Spingarn	ಸ್ಪಿನ್‌ಗರ್ನ್
Medal	ಮೆಡಲ್
Radhavallabh	ರಾಧಾವಲ್ಲಭ
Hari	ಹರಿ
bhoomi	ಭೂಮಿ
Hanumaan	ಹನುಮಾನ್
Graham	ಗ್ರಹಾಂ
Stevenson	ಸ್ಟೆವೆನ್‌ಸನ್
Dharuna	ಧರುಣಾ
Kamalesh	ಕಮಲೇಶ್
Essam	ಎಸ್ಸಾಂ
Atmajyoti	ಆತ್ಮಜ್ಯೋತಿ
Chris	ಕ್ರಿಸ್
Pringle	ಪ್ರಿಂಗಲ್
Cleavant	ಕ್ಲೀವಾಂಟ್
Madihah	ಮದಿಹಾ
Erzherzog	ಎಜರ್‌ಜೋಗ್
Karl	ಕಾರ್ಲ್
Dosti	ದೋಸ್ತೀ
Aaditya	ಆದಿತ್ಯ
Ahlam	ಅಹ್ಲಮ್
Valarie	ವೈಲೆರೀ
Nairi	ನೈರಿ
Raahi	ರಾಹಿ
Agori Khas	ಅಗೋರಿಖಾಸ್
Ellenabad	ಎಲೆನಾಬಾದ್
Virginia	ವರ್ಜೀನಿಯಾ
reel	ರೀಲ್
Pannalal	ಪನ್ನಾಲಾಲ್
Ghosh	ಘೋಷ್
Joshi	ಜೋಶಿ
Patankar	ಪಠಣಕರ್
Ekalinga	ಏಕಲಿಂಗ
Order	ಆರ್ಡರ್
of	ಆಫ್
Ushakov	ಉಶಾಕೊವ್
Thayer	ಥಾಯೆರ್
Shakti	ಶಕ್ತಿ
Aaj	ಆಜ್
Kal	ಕಲ್
Jaisal	ಜೈಸಲ್
Peak	ಪೀಕ್
International	ಇಂಟರ್ನ್ಯಾಷನಲ್
Limited	ಲಿಮಿಟೆಡ್
Pyar	ಪ್ಯಾರ್
Ki	ಕಿ
Baazi	ಬಾಜೀ
Mohammad	ಮೊಹಮ್ಮದ್
Abul	ಅಬ್ದುಲ್
Kalam	ಕಲಾಂ
Azad	ಆಜಾದ್
Paatekar	ಪಾಟೇಕರ್
Rebaba	ರೆಬಾಬಾ
shark	ಶಾರ್ಕ್
Kanad	ಕಾನಡ
Santa	ಸಂತಾ
Susana	ಸುಸಾನಾ
Baton	ಬತನ್
Baton	ಬತನ್
Mein	ಮೆ
Hamari	ಹಮಾರಿ
Kismat	ಕಿಸ್ಮತ್
Bindki	ಬಿಂದಕೀ
Road	ರೋಡ್
Ambardekar	ಅಂಬಾರ್ಡೆಕರ್
Abdul	ಅಬ್ದುಲ್
qadeer	ಖಾದಿರ್
Asambhav	ಅಸಂಭವ್
Gwinett's	ಗ್ವಿನೆಟ್ಸ್
Family	ಫ್ಯಾಮಿಲಿ
Rajendramohan	ರಾಜೇಂದ್ರಮೋಹನ
Rubaina	ರುಬೈನಾ
Westmoreland	ವೆಸ್ಟ್‌ಮೋರ್‌ಲ್ಯಾಂಡ್
Dhaulpur	ಧಾಲ್ಪುರ್
Prahlaad	ಪ್ರಹ್ಲಾದ್
Vitthal	ವಿಠ್ಠಲ
Zamana	ಜಮಾನಾ
Kala	ಕಾಲಾ
Dhandha	ಧಂಧಾ
Gorey	ಗೋರೆ
Log	ಲೋಗ್
pricewaterhouse	ಪ್ರೈಸ್‌ವಾಟರ್‌ಹೌಸ್
coopers	ಕೂಪರ್ಸ್
Galaxy	ಗ್ಯಾಲೆಕ್ಸಿ
Entertainment	ಎಂಟರ್‌ಟೈನ್ಮೆಂಟ್
Marianne	ಮೇರಿಯನ್
Williamson	ವಿಲಿಯಂಸನ್
Ganadhyaksha	ಗಣಾಧ್ಯಕ್ಷ
Tulsa	ಟುಲ್ಸಾ
Intl	ಇಂಟರ್ನ್ಯಾಷನಲ್
Business	ಬ್ಯುಸಿನೆಸ್
Machines	ಮೆಶಿನ್ಸ್
Charles	ಚಾರ್ಲ್ಸ್
Coventry	ಕೋವೆಂಟ್ರಿ
Gundar	ಗುಂದರ್
Reservoir	ರಿಜರ್ವಾಯರ್
Atindar	ಅತೀಂದರ್
Madpuri	ಮಾದ್‌ಪುರಿ
Dulip	ದುಲಿಪ್
Liyanage	ಲಿಯನಗೆ
Shatrumardan	ಶತ್ರುಮರ್ಧನ್
Maqil	ಮಖಿಲ್
Shanbaree	ಶಂಬರೀ
Dhul-Nun	ದುಲ್-ನುನ್
al-Misri	ಅಲ್-ಮಿಸ್ರಿ
Achalda	ಅಚಲ್ಡಾ
Akhand	ಅಖಂಡ್
Saubhagyawati	ಸೌಭಾಗ್ಯವತಿ
Zander	ಜನ್ದರ್
Pinquillo	ಪಿಂಕ್ವಿಲೊ
Gordon	ಗೋರ್ಡನ್
Greenidge	ಗ್ರೀನಿಜ್
Order	ಆರ್ಡರ್
of	ಆಫ್
Christ	ಕ್ರಿಸ್ಟ್
Kahani	ಕಹಾನಿ
Phoolvati	ಪೂಲ್ವತಿ
Ki	ಕಿ
Teleri	ಟೆಲೇರಿ
Oonch	ಊಂಚ್
Neech	ನೀಚ್
Mandeep	ಮನ್‌ದೀಪ್
Mitchell	ಮಿಚೆಲ್
Mario	ಮಾರಿಯೊ
Chhupa	ಛುಪಾ
Rustam	ರುಸ್ತಮ್
Protactinium	ಪ್ರೊಟ್ಯಾಕ್ಟಿನಿಯಂ
Broadwater	ಬ್ರಾಡ್‌ವಾಟರ್
Coyle	ಕೊಯ್ಲಿ
Bagri	ಬಾಗ್ರಿ
Sajjanpur	ಸಜ್ಜನ್‌ಪುರ್
Achintya	ಅಚಿಂತ್ಯ
Shifaa	ಶೀಫಾ
Jurmana	ಜುರ್ಮಾನಾ
Veerkar	ವೀರ್ಕರ್
Amlai	ಅಮಲಾಯ್
The	ದ
Doon	ದೂನ್
School,	ಸ್ಕೂಲ್,
Dehradun	ಡೆಹ್ರಾಡೂನ್
Kaushik	ಕೌಶಿಕ್
Ardara	ಆರ್ಡರಾ
Cyndi	ಸಿಂಡಿ
Ununbium	ಯುನುನ್ಬಿಯಂ
Deeptendu	ದೀಪ್ತೇಂದು
Bombay	ಬಾಂಬೆ
Masjid	ಮಸ್ಜಿದ್
Kapani	ಕಪಾನಿ
Yogeshvar	ಯೋಗೇಶ್ವರ್
Supreme	ಸುಪ್ರೀಂ
Petro	ಪೆಟ್ರೋ
Venugopal	ವಿನೂಗೋಪಾಲ್
Rao	ರಾವ್
Nimish	ನಿಮಿಷ್
Golden	ಗೋಲ್ಡನ್
gate	ಗೇಟ್
Jhinuk	ಝಿನುಕ್
Formidable	ಫೊರ್ಮಿಡಬಲ್
Jody	ಜೋಡೀ
Suranjana	ಸುರಂಜನ
Keene	ಕೀನ್
Ajaatashatru	ಅಜಾತಶತ್ರು
Kuntee	ಕುಂತೀ
Keena	ಕೀನಾ
Madhuchanda	ಮಧುಚಂದಾ
Jawad	ಜಾವದ್
Jawab	ಜವಾಬ್
Mahaamuni	ಮಹಾಮುನಿ
Fort	ಫೋರ್ಟ್
tejon	ತೆಜೋನ್
Jawan	ಜವಾನ್
Pannagesh	ಪನ್ನಗೇಶ್
Kathleen	ಕ್ಯಾಥ್ಲೀನ್
Hans	ಹನ್ಸ್
Christian	ಕ್ರಿಶ್ಚಿಯನ್
Andersen	ಆಂಡರ್ಸ್‌ಸನ್
Award	ಅವಾರ್ಡ್
Black	ಬ್ಲ್ಯಾಕ್
Hughes	ಹಗ್ಗೇಸ್
Medal	ಮೆಡಲ್
Hare	ಹರೆ
Kanch	ಕಾಂಚ್
Ki	ಕಿ
Churiyan	ಚುಡಿಯಾ
Kananbala	ಕಾನಂಬಲ
Juma'	ಜುಮಾ
Banani	ಬನಾನಿ
Banahi	ಬನಾಹಿ
University	ಯುನಿವರ್ಸಿಟಿ
of	ಆಫ್
London	ಲಂಡನ್
Sean	ಸೀನ್
Ervine	ಇರ್ವಿನ್
Jan	ಜಾನ
Pahechan	ಪಹಚಾನ್
Jerold	ಜೆರೋಲ್ಡ್
Lalitkishore	ಲಲಿತ್‌ಕಿಶೋರ್
Halwara	ಹಲ್ವಾರಾ
Vishwambhar	ವಿಶ್ವಂಭರ್
Upadyay	ಉಪಾಧ್ಯಾಯ್
Ricky	ರಿಕಿ
Ponting	ಪಾಂಟಿಂಗ್
Rufiyaa	ರುಫಿಯಾ
Alipur	ಅಲಿಪುರ್
Duar	ದುವರ್
Hatyare	ಹತ್ಯಾರೆ
Sheikh	ಶೇಕ್
Ruzbehan	ರಜ್‌ಬೆಹನ್
NALCO	ನ್ಯಾಲ್ಕೊ
Bayer	ಬಾಯರ್
Badawi	ಬದಾವಿ
The	ದ
Goulandris	ಗೌಲಂಡ್ರಿಸ್
Museum	ಮ್ಯೂಸಿಯಂ
of	ಆಫ್
Natural	ನ್ಯಾಚುರಲ್
History	ಹಿಸ್ಟರಿ
Aalingan	ಆಲಿಂಗನ್
Lal	ಲಾಲ್
Bangla	ಬಂಗಲಾ
Joseph	ಜೋಸೆಫ್
Stalin	ಸ್ಯಾಲಿನ್
Ulaanbaatar	ಉಲ್ಲಾನ್‌ಬಟೋರ್
Nat	ನ್ಯಾಟ್
Fert	ಫರ್ಟ್
Karambelkar	ಕರಾಂಬೇಲ್ಕರ್
Bilwmangal	ಬಿಲ್ವಮಂಗಲ್
Naatu	ನಾತು
Guajira	ಗೌಜೀರಾ
Sun	ಸನ್
Pharma	ಫಾರ್ಮಾ
Vidrumalataa	ವಿದ್ರುಮಲತಾ
Nehra	ನೆಹ್ರಾ
Bandagi	ಬಂದಗೀ
Franc	ಫ್ರಾಂಕ್
Mayin	ಮಾಯಿನ್
Larkin	ಲಾರ್ಕಿನ್
Vanamaataa	ವನಮಾತಾ
Nageshwar	ನಾಗೇಶ್ವರ
Jyotirlinga	ಜ್ಯೋತಿರ್ಲಿಂಗ
Panchwin	ಪಂಚವಿನ್
Manzil	ಮಂಜಿಲ್
Bahamas	ಬಹಾಮಾಸ್
Hasina	ಹಸೀನಾ
Maan	ಮಾನ್
Jayegi	ಜಾಯೆಗಿ
Chhatwal	ಛತ್ತವಾಲ್
Kohima	ಕೋಹಿಮಾ
Boordhi-Zaffer	ಬೂರ್ದಿ-ಝಫರ್
Roj	ರೋಜ್
Kennedy	ಕೆನೆಡಿ
Arsikere	ಅರಸೀಕೆರೆ
Junction	ಜಂಕ್ಷನ್
Druhin	ದ್ರುಹಿಣ್
Detective	ಡಿಟೆಕ್ಟಿವ್
Janoo	ಜಾನೂ
Gavin	ಗವಿನ್
Hamilton	ಹ್ಯಾಮಿಲ್ಟನ್
Calder	ಕಾಲ್ಡರ್
Murari	ಮುರಾರಿ
Anise	ಅನೈಸ್
Samjhauta	ಸಂಜೌತಾ
Waheed	ವಹೀದ್
Agni	ಅಗ್ನಿ
Chakra	ಚಕ್ರ
Nerys	ನೆರಿಸ್
Gurudwara	ಗುರುದ್ವಾರ
Bauli	ಬೌಲಿ
Sahib	ಸಾಹಿಬ್
Amrit	ಅಮೃತ್
Manthan	ಮಂಥನ್
Ghatprabha	ಘಟಪ್ರಭಾ
Paap	ಪಾಪ್
Ki	ಕಿ
Duniya	ದುನಿಯಾ
Rashi	ರಾಶಿ
Amergin	ಅಮೆರ್ಜಿನ್
Shubhang	ಶುಭಾಂಗ್
Rangila	ರಂಗೀಲಾ
Ratan	ರತನ್
Vivechan	ವಿವೇಚನ್
Ajay	ಅಜಯ್
Sunaharaa	ಸುನಹರಾ
Cody	ಕೋಡಿ
Krashnaa	ಕೃಷ್ಣಾ
Chhinda	ಛಿಂದಾ
Abdul	ಅಬ್ದುಲ್
raheem	ರಹೀಂ
Arshad	ಅರ್ಷಾದ್
Pervez	ಪರ್ವೇಜ್
Anaikuttam	ಅನೈಕುಟ್ಟಮ್
Reservoir	ರಿಜರ್ವಾಯರ್
McPhail	ಮ್ಯಾಕ್‌ಫಾಯ್ಲ್
Bosporus	ಬಾಸ್ಪೋರಸ್
Pyasi	ಪ್ಯಾಸಿ
Sham	ಶಾಮ್
Cirocco	ಸಿರೋಕೋ
Suwo	ಸುವೋ
Slalom	ಸ್ಲಾಲಂ
Vedikaa	ವೇದಿಕಾ
Gary	ಗ್ಯಾರಿ
Brent	ಬ್ರೆಂಟ್
Reon	ರಿಯೋನ್
King	ಕಿಂಗ್
Svarnim	ಸ್ವರ್ಣಿಮ್
Agnikumaar	ಅಗ್ನಿಕುಮಾರ್
Richard	ರಿಚರ್ಡ್
Burton	ಬರ್ಟನ್
Order	ಆರ್ಡರ್
of	ಆಫ್
Scientific	ಸೈಂಟಿಫಿಕ್
and	ಆಂಡ್
Technological	ಟೆಕ್ನಾಲಾಜಿಕಲ್
Merit	ಮೆರಿಟ್
Scotia	ಸ್ಕಾಟಿಯಾ
Sea	ಸೀ
Ruso	ರೂಸೋ
Sheikh	ಶೇಕ್
Shebeli	ಶೆಬೇಲಿ
Kolina	ಕೊಲಿನಾ
Indrakarman	ಇಂದ್ರಕರ್ಮನ್
Shreemayi	ಶ್ರೀಮಯಿ
Glacier	ಗ್ಲೇಸಿಯರ್
Al	ಅಲ್
Sahariar	ಸಹಾರಿಯರ್
Pretvam	ಪ್ರೀತ್ವಂ
Helle	ಹೆಲೆ
Joel	ಜೋಲ್
Osment	ಓಸ್ಮೆಂಟ್
Sarfarosh	ಸರಫರೋಶ್
Sarkari	ಸರಕಾರಿ
Mehman	ಮೆಹಮಾನ್
Pacific	ಪೆಸಿಫಿಕ್
Rim	ರಿಮ್
Jab	ಜಬ್
Pyar	ಪ್ಯಾರ್
Kise	ಕಿಸೀ
Se	ಸೇ
Hota	ಹೋತಾ
Hai	ಹೈ
Akhfash	ಅಖ್ಫಾಶ್
Konkani	ಕೊಂಕಣಿ
The	ದ
morning	ಮಾರ್ನಿಂಗ್
quick	ಕ್ವಿಕ್
Jimmy	ಜಿಮ್ಮಿ
Cook	ಕುಕ್
Hillcrest	ಹಿಲ್‌ಕ್ರೆಸ್ಟ್
Baptist	ಬ್ಯಾಪ್ಟಿಸ್ಟ್
Willie	ವಿಲ್ಲೀ
Watson	ವಾಟ್ಸನ್
Walter	ವಾಲ್ಟರ್
Kohn	ಕೋನ್
Cornelia	ಕಾರ್ನೇಲಿಯಾ
Jirair	ಜಿರೈರ್
Krishnakanta	ಕೃಷ್ಣಕಾಂತ
Katelynn	ಕೇಟ್‌ಲಿನ್
Alastair	ಅಲಾಸ್ಟೇರ್
Cook	ಕುಕ್
Din	ದಿನ್
Dahade	ದಹಾಡೆ
Raj	ರಾಜ್
Tarang	ತರಂಗ್
Ganagapur	ಗಂಗಾಪುರ್
Road	ರೋಡ್
Auckland	ಆಕ್ಲೆಂಡ್
University	ಯುನಿವರ್ಸಿಟಿ
of	ಆಫ್
Technology	ಟೆಕ್ನಾಲಜಿ
Ronnie	ರಾನೀ
Irani	ಇರಾನಿ
Shahid	ಶಹೀದ್
Anwar	ಅನ್ವರ್
Haar	ಹಾರ್
Jeet	ಜೀತ್
Arjun	ಅರ್ಜುನ್
Pandit	ಪಂಡಿತ್
Berbak	ಬೆರ್ಬಾಕ್
Emirates	ಎಮಿರೇಟ್ಸ್
tower	ಟವರ್
One	ಒನ್
George	ಜಾರ್ಜ್
Bush	ಬುಷ್
Chainwa	ಚೈನವಾ
Susane	ಸುಸೇನ್
Divyesh	ದಿವ್ಯೇಶ್
Confederation	ಕಾನ್ಫೆಡರೇಶನ್
Caribbean	ಕೆರೆಬಿಯನ್
Vraksharaaj	ವೃಕ್ಷರಾಜ
Amani	ಅಮನಿ
Dakaniya	ದಕಾನಿಯಾ
Talav	ತಲಾವ್
Natwar	ನಟವರ್
Baidehi	ಬೈದೇಹಿ
Prasanna	ಪ್ರಸನ್ನ
Bindiya	ಬಿಂದಿಯಾ
Chamkegi	ಚಮಕೇಗೀ
Butte	ಬುಟ್ಟೆ
Tallinn	ತಲ್ಲಿನ್
Stuart	ಸ್ಟುವರ್ಟ್
Williams	ವಿಲಿಯಮ್ಸ್
Bhadrachalam	ಭದ್ರಾಚಲಂ
Dinesh	ದಿನೇಶ್
Aojla	ಓಜ್ಲಾ
Amu	ಅಮು
Darya	ದರ್ಯಾ
Auberta	ಆಬೆರ್ಟಾ
Evergreen	ಎವರ್‌ಗ್ರೀನ್
Community	ಕಮ್ಯುನಿಟಿ
Omar	ಒಮರ್
Henry	ಹೆನ್ರಿ
Studs	ಸ್ಟಡ್ಸ್
Orchards	ಆರ್ಚಾರ್ಡ್ಸ್
Community	ಕಮ್ಯುನಿಟಿ
Cashlin	ಕಾಶ್ಲಿನ್
Harvey	ಹಾರ್ವೇ
Awards	ಅವಾರ್ಡ್ಸ್
Hassium	ಹ್ಯಾಸಿಯಂ
Khota	ಖೋಟಾ
Paisa	ಪೈಸಾ
Saeed	ಸಯೀದ್
Azad	ಆಜಾದ್
Farasat	ಫರಾಸತ್
Offenpest	ಆಫೆನ್‌ಪೆಸ್ಟ್
Caterpillar	ಕ್ಯಾಟರ್ಪಿಲ್ಲರ್
Leeds	ಲೀಡ್ಸ್
Shiva	ಶಿವಾ
Pandora	ಪಂಡೋರಾ
Madhura	ಮಧುರಾ
Fuller	ಫುಲರ್
Boomps-a-daisy	ಬೂಮ್‌ಪ್ಸ್-ಎ-ಡೈಸಿ
Abdul	ಅಬ್ದುಲ್
azim	ಅಜೀಮ್
Madhuri	ಮಾಧುರಿ
Indra	ಇಂದ್ರ
Pulastya	ಪುಲಸ್ತ್ಯ
Balee	ಬಾಲೀ
Raghib	ರಘಿಬ್
Ainslie	ಐನ್‌ಸ್ಲಿ
Tiple	ಟಿಪ್ಲ್
Elata	ಇಲಾಟಾ
Jahan	ಜಹಾನ್
Hind	ಹಿಂದ್
Constr	ಕನ್ಸ್‌ಸ್ಟ್ರಕ್ಷನ್
Punarjanam	ಪುನರ್ಜನ್ಮ್
Proffitt	ಪ್ರಾಫಿಟ್
Abhinav	ಅಭಿನವ್
Roster	ರೋಸ್ಟರ್
Shag	ಶಾಗ್
Maghavaajit	ಮಘವಾಜಿತ್
Monisha	ಮೋನಿಶಾ
Livingstone	ಲಿವಿಂಗ್‌ಸ್ಟೋನ್
Chakia	ಚಕಿಯಾ
Major	ಮೇಜರ್
League	ಲೀಗ್
Lacrosse	ಲಾಕ್ರೊಸ್
Community	ಕಾಮ್ಯುನಿಟಿ
Service	ಸರ್ವಿಸ್
Award	ಅವಾರ್ಡ್
Jimuta	ಜಿಮುತಾ
Creighton	ಕ್ರೈಟನ್
Kural	ಕುರಾಲ್
Jai	ಜೈ
Jagannath	ಜಗನ್ನಾಥ್
Ginata	ಗಿನಾಟಾ
Marasi	ಮರಾಸಿ
Chambal	ಚಂಬಲ್
Ke	ಕೆ
Daku	ಡಾಕೂ
Sanjh	ಸಾಂಝ್
Ki	ಕಿ
Bela	ಬೆಲಾ
Manusela	ಮನುಸೆಲಾ
Vaitarna	ವೈತರ್ಣಾ
Dobh	ದೋಭ
Bahali	ಬಹಾಲಿ
Gambler	ಗ್ಯಾಂಬ್ಲರ್
Amit	ಅಮಿತ್
Mishra	ಮಿಶ್ರಾ
Netball	ನೆಟ್‌ಬಾಲ್
Bari	ಬಾರಿ
Brahman	ಬ್ರಹಾಮನ್
Nevanlinna	ನೆವನ್ಲಿನ್ನಾ
Prize	ಪ್ರೈಜ್
Safiyy	ಸಫೀ
Balakrishna	ಬಾಲಕೃಷ್ಣ
Somnath	ಸೋಮನಾಥ
Jyotirlinga	ಜ್ಯೋತಿರ್ಲಿಂಗ
Kahnuwal	ಕಹನೂವಾಲಾ
Binaur	ಬಿನಾರ್
Danzon	ಡ್ಯಾನ್ಸನ್
Kaylee	ಕೇಲೀ
Somakaantaa	ಸೋಮಕಾಂತಾ
Hyundai	ಹ್ಯುಂಡೈ
Motor	ಮೋಟರ್
Oda	ಓಡಾ
Sakunosuke	ಸಕುನೋಸುಕೆ
Prize	ಪ್ರೈಜ್
Michael	ಮೈಕೇಲ್
Bevan	ಬೆವೆನ್
Thracian	ತರಾಸಿಯನ್
Amalsad	ಅಮಲ್‌ಸದ್
Nobel	ನೊಬೆಲ್
Peace	ಪೀಸ್
Prize	ಪ್ರೈಜ್
Bidhan	ಬಿಧಾನ್
Nagar	ನಗರ್
Jalan	ಜಲನ್
Chiraagh	ಚಿರಾಗ್
Jo	ಜೋ
Huwa	ಹುವಾ
So	ಸೋ
Bhool	ಭೂಲ್
Ja	ಜಾ
Wohi	ವಹೀ
Bhayanak	ಭಯಾನಕ್
Raat	ರಾತ್
Ashok	ಅಶೋಕ್
Leyland	ಲೀಲ್ಯಾಂಡ್
Ghayda	ಗಾಯದಾ
Irma	ಇರ್ಮಾ
Kaydence	ಕೆಡೆನ್ಸ್
Freed	ಫ್ರೀಡ್
Brasschaet	ಬ್ರ್ಯಾಸ್‌ಚೆಟ್
fort	ಫೋರ್ಟ್
Harnett	ಹಾರ್ನೆಟ್
Henry	ಹೆನ್ರಿ
Fielding	ಫೀಲ್ಡಿಂಗ್
Sukriti	ಸುಕೃತಿ
Robert	ರಾಬರ್ಟ್
Anderson	ಆಂಡರ್ಸನ್
Naples	ನೇಪಲ್ಸ್
American	ಅಮೆರಿಕನ್
Intl	ಇಂಟ್
Group	ಗ್ರೂಪ್
Subroto	ಸುಬ್ರತೊ
Banerjee	ಬ್ಯಾನರ್ಜಿ
Kailashnath	ಕೈಲಾಶ್‌ನಾಥ್
Munich	ಮ್ಯೂನಿಚ್
Mazloom	ಮಜಲೂಮ್
Saint	ಸೆಂಟ್
olaf's	ಒಲಾಫ್ಸ್
castle	ಕ್ಯಾಸ್ಟರ್
Ullas	ಉಲ್ಲಾಸ್
Ibtihal	ಇಬ್ತಿಹಾಲ್
Ramavatar	ರಾಮಾವತಾರ್
Nevina	ನೆವಿನಾ
Skirrow	ಸ್ಕಿರೋ
Shahid	ಶಹೀದ್
Nazir	ನಜೀರ್
Jalangi	ಜಲಾಂಗಿ
Samrendru	ಸಮರೇಂದು
Atahar	ಅತಹರ್
Banco	ಬಾಂಕೋ
Do	ಡೊ
Brasil	ಬ್ರಾಸಿಲ್
Champa	ಚಂಪಾ
Kali	ಕಲೀ
Ladki	ಲಡಕಿ
Sahyadri	ಸಹ್ಯಾದ್ರಿ
Ki	ಕಿ
Brendon	ಬ್ರೆಂಡನ್
Kuruppu	ಕುರುಪ್ಪು
Amala	ಅಮಲಾ
Ek	ಏಕ್
Naav	ನಾವ್
Kinare	ಕಿನಾರೆ
Do	ದೋ
Srivilliputtur	ಶ್ರೀವಿಲ್ಲಿಪುತ್ತೂರು
Aacharysut	ಆಚಾರ್ಯಸುತ
Tirukkottiyur	ತಿರುಕ್ಕೊಟ್ಟಿಯೂರ್
Celebration	ಸೆಲೆಬ್ರೇಶನ್
Community	ಕಮ್ಯೂನಿಟಿ
Jack	ಜ್ಯಾಕ್
Benny	ಬೆನ್ನಿ
Chalta	ಚಲ್ತಾ
Purza	ಪುರ್ಜಾ
Glen	ಗ್ಲೆನ್
Chapple	ಚಾಪಲ್
Angulimal	ಅಂಗುಲಿಮಾಲ್
Sailing	ಸೈಲಿಂಗ್
Order	ಆರ್ಡರ್
of	ಆಫ್
Leopold	ಲಿಯೋಪೊಲ್ಡ್
Baden	ಬದೆನ್
Naldurg	ನಲ್‌ದುರ್ಗ್
Indianapolis	ಇಂಡಿಯಾನಪೊಲಿಸ್
Chaad	ಛಾಡ್
Kolhatkar	ಕೋಲ್ಹಾಟ್‌ಕರ್
Banaskantha	ಬನಸ್ಕಂದ
Pyase	ಪ್ಯಾಸಿ
Panchhi	ಪಂಛೀ
Xaviere	ಜಾವಿಯರ್
Sushil	ಸುಶೀಲ್
Eshwar	ಈಶ್ವರ್
Bukit	ಬುಕಿಟ್
Tiga	ಟಿಗಾ
Puluh	ಪುಲುಹ್
Fishing	ಫಿಶಿಂಗ್
Shajee'ah	ಶಜೀಹ
Hedley	ಹೆಡ್ಲಿ
Howarth	ಹೋವರ್ತ್
Adityaa	ಆದಿತ್ಯಾ
Imtihal	ಇಮ್ತಿಹಾಲ್
Albert	ಆಲ್ಬರ್ಟ್
Pinto	ಪಿಂಟೊ
Ko	ಕೊ
Gussa	ಗುಸ್ಸಾ
Kyon	ಕ್ಯು
Ata	ಆತಾ
Hai	ಹೈ
Deven_dr	ದೇವೇಂದ್ರ್
Geoff	ಜೆಫ್
Allott	ಅಲಾಟ್
Shrinath	ಶ್ರೀನಾಥ್
Dharma	ಧರ್ಮಾ
Mosquitos	ಮಾಸ್ಕ್ವಿಟೋಸ್
Miffin	ಮಿಫಿನ್
Nitin	ನಿತಿನ್
Ariyalur	ಅರಿಯಲೂರ್
Shree	ಶ್ರೀ
Krishna	ಕೃಷ್ಣ
Leela	ಲೀಲಾ
University	ಯುನಿವರ್ಸಿಟಿ
of	ಆಫ್
canberra	ಕ್ಯಾನ್‌ಬೆರಾ
Kaziranga	ಕಾಜಿರಂಗಾ
Marjanah	ಮರ್ಜನಾ
Jacob	ಜಾಕೊಬ್
Martin	ಮಾರ್ಟಿನ್
Order	ಆರ್ಡರ್
of	ಆಫ್
National	ನ್ಯಾಶನಲ್
Redevelopment	ರಿಡೆವೆಲಪ್‌ಮೆಂಟ್
Merit	ಮೆರಿಟ್
Gupt	ಗುಪ್ತ್
Shastra	ಶಾಸ್ತ್ರ
Janak	ಜನಕ್
Dainik	ದೈನಿಕ್
agradoot	ಅಗ್ರದೂತ್
Bansdih	ಬನ್ಸದಿ
Road	ರೋಡ್
Stavita	ಸ್ಟೇವಿಟಾ
Ratanalaal	ರತನ್‌ಲಾಲ್
Gurudwara	ಗುರುದ್ವಾರ
Nagina	ನಗೀನಾ
Ghat	ಘಾಟ್
War	ವಾರ್
of	ಆಫ್
the	ದಿ
Grand	ಗ್ರಾಂಡ್
Alliance	ಅಲಯನ್ಸ್
Gummidipundi	ಗುಮ್ಮಿಡಿಪೂಂಡಿ
Mohammad	ಮೊಹ್ಮದ್
Rafique	ರಫೀಕ್
Kaukab	ಕಾಕುಬ್
Vair	ವೈರ್
Ahmad	ಅಹಮದ್
al-Bakkai	ಅಲ್-ಬಕ್ಕಾಯ್
al-Kunti	ಅಲ್-ಕುಂತಿ
Chakob	ಚಾಕೋಬ್
Rexam	ರೆಕ್ಸಾಮ್
Kolthekar	ಕೋಲ್ತೆಕರ್
Indiana	ಇಂಡಿಯಾನಾ
University	ಯುನಿವರ್ಸಿಟಿ
Bloomington	ಬ್ಲೂಮಿಂಗ್ಟನ್
Devahuti	ದೇವಾಹುತಿ
Buhayyah	ಬುಹೈಯಾ
Achalaa	ಅಚಲಾ
Aladdin	ಅಲಾದೀನ್
Knowledge	ನಾಲೆಡ್ಜ್
Systems	ಸಿಸ್ಟಮ್ಸ್
Limited	ಲಿಮಿಟೆಡ್
Portsdown	ಪೋರ್ಟ್ಸ್‌ಡೌನ್
hill	ಹಿಲ್
Sharma	ಶರ್ಮಾ
Prabhaa	ಪ್ರಭಾ
Badriprasad	ಬದ್ರಿಪ್ರಸಾದ್
Sudi	ಸುದಿ
Sharda	ಶಾರದಾ
January	ಜಾನವರಿ
Yashomati	ಯಶೋಮತಿ
Panduranga	ಪಾಂಡುರಂಗ
Saujan_y	ಸೌಜನ್ಯ
Boschbeek	ಬಾಸ್ಕ್‌ಬೀಕ್
fort	ಫೋರ್ಟ್
Rasavant	ರಸವಂತ್
Ferry	ಫೆರಿ
Donald	ಡೊನಾಲ್ಡ್
Trump	ಟ್ರಂಪ್
Kannamangai	ಕನ್ನಾಮನಗೈ
Cendant	ಸೆಂಡೆಂಟ್
Manjaree	ಮಂಜರೀ
Sara	ಸಾರಾ
Jahan	ಜಹಾ
Hamara	ಹಮಾರಾ
Ahlaadit	ಆಹ್ಲಾದಿತ್
Shaswati	ಶಾಶ್ವತಿ
Megha	ಮೇಘಾ
Museum	ಮ್ಯೂಸಿಯಂ
of	ಆಫ್
Cretan	ಕ್ರೇಟನ್
Ethnology	ಎಥ್ನಾಲಜಿ
Tom	ಟಾಮ್
Hanks	ಹ್ಯಾಂಕ್ಸ್
Naren_dr	ನರೇಂದ್ರ್
All	ಆಲ್
Saints	ಸೈಂಟ್ಸ್
Lutheran	ಲುಥೆರಾನ್
Hamari	ಹಮಾರಿ
Shaan	ಶಾನ್
India	ಇಂಡಿಯಾ
In	ಇನ್
Africa	ಆಫ್ರಿಕಾ
Natasha	ನತಾಶಾ
Namak	ನಮಕ್
Halal	ಹಲಾಲ್
Lakshmikant	ಲಕ್ಷ್ಮೀಕಾಂತ್
Lucky	ಲಕೀ
Number	ನಂಬರ್
Aung	ಆಂಗ್
San	ಸಾಂಗ್
su	ಸೂ
ki	ಕೀ
Kenny	ಕೆನ್ನಿ
Benjamin	ಬೆಂಜಮಿನ್
Etalan	ಇಟಲನ್
de	ಡೆ
Yennenga	ಯೆನೆಂಗಾ
Khush	ಖುಷ್
bakht	ಭಕ್ತ್
Trent	ಟ್ರೆಂಟ್
Aya	ಆಯಾ
Sawan	ಸಾವನ್
Jhoom	ಝೂಮ್
Ke	ಕೆ
Eliot	ಈಲಿಯಟ್
Donny	ಡಾನಿ
Jalia	ಜಲಿಯಾ
Richard	ರಿಚರ್ಡ್
Clarke	ಕ್ಲಾರ್ಕ್
Donna	ಡೊನ್ನಾ
Nabilah	ನಬೀಲಾಲ್
Agni	ಅಗ್ನಿ
Prem	ಪ್ರೇಮ್
Prem	ಪ್ರೇಮ್
Jaal	ಜಾಲ್
Un_manaa	ಉನ್ಮನಾ
Jab	ಜಬ್
Jab	ಜಬ್
Phool	ಪೂಲ್
Khile	ಖಿಲೆ
Wahibah	ವಹೀಬಾ
Bhawani	ಭವಾನಿ
Mandi	ಮಂಡಿ
Chris	ಕ್ರಿಸ್
Drum	ಡ್ರಂ
O	ಓ
Panchhi	ಪಂಛೀ
Ulfah	ಉಲ್ಫಾ
Urmimala	ಊರ್ಮಿಳಾ
Savera	ಸವೇರಾ
Kishori	ಕಿಶೋರಿ
Shararat	ಶರಾರತ್
Ian	ಇಯಾನ್
Healy	ಹೀಲಿ
Strait	ಸ್ಟ್ರೈಟ್
of	ಆಫ್
Gibraltar	ಗಿಬ್ರಾಲ್ಟರ್
Kabuli	ಕಾಬುಲಿ
Khan	ಖಾನ್
Murabbi	ಮುರಬ್ಬಿ
Bhadraaksha	ಭದ್ರಾಕ್ಷ
Sirmilik	ಸಿರ್ಮಿಲಕ್
Bhagavaan	ಭಗವಾನ್
Marenda	ಮರೇಂದಾ
Shaan_ti	ಶಾಂತಿ
Bhakt	ಭಕ್ತ್
Pralhad	ಪ್ರಹ್ಲಾದ್
Fed	ಫೆಡ್
Cup	ಕಪ್
Shail	ಶೈಲ್
sutaa	ಸುತಾ
National	ನ್ಯಾಷನಲ್
Australia	ಆಸ್ಟ್ರೇಲಿಯಾ
Bank	ಬ್ಯಾಂಕ್
Saparna	ಸಪರ್ಣ
Qalandar	ಖಲಂದರ್
Baba	ಬಾಬಾ
Auliya	ಔಲಿಯಾ
Apna	ಅಪ್ನಾ
Bana	ಬನಾ
Lo	ಲೋ
Vakil	ವಕೀಲ್
Babu	ಬಾಬೂ
Menifee	ಮೆನಿಫಿ
Kmart	ಕೆಮಾರ್ಟ್
Holding	ಹೋಲ್ಡಿಂಗ್
Gatana	ಗಟಾನಾ
Reservoir	ರಿಜರ್ವಾಯರ್
John	ಜಾನ್
Maguire	ಮಾಗುರ್
Eldon	ಎಲ್ಡನ್
Vishishat	ವಿಶಿಷ್ಟ
Hind	ಹಿಂದ್
Ka	ಕಾ
Lal	ಲಾಲ್
koch	ಕಾಚ್
industries	ಇಂಡಸ್ಟ್ರೀಸ್
Quade	ಕ್ವೇಡ್
Gunung	ಗುನುಂಗ್
Palung	ಪಲುಂಗ್
Waylon	ವೈಲನ್
Sinclair	ಸಿಂಕ್ಲೇರ್
Mehfil	ಮಹಫಿಲ್
Surasakhaa	ಸುರಸಖ
Kirkwood	ಕಿರ್ಕ್‌ವುಡ್
Dhimaan	ಧೀಮಾನ್
Nabihah	ನಬೀಹಾ
Daag	ದಾಗ್
Rupiah	ರುಪೈಯಾ
Nadr	ನದ್ರ್
Chittaurgarh	ಚಿತ್ತಾರ್‌ಗಢ್
Wernecke	ವೆರ್ನೆಕ್
Love	ಲವ್
And	ಅಂಡ್
Murder	ಮರ್ಡರ್
Collingsworth	ಕಾಲಿಂಗ್ಸ್‌ವರ್ಥ್
Gounaropoulos	ಗೌರ್ನರೋಪೊಲೀಸ್
Museum	ಮ್ಯೂಸಿಯಂ
of	ಆಫ್
the	ದ
Municipality	ಮುನಿಸಿಪಲಿಟಿ
of	ಆಫ್
Zografou	ಜೋಗ್ರಾಫೂ
Harry	ಹ್ಯಾರಿ
S.	ಎಸ್.
Truman	ಟ್ರೂಮನ್
Abdul	ಅಬ್ದುಲ್
muqsit	ಮುಕ್ಸೆತ್
Kazantzakis	ಕಝಾನ್‌ಝಾಕಿಸ್
Museum	ಮ್ಯೂಸಿಯಂ
Hollington	ಹೋಲಿಂಗ್ಟನ್
Westaim	ವೆಸ್ಟೈಮ್
Corporation	ಕಾರ್ಪೊರೇಶನ್
Walter	ವಾಲ್ಟರ್
Cronkite	ಕ್ರೋನ್ಕೈಟ್
Baawri	ಬಾವರೀ
Kurukshetra	ಕುರುಕ್ಷೇತ್ರ
Georgian	ಜಾರ್ಜಿಯನ್
Bay	ಬೇ
Bihar	ಬಿಹಾರ
Lynna	ಲಾಯ್ನಾ
Jahangir	ಜಹಂಗೀರ್
Aban	ಅಬಾನ್
LoydChiles	ಲಾಯ್ಡ್‌ಚಿಲೀಸ್
Dum	ಡಂ
Dum	ಡಂ
Cantonment	ಕಂಟೋನ್ಮೆಂಟ್
Aflatoon	ಅಫಲಾತೂನ್
Kowloon	ಕೌಲೂನ್
Reservoir	ರಿಜರ್ವಾಯರ್
Juhi	ಜುಹಿ
Milind	ಮಿಲಿಂದ್
Bridgeport	ಬ್ರಿಜ್‌ಪೋರ್ಟ್
Christian	ಕ್ರಿಶ್ಚಿಯನ್
Ankita	ಅಂಕಿತ
Danish	ಡ್ಯಾನಿಶ್
Dafiyah	ದಫಿಯಾ
Magenta	ಮಜಂತಾ
Daria	ಡರಿಯಾ
Atinderjeet.	ಅತೀಂದ್ರಜೀತ್
Kaduthuruthi	ಕಾಡುತುರುತಿ
Hats'	ಹ್ಯಾಟ್ಸ್
Russian	ರಶ್ಯನ್
War	ವಾರ್
Selena	ಸೆಲೆನಾ
Carlyn	ಕಾರ್ಲಿನ್
Iraaj	ಇರಾಜ್
Chandrashekhar	ಚಂದ್ರಶೇಖರ್
Azad	ಆಜಾದ್
Aaj	ಆಜ್
Ka	ಕಾ
Gundaraj	ಗುಂಡರಾಜ್
Rajneesh	ರಜನೀಶ್
Cumbres	ಕ್ಯುಬ್ರೆಸ್
de	ಡಿ
Monterrey	ಮಾಂಟಿರೆ
Devpura	ದೇವಪುರಾ
Ghar	ಘರ್
Akhir	ಆಖಿರ್
Ghar	ಘರ್
Hai	ಹೈ
Genero	ಜೆನಿರೊ
Yagyamaan	ಯಗ್ಯಮಾನ್
Robert	ರಾಬರ್ಟ್
Redford	ರೆಡ್‌ಫೋರ್ಡ್
Draupadi	ದ್ರೌಪದಿ
Bombay	ಬಾಂಬೆ
Town	ಟೌನ್
Maati	ಮಾಟಿ
Balidan	ಬಲಿದಾನ್
Ki	ಕಿ
Chitchor	ಚಿತ್‌ಚೋರ್
Antoinette	ಆಂಟಾಯ್ನೆಟ್
Karate	ಕರಾಟೆ
Duddhinagar	ದುದ್ಧಿನಗರ್
University	ಯುನಿವರ್ಸಿಟಿ
of	ಆಫ್
North	ನಾರ್ತ್
Carolina	ಕರೊಲಿನಾ
Talisma	ತಲಿಸ್ಮಾ
Commerzbank	ಕಾಮರ್ಝ್ ಬ್ಯಾಂಕ್
Mexico	ಮೆಕ್ಸಿಕೋ
City	ಸಿಟಿ
Avian	ಏವಿಯನ್
Dalia	ದಲಿಯಾ
Abdul	ಅಬ್ದುಲ್
wajeed	ವಜೀದ್
Fauladi	ಫೌಲಾದೀ
Mukka	ಮುಕ್ಕಾ
Bratislava	ಬ್ರಾಟಿಸ್ಲಾವಾ
Rizwan	ರಿಜ್ವಾನ್
New	ನ್ಯೂ
tavern	ಟವರ್ನ್
fort	ಫೋರ್ಟ್
Amay	ಅಮಯ್
Khurasiya	ಖುರಾಸಿಯಾ
Requin	ರಿಕ್ವಿನ್
Stephen	ಸ್ಟೀಫನ್
Fleming	ಫ್ಲೆಮಿಂಗ್
Punar	ಪುನಾರ್
Milan	ಮಿಲನ್
Angaraaj	ಅಂಗರಾಜ್
Charlotte	ಕಾರ್ಲೊಟ್
Darritola	ದಾರೀತೋಲಾ
Elie	ಈಲೀ
Allen	ಅಲೆನ್
Sohni	ಸೋಹ್ನಿ
Adrienne	ಎಡ್ರೀನ್
Saint	ಸೇಂಟ್
Croix	ಕ್ರೋಕ್ಸ್
Itni	ಇತನೀ
Si	ಸೀ
Baat	ಬಾತ್
Neil	ನೀಲ್
Johnson	ಜಾನ್ಸನ್
Graeme	ಗ್ರೀಮ್
Watson	ವ್ಯಾಟ್ಸನ್
Abdul	ಅಬ್ದುಲ್
muti	ಮುತಿ
Nicholas	ನಿಕೋಲಾಸ್
Appert	ಆಪರ್ಟ್
Award	ಅವಾರ್ಡ್
Mohammad	ಮೊಹಮ್ಮದ್
Hafeez	ಹಫೀಜ್
Nicholas	ನಿಕೊಲಸ್
Financial	ಫೈನಾನ್ಷಿಯಲ್
Chris	ಕ್ರಿಸ್
Lewis	ಲೆವಿಸ್
Meridian	ಮೆರಿಡಿಯನ್
School	ಸ್ಕೂಲ್
Times	ಟೈಮಸ್
Multimedia	ಮಲ್ಟಿಮೀಡಿಯ
Ummayyah	ಉಮ್ಮಯ್ಯಾ
South	ಸೌತ್
Korea	ಕೊರಿಯಾ
Shyamari	ಶ್ಯಮರಿ
Dick	ಡಿಕ್
Chaney	ಚೆನೀ
Padma	ಪದ್ಮ
Vibhushan	ವಿಭೂಷಣ
Gogte	ಗೋಗಟೆ
Charlot	ಕಾರ್ಲಟ್
Kavthekar	ಕಾವ್ತೇಕರ್
Phool	ಪೂಲ್
Khile	ಖಿಲೆ
Hain	ಹೈ
Gulshan	ಗುಲ್ಶನ್
Gulshan	ಗುಲ್ಶನ್
Prometheus	ಪ್ರೊಮೆಥಿಯಸ್
Award	ಅವಾರ್ಡ್
Patale	ಪಟಾಲೆ
Chango	ಚಾಂಗೋ
Rwenzori	ವೆನ್ಜೋರಿ
Mountains	ಮೌಂಟನ್ಸ್
Shumaysah	ಶುಮಾಷಾ
Ituran	ಇಟುರಾನ್
Location	ಲೊಕೇಶನ್
and	ಅಂಡ್
Control	ಕಂಟ್ರೋಲ್
Shobhana	ಶೋಭನಾ
Asif	ಆಸಿಫ್
Masood	ಮಸೂದ್
Aurat	ಔರತ್
Ka	ಕಾ
Inteqam	ಇಂತೆಕಾಮ್
Anshul	ಅಂಶುಲ್
Ghiyath	ಗಿಯಾಥ್
Fort	ಫೋರ್ಟ್
stanwix	ಸ್ಟ್ಯಾನ್‌ವಿಕ್ಸ್
Baddowal	ಬದ್ಧೋವಾಲಾ
Liberace	ಲಿಬರೇಸ್
Janjgir-Champa	ಜಾಂಜ್ಗಿರ್-ಚಂಪಾ
Nongstain	ನಾಂಗ್ ಸ್ಟೈನ್
Essar	ಎಸ್ಸಾರ್
Steel	ಸ್ಟೀಲ್
Kaleemah	ಕಲೀಮಾ
Ek	ಏಕ್
Thi	ಥಿ
Ladki	ಲಡಕಿ
Love	ಲವ್
Marriage	ಮ್ಯಾರೇಜ್
Roop	ರೂಪ್
Lekha	ಲೇಖಾ
Elsie	ಎಲ್ಸೀ
Strasburg	ಸ್ಟ್ರಾಸ್‌ಬರ್ಗ್
Sereno	ಸೆರೆನೋ
Athmah	ಆತ್ಮ
Ek	ಏಕ್
Adhuri	ಅಧೂರೀ
Kahani	ಕಹಾನಿ
Haathi	ಹಾಥಿ
Mere	ಮೆರೆ
Saathi	ಸಾಥಿ
Moonsilver	ಮೂನ್ಸಿಲ್ವರ್
Abdul	ಅಬ್ದುಲ್
mannaan	ಮನ್ನಾನ್
Nationawide	ನೇಶನಾವೈಡ್
Marcia	ಮಾರ್ಸಿಯಾ
Raigad	ರಾಯ್‌ಗಢ್
fort	ಫೋರ್ಟ್
Sayfiyy	ಸೇಫೀ
Glenmark	ಗ್ಲೆನ್ಮಾರ್ಕ್
Pharmaceuticals	ಫಾರ್ಮೆಸಿಟಿಕಲ್ಸ್
Matwani	ಮಟವಾಣಿ
Arlen	ಅರ್ಲೆನ್
Aachaarysuta	ಆಚಾರ್ಯಸುತ
Mount	ಮೌಂಟ್
Kenya	ಕೀನ್ಯಾ
Khaleel	ಖಲೀಲ್
Jenna	ಜೆನ್ನಾ
Madhav	ಮಾಧವ
Trevor	ಟ್ರೆವರ್
Laughlin	ಲಾಫಿನ್
Pransukh	ಪ್ರಾಣಸುಖ
Cerelia	ಸೆರೆಲಿಯಾ
Yorkshire	ಯಾರ್ಕ್‌ಶೈರ್
Dales	ಡೇಲ್ಸ್
Armen	ಆರ್ಮೆನ್
Stacie	ಸ್ಟೇಸಿ
Buffalo	ಬಫೆಲೋ
Acton	ಏಕ್ಟನ್
Pope	ಪೋಪ್
John	ಜಾನ್
Paul	ಪೌಲ್
II	II
Cottle	ಕಾಟ್ಟಲ್
Order	ಆರ್ಡರ್
of	ಆಫ್
William	ವಿಲಿಯಂ
Jonathan	ಜೋನಾಥನ್
Agnew	ಆಗ್ನ್ಯೂ
Dasna	ದಸನಾ
Agathaa	ಅಗಥಾ
Corey	ಕೋರೀ
Collymore	ಕಾಲಿಮೋರ್
Cross	ಕ್ರಾಸ್
Country	ಕಂಟ್ರಿ
Shair	ಶಾಯರ್
Roger	ರೋಜರ್
Telemachus	ಟೆಲಿಮಚುಸ್
Damia	ಡಾಮಿಯಾ
Mehmaan	ಮೆಹ್ಮಾನ್
Fayyadh	ಫೈಯಾದ್
Iron	ಐರನ್
Duke	ಡ್ಯೂಕ್
Amoghaa	ಅಮೋಘಾ
Rockford	ರಾಕ್ ಫರ್ಡ್
Styles	ಸ್ಟೈಲ್ಸ್
Jerry	ಜೆರಿ
Falwell	ಫಾಲ್ವೆಲ್
Doodh	ದೂಧ್
Ka	ಕಾ
Karz	ಕರ್ಜಾ
Dreama	ಡ್ರೀಮಾ
Mark	ಮಾರ್ಕ್
Greatbatch	ಗ್ರೇಟ್‌ಬ್ಯಾಚ್
Colour	ಕಲರ್
Chem	ಕೆಮ್
Alibaba	ಅಲೀಬಾಬಾ
Dev	ದೇವ್
kumar	ಕುಮಾರ್
University	ಯುನಿವರ್ಸಿಟಿ
of	ಆಫ್
Missouri	ಮಿಸ್ಸೌರಿ
Aangan	ಆಂಗನ್
Ki	ಕೀ
Kali	ಕಲೀ
Balraam	ಬಲರಾಮ್
Kismat	ಕಿಸ್ಮತ್
Palat	ಪಲಟ್
Ke	ಕೆ
Dekh	ದೇಖ್
Inayat	ಇನಾಯತ್
Khan	ಖಾನ್
Murdoch	ಮುರ್ಡೋಕ್
University	ಯುನಿವರ್ಸಿಟಿ
Shanon	ಶೆನನ್
Andha	ಅಂಧಾ
Yudh	ಯುದ್ಧ್
Andrea	ಆಂಡ್ರಿಯಾ
Doria	ಡೋರಿಯಾ
Asli	ಅಸಲೀ
Naqli	ನಕಲೀ
Aachaaryanandanaa	ಆಚಾರ್ಯನಂದನಾ
Ghaisas	ಘೈಸಾಸ್
Patil	ಪಾಟಿಲ್
Miss	ಮಿಸ್
Bombay	ಬಾಂಬೆ
Tristana	ತ್ರಿಸ್ತನಾ
Suneeti	ಸುನೀತಿ
Aaditynandan	ಆದಿತ್ಯನಂದನ್
Naami	ನಾಮಿ
Chor	ಚೋರ್
Michael	ಮೈಕೆಲ್
Owens	ಓವೆನ್ಸ್
Aalha	ಆಲ್ಹಾ
Udal	ಉದಲ್
Azamat	ಅಜಮತ್
Uran	ಉರನ್
Vidor	ವಿದೋರ್
Itimad	ಇತಿಮಾದ್
Mehrabani	ಮೆಹರಬಾನೀ
Phir	ಫಿರ್
Aya	ಆಯಾ
Toofan	ತೂಫಾನ್
Canadian	ಕೆನಡಿಯನ್
Poets	ಪೋಯೆಟ್ಸ್
Award	ಅವಾರ್ಡ್
Fidel	ಫಿಡೆಲ್
Nain	ನೈನ್
Mile	ಮಿಲೆ
Chain	ಚೈನ್
Kahan	ಕಹಾ
Shindi	ಶಿಂದಿ
Sandeepan	ಸಂದೀಪನ್
Graham	ಗ್ರಹಾಂ
Roope	ರೂಪ್
James	ಜೇಮ್ಸ್
Whitaker	ವ್ಹಿಟಾಕೇರ್
Muneeb	ಮುನೀಬ್
Zagiri	ಜಾಗಿರಿ
John	ಜಾನ್
Popal	ಪೋಪಾಲ್
Sakhi	ಸಖೀ
Robin	ರಾಬಿನ್
Koc	ಕಾಕ್
Holding	ಹೋಲ್ಡಿಂಗ್
Roseanne	ರೋಸಿಯಾನ್
Rodney	ರಾಡ್ನೆ
Sarwari	ಸಾರ್ವರಿ
Landis	ಲಂಡಿಸ್
Majaal	ಮಜಾಲ್
Verrill	ವೆರಿಲ್ಲಾ
Anandmayee	ಆನಂದಮಯೀ
Karouli	ಕರೌಲಿ
Time	ಟೈಮ್
Warner	ವಾರ್ನರ್
Lakshmipathy	ಲಕ್ಷ್ಮಿಪತಿ
Balaji	ಬಾಲಾಜಿ
Syneron	ಸೈನಿರಾನ್
Medical	ಮೆಡಿಕಲ್
Kotwal	ಕೋತ್ವಾಲ್
Aachaarynandan	ಆಚಾರ್ಯನಂದನ್
Timken	ಟಿಮ್‌ಕಿನ್
Guglani	ಗುಗ್ಲಾಣಿ
Suvarchalaa	ಸುವರ್ಚಲಾ
Hummingbird	ಹಮ್ಮಿಂಗ್‌ಬರ್ಡ್
Favian	ಫಾವಿಯಾನ್
Marcs	ಮಾರ್ಕಸ್
Mcguire	ಮೆಕ್‌ಗ್ವಾಯರ್
Bhatti	ಭಟ್ಟಿ
Ram	ರಾಮ್
Tere	ತೇರಿ
Kitne	ಕಿತನೆ
Naam	ನಾಮ್
Grahan	ಗ್ರಹಣ್
Danga	ದಂಗಾ
Fasad	ಫಸಾದ್
Matsendra	ಮತ್ಸೇಂದ್ರ
Tictoria	ಟಿಕ್ಟೋರಿಯಾ
Order	ಆರ್ಡರ್
of	ಆಫ್
the	ದ
October	ಅಕ್ಟೋಬರ್
Revolution	ರೆವೆಲ್ಯೂಶನ್
Chanton	ಚಾಂಟನ್
Roti	ರೋಟಿ
Kapada	ಕಪಡಾ
Aur	ಔರ್
Makan	ಮಕಾನ್
James	ಜೇಮ್ಸ್
Franklin	ಫ್ರಾಂಕ್ಲಿನ್
Fort	ಫೋರ್ಟ್
mchenry	ಮ್ಯಾಕೆನ್ರಿ
Mohin	ಮೊಹಿನ್
Everest	ಎವರೆಸ್ಟ್
Ind	ಇಂಡ್
Long	ಲಾಂಗ್
Beach	ಬೀಚ್
Tadhg	ತಾದ್ಗ್
Phir	ಫಿರ್
Aayee	ಆಯಿ
Barsat	ಬರಸಾತ್
Anagh	ಅನಘ್
Dhoble	ದೋಬ್ಲೆ
Saajan	ಸಾಜನ್
Mere	ಮೇರೆ
Mein	ಮೇ
Saajan	ಸಾಜನ್
Ki	ಕಿ
Iren	ಐರಿನ್
Simon	ಸೈಮನ್
Jones	ಜಾನ್ಸ್
Lao	ಲಾವೋ
Tzu	ಸು
Order	ಆರ್ಡರ್
of	ಆಫ್
Agricultural,	ಆಗ್ರಿಕಲ್ಚರಲ್,
Commercial	ಕಮರ್ಶಿಯಲ್
or	ಆರ್
Industrial	ಇಂಡಸ್ಟ್ರಿಯಲ್
Merit	ಮೆರಿಟ್
Mera	ಮೇರಾ
Pati	ಬತಿ
Sirf	ಸಿರ್ಫ್
Mera	ಮೇರಾ
Hai	ಹೈ
Luxor	ಲಕ್ಸರ್
Bamanheri	ಬಮನ್‌ಹೇರಾ
Bank	ಬ್ಯಾಂಕ್
Robbery	ರಾಬರಿ
University	ಯುನಿವರ್ಸಿಟಿ
of	ಆಫ್
Birmingham	ಬರ್ಮಿಂಗ್ಹಾಮ್
Aadmi	ಆದಮಿ
Sohni	ಸೋಹನೀ
Mahiwal	ಮಹಿವಾಲ್
Higher	ಹೈಯರ್
Ground	ಗ್ರೌಂಡ್
Apna	ಅಪ್ನಾ
Desh	ದೇಶ್
Paraye	ಪರಾಯೆ
Log	ಲೋಗ್
The	ದಿ
Meredith	ಮೆರಿಡ್ತ್
Cup	ಕಪ್
Fort	ಫೋರ್ಟ್
mackinac	ಮ್ಯಾಕಿನಕ್
James	ಜೇಮ್ಸ್
Dean	ಡೀನ್
Resurrection	ರಿಸರಕ್ಷನ್
Lutheran	ಲುಥೆರಾನ್
Sharan	ಶರಣ್
lenaa	ಲೆನಾ
Bharat	ಭಾರತ್
Milap	ಮಿಲಾಪ್
Nanjing	ನಂಜಿಂಗ್
Museum	ಮ್ಯೂಸಿಯಂ
Mufti	ಮುಫ್ತಿ
Onex	ಓನೆಕ್ಸ್
Afadal	ಅಫದಲ್
Scuba	ಸ್ಕ್ಯೂಬಾ
diving	ಡೈವಿಂಗ್
Brijmohan	ಬೃಜಮೋಹನ್
First	ಫಸ್ಟ್
Southern	ಸದರ್ನ್
Baptist	ಬ್ಯಾಪ್ಟಿಸ್ಟ್
Zimmedaar	ಜಿಮ್ಮೆದಾರ್
University	ಯುನಿವರ್ಸಿಟಿ
of	ಆಫ್
Kent	ಕೆಂಟ್
Sagittarius	ಸಾಜಿಟೇರಿಯಸ್
Kooner	ಕೂನೇರ್
Salim	ಸಲೀಮ್
Shotley	ಶೋಟ್ಲೆ
battery	ಬ್ಯಾಟರಿ
Gelsey	ಗೆಲ್ಸೀ
Angelique	ಏಂಜೆಲಿಕ್
Khidki	ಖಿಡಕಿ
Navios	ನೇವಿಯಸ್
Maritime	ಮೆರಿಟೈಮ್
Holdings	ಹೋಲ್ಡಿಂಗ್ಸ್
James	ಜೇಮ್ಸ್
Anderson	ಆಂಡರ್ಸನ್
Snow	ಸ್ನೋ
Korde	ಕೋರ್ಡೆ
Ambarish	ಅಂಬರೀಶ್
Sapna	ಸಪ್ನಾ
Dinkar	ದಿನಕರ್
Radium	ರೇಡಿಯಂ
Little	ಲಿಟ್ಲ್
Flock	ಫ್ಲಾಕ್
Baptist	ಬ್ಯಾಪ್ಟಿಸ್ಟ್
Lilika	ಲಿಲಿಕಾ
Lumps	ಲುಂಪ್ಸ್
fort	ಫೋರ್ಟ್
Laccadive	ಲಕಾಡೈವ್
Carolina	ಕ್ಯಾರೊಲಿನಾ
shag	ಶಾಗ್
Paisa	ಪೈಸಾ
Ya	ಯಾ
Pyar	ಪ್ಯಾರ್
The	ದಿ
Living	ಲಿವಿಂಗ್
Well	ವೆಲ್
United	ಯುನೈಟೆಡ್
Methodist	ಮೆಥಡಿಸ್ಟ್
Mark	ಮಾರ್ಕ್
Twain	ಟ್ವೈನ್
Aabirah	ಆಬಿರಾ
Genera	ಜೆನೀರಾ
Family	ಫ್ಯಾಮಿಲಿ
Jeena	ಜೀನಾ
Yahan	ಯಹಾ
Computer	ಕಂಪ್ಯೂಟರ್
Sciences	ಸೈನ್ಸಸ್
Ken	ಕೆನ್
Rutherford	ರದರ್‌ಫರ್ಡ್
Baijayanthi	ಬೈಜಯಂತಿ
Bhedi	ಭೇದಿ
Lutera	ಲುಟೇರಾ
National	ನ್ಯಾಶನಲ್
Medal	ಮೆಡಲ್
of	ಆಫ್
Science	ಸೈನ್ಸ್
Cape	ಕೇಪ್
Breton	ಬ್ರೆಟೊನ್
Paisa	ಪೈಸಾ
Yeh	ಯೆ
Paisa	ಪೈಸಾ
Urja	ಊರ್ಜಾ
Imaan	ಈಮಾನ್
Dharam	ಧರಮ್
National	ನ್ಯಾಶನಲ್
Book	ಬುಕ್
Critics	ಕ್ರಿಟಿಕ್ಸ್
Circle	ಸರ್ಕಲ್
Award	ಅವಾರ್ಡ್
Nadine	ನಾದಿನ್
Gordimer	ಗಾರ್ಡಿಮರ್
Shamasher	ಶಮಶೀರ್
Christmas	ಕ್ರಿಸ್ಮಸ್
Island	ಐಲ್ಯಾಂಡ್
Mount	ಮೌಂಟ್
Revelstoke	ರೆವಲ್‌ಸ್ಟೋಕ್
Bancroft	ಬ್ಯಾಂಕ್ರಾಫ್ಟ್
Prize	ಪ್ರೈಜ್
Shell	ಶೆಲ್
Pravin	ಪ್ರವೀಣ್
Amre	ಆಮ್ರೆ
Police	ಪೊಲೀಸ್
Station	ಸ್ಟೇಶನ್
Fort	ಫೋರ್ಟ್
macon	ಮ್ಯಾಕೊನ್
Isa	ಇಸಾ
Shareef	ಶರೀಫ್
Adolf	ಅಡಾಲ್ಫ್
Hitler	ಹಿಟ್ಲರ್
Bank	ಬ್ಯಾಂಕ್
of	ಆಫ್
America	ಅಮೆರಿಕ
Center	ಸೆಂಟರ್
Stan	ಸ್ಟಾನ್
MacArthur	ಮ್ಯಾಕ್‌ಆರ್ಥರ್
Fellowship	ಫೆಲೋಶಿಪ್
Vardha	ವರ್ಧಾ
Musafir	ಮುಸಾಫಿರ್
Khana	ಖಾನಾ
Austral	ಆಸ್ಟ್ರಲ್
Gilliam	ಗಿಲ್ಲಿಯಮ್
Panchkula	ಪಂಚಕುಲಾ
Lavaa	ಲಾವಾ
Sauhaard	ಸೌಹಾರ್ದ್
Arunachal	ಅರುಣಾಚಲ
Inspector	ಇನ್ಸ್‌ಪೆಕ್ಟರ್
Alok	ಅಲೋಕ್
Vaageeshaa	ವಾಗೀಶ
Anand	ಆನಂದ್
Nagar	ನಗರ್
Fatehabad	ಫತೇಬಾದ್
Junction	ಜಂಕ್ಷನ್
Puranik	ಪುರಾಣಿಕ್
Sandhaar	ಸಂಧಾರ್
Rangeela	ರಂಗೀಲಾ
Sanjh	ಸಾಂಝ್
savera	ಸವೇರಾ
Ghaniyah	ಗನಿಯಾಹ್
Tusharkana	ತುಷಾರಕನಾ
Andros	ಆಂಡ್ರೋಸ್
Museum	ಮ್ಯೂಸಿಯಂ
of	ಆಫ್
Modern	ಮಾಡ್ರನ್
Art	ಆರ್ಟ್
Mere	ಮೇರೆ
Garib	ಗರೀಬ್
Nawaz	ನವಾಜ್
Trishna	ತೃಷ್ಣಾ
Shivnarine	ಶಿವನಾರಾಯಣ್
Chanderpaul	ಚಂದ್ರಪಾಲ್
Jaisukh	ಜೈಸುಖ್
Mudrika	ಮುದ್ರಿಕ
Pipe	ಪೈಪ್
Smoker	ಸ್ಮೋಕರ್
of	ಆಫ್
the	ದಿ
Year	ಇಯರ್
Nikunj	ನಿಕುಂಜ್
Azhar	ಅಜರ್
Hossain	ಹುಸೇನ್
Adhiwar	ಅಧಿವರ್
Miraj	ಮಿರಜ್
Charlton	ಚಾರ್ಲಟನ್
Heston	ಹೆಸ್ಟಾನ್
Rajnigandha	ರಾಜನೀಗಂಧಾ
Muslim	ಮುಸ್ಲಿಂ
Diksha	ದೀಕ್ಷಾ
Fort	ಫೋರ್ಟ್
bokar	ಬೋಕರ್
Khadijah	ಖದೀಜಾ
Pyar	ಪ್ಯಾರ್
Ki	ಕಿ
Maar	ಮಾರ್
Kedarnath	ಕೇದಾರನಾಥ
Jyotirlinga	ಜ್ಯೋತಿರ್ಲಿಂಗ
Modern	ಮಾಡರ್ನ್
Youth	ಯೂತ್
Trude	ಟ್ರೂಡ್
Mogadishu	ಮೊಗಾದಿಶು
Mujaffarnagar	ಮುಜಾಫರನಗರ್
Kalinjar	ಕಲಿಂಜರ್
Rajput	ರಾಜಪೂತ್
Peking	ಪೀಕಿಂಗ್
University	ಯುನಿವರ್ಸಿಟಿ
Mahindra	ಮಹೀಂದ್ರಾ
Gesco	ಜೆಸ್ಕೊ
Developers	ಡೆವಲಪರ್ಸ್
Gehrayee	ಗಹರಾಯಿ
Asranada	ಅರ್ಸನಾಡಾ
Bank	ಬ್ಯಾಂಕ್
of	ಆಫ್
India	ಇಂಡಿಯಾ
Kassia	ಕಾಸಿಯಾ
Giuseppe	ಗ್ಯುಸೆಪ್
Miraglia	ಮಿರಾಗ್ಲಿಯಾ
Taaraa	ತಾರಾ
Brijesh	ಬ್ರಿಜೇಶ್
Abhra	ಅಭ್ರ
Don	ಡಾನ್
Johnson	ಜಾನ್ಸನ್
Shyla	ಶೈಲಾ
Connley	ಕಾನ್ಲೀ
Oojam	ಊಜಂ
Jeanne	ಜಿಯನ್ನಾ
Chubu	ಚುಬು
Electric	ಎಲೆಕ್ಟ್ರಿಕ್
Power	ಪವರ್
Mad	ಮದ್
Bhare	ಭರೆ
Nain	ನೈನ್
Awaam	ಅವಾಮ್
Apni	ಅಪ್ನಿ
Chhaya	ಛಾಯಾ
Mumtaz	ಮುಮತಾಜ್
Begum	ಬೇಗಮ್
Chyulu	ಚುಯುಲು
Hills	ಹಿಲ್ಸ್
Fossilized	ಫಾಸಿಲಿಜದ್
Forest	ಫಾರೆಸ್ಟ್
of	ಆಫ್
Lesvos	ಲೆವೋಸ್
Museum	ಮ್ಯೂಸಿಯಂ
of	ಆಫ್
Natural	ನ್ಯಾಚುರಲ್
History	ಹಿಸ್ಟರಿ
Balkrishna	ಬಾಲಕೃಷ್ಣ
Woodham	ವುಡ್‌ಹ್ಯಾಮ್
Maa	ಮಾ
Ka	ಕಾ
Anchal	ಆಂಚಲ್
Tarakeshwar	ತಾರಕೇಶ್ವರ
Anuradhaa	ಅನುರಾಧಾ
Hum	ಹಮ್
Diwane	ದೀವಾನೆ
Fort	ಫೋರ್ಟ್
edmonton	ಎಡ್ಮಂಟನ್
Mississippi	ಮಿಸಿಸ್ಸಿಪ್ಪಿ
River	ರಿವರ್
Sea	ಸೀ
of	ಆಫ್
Okhotsk	ಒಕೋಟ್ಸ್
Krishnamurthy	ಕೃಷ್ಣಮೂರ್ತಿ
Khush	ಖುಶ್
Naseeb	ನಸೀಬ್
Arulchelvan	ಅರುಳ್‌ಚೆಲ್ವನ್
Wimborn	ವಿಮ್‌ಬಾರ್ನ್
Samsung	ಸ್ಯಾಮ್‌ಸಂಗ್
Museum	ಮ್ಯೂಸಿಯಂ
Trilok	ತ್ರಿಲೋಕ್
Yogen_dar	ಯೋಗೇಂದ್ರ
Summit	ಸಮಿತ್
Awards	ಅವಾರ್ಡ್ಸ್
Sultanpuria	ಸುಲ್ತಾನ್‌ಪುರಿಯಾ
Sagheer	ಸಗೀರ್
Taranekar	ತರಾಣೆಕರ್
Catherine	ಕೆಥರೀನ್
Balaajee	ಬಾಲಾಜೀ
Deacon	ಡೀಕನ್
Jola	ಜೋಲಾ
Farhan	ಫರಾನ್
Adil	ಅದಿಲ್
Raipur	ರಾಯ್ಪುರ್
Manchester	ಮ್ಯಾಂಚೆಸ್ಟರ್
Goonj	ಗೂಂಜ್
Meharbani	ಮೆಹರಬಾನೀ
Cliffe	ಕ್ಲಿಫ್
fort	ಫೋರ್ಟ್
Ishita	ಇಶಿತಾ
Suvarnarekha	ಸುವರ್ಣಲೇಖ
Jet-skiing	ಜೆಟ್-ಸ್ಕೀಯಿಂಗ್
Lutf	ಲುತ್ಫ್
Marlon	ಮಾರ್ಲನ್
Vonhagt	ವಾನಾಟ್
Kaiyo	ಕೈಯೊ
Raj	ರಾಜ್
Laxmi	ಲಕ್ಷ್ಮಿ
Zakir	ಜಕೀರ್
Khan	ಖಾನ್
Dharamsheel	ಧರಂಶೀಲ್
Purana	ಪುರಾನಾ
Mandir	ಮಂದಿರ್
Lola	ಲೋಲಾ
Strait	ಸ್ಟ್ರೈಟ್
of	ಆಫ್
Dover	ಡೊವರ್
Yoko	ಯೋಕೋ
Ono	ಓನೋ
Marian	ಮೆರಿಯನ್
Engel	ಇಂಜಿಲ್
Award	ಅವಾರ್ಡ್
Prince	ಪ್ರಿನ್ಸ್
George	ಜಾರ್ಜ್
Christian	ಕ್ರಿಶ್ಚಿಯನ್
Sayid	ಸಾಯಿದ್
Badshahnagar	ಬಾದಶಾನಗರ್
Dolti	ಡೋಲತೀ
Naiya	ನೈಯಾ
Bishan	ಬಿಶನ್
Balawant	ಬಲವಂತ್
Pyaremohan	ಪ್ಯಾರೆಮೋಹನ್
Gosavi	ಗೋಸಾವಿ
Chilbila	ಚಿಲ್ಬಿಲಾ
Junction	ಜಂಕ್ಷನ್
Marcena	ಮಾರ್ಸೀನಾ
Ivi	ಇವಿ
Sacred	ಸೇಕ್ರೆಡ್
Heart	ಹಾರ್ಟ್
Catholic	ಕೆಥೋಲಿಕ್
Ivo	ಇವೋ
Abdus	ಅಬ್ದುಸ್
saboor	ಸಬೂರ್
Ravindra	ರವೀಂದ್ರ
Guitarron	ಗಿಟಾರೊನ್
Mcdonalds	ಮೆಕ್‌ಡೊನಾಲ್ಡ್ಸ್
Louis	ಲೂಯಿಸ್
Fisher	ಫಿಶರ್
Hamjoli	ಹಾಮ್‌ಜೋಲಿ
Gurr	ಗುರ್
Arya	ಆರ್ಯ
Lakshana	ಲಕ್ಷಣ
Mradaa	ಮೃದಾ
Nola	ನೋಲಾ
Museum	ಮ್ಯೂಸಿಯಂ
of	ಆಫ್
the	ದ
city	ಸಿಟಿ
of	ಆಫ್
New	ನ್ಯೂ
York	ಯಾರ್ಕ್
Batuque	ಬಟೂಕಿ
Sartaj	ಸರತಾಜ್
Baghi	ಬಾಗೀ
Haseena	ಹಸೀನಾ
Jaali Note	ಜಾಲಿನೋಟ್
Taner	ತನೇರ್
Ansari	ಅನ್ಸಾರಿ
Mere	ಮೇರೆ
Lal	ಲಾಲ್
Toboggan	ಟೋಬೋಗನ್
Congo	ಕಾಂಗೋ
Brad	ಬ್ರಾಡ್
Williams	ವಿಲಿಯಮ್ಸ್
Yamunanagar	ಯಮುನಾನಗರ್
Sanne	ಸೇನಿ
Geetanjali	ಗೀತಾಂಜಲಿ
Naomi	ನಯೋಮಿ
Awards	ಅವಾರ್ಡ್ಸ್
Zaheerah	ಜಹೀರಾ
Norah	ನೋರಾಹ್
Central	ಸೆಂಟ್ರಲ್
America	ಅಮೆರಿಕ
Maya	ಮಾಯಾ
Prayashchit	ಪ್ರಾಯಶ್ಚಿತ್
Tourville	ಟೋರ್ವಿಲೆ
Prerana	ಪ್ರೇರಣಾ
Fabian	ಫೇಬಿಯನ್
Calliope	ಕ್ಯಾಲಿಯೋಪ್
Lalach	ಲಾಲಚ್
Ashish	ಆಶಿಷ್
Haimvat	ಹೈಮ್‌ವತ್
Jeevan	ಜೀವನ್
Naiya	ನೈಯಾ
Hud	ಹುದ್
Jackvillen	ಜ್ಯಾಕ್‌ವಿಲಿನ್
Kennedy	ಕೆನೆಡಿ
Apna	ಅಪ್ನಾ
Hath	ಹಾಥ್
Jagannath	ಜಗನ್ನಾಥ್
Aankhen	ಆಂಖೆ
The	ದಿ
Royal	ರಾಯಲ್
Norwegian	ನಾರ್ವೇಜಿಯನ್
Order	ಆರ್ಡರ್
of	ಆಫ್
Saint	ಸೇಂಟ್
Olav	ಒಲಾವ್
Jasbeer	ಜಸ್ಬೀರ್
Sene	ಸೆನಿ
Dhavle	ಢವಲೆ
Tata	ಟಾಟಾ
Metaliks	ಮೆಟಾಲಿಕ್ಸ್
Mirari	ಮಿರರಿ
Dave	ಡೇವ್
Callaghan	ಕಾಲಘನ್
Robin	ರಾಬಿನ್
Singh	ಸಿಂಗ್
Anwar	ಅನ್ವರ್
Hossain	ಹುಸೇನ್
Brinda	ಬ್ರಿಂದಾ
The	ದ
Trump	ಟ್ರಂಪ್
building	ಬಿಲ್ಡಿಂಗ್
Silicon	ಸಿಲಿಕಾನ್
Dhampur	ಧಾಮಪುರ್
Sugar	ಶುಗರ್
Jalianwala	ಜಲಿಯನ್‌ವಾಲಾ
Bagh	ಬಾಗ್
Ki	ಕಿ
Jyoti	ಜ್ಯೋತಿ
Golmaal	ಗೋಲ್ಮಾಲ್
Air-India	ಏರ್-ಇಂಡಿಯಾ
Seamus	ಸಿಮಸ್
Apte	ಆಪ್ಟೆ
Capilano	ಕ್ಯಾಪಿಲಾನೊ
Suspension	ಸಸ್ಪೆನ್ಷನ್
Jui	ಜುಯ್
Erna	ಎರ್ನಾ
Meri	ಮೇರಿ
Lalkaar	ಲಲಕಾರ್
Landmolen	ಲ್ಯಾಂಡ್‌ಮೋಲೆನ್
Dirk	ಡರ್ಕ್
Wellham	ವೆಲಹಮ್
Modesty	ಮೊಡೆಸ್ಟಿ
Centimos	ಸೆಂಟಿಮೊಸ್
Mahaabhuj	ಮಹಾಭುಜ್
Groszy	ಗ್ರಾಸಿ
Kevin	ಕೆವಿನ್
Duers	ಡ್ಯುಯರ್ಸ್
Marriage	ಮ್ಯಾರೇಜ್
Bureau	ಬ್ಯೂರೊ
Lut	ಲುತ್
Shyama	ಶ್ಯಾಮ
Alan	ಅಲನ್
Turner	ಟರ್ನರ್
Ur-itreesh	ಉರ್-ಇತ್ರೀಶ್
Raat	ರಾತ್
Ki	ಕೆ
Rani	ರಾನಿ
Pearson	ಪಿಯರ್ಸನ್
Medal	ಮೆಡಲ್
of	ಆಫ್
Peace	ಪೀಸ್
University	ಯುನಿವರ್ಸಿಟಿ
of	ಆಫ್
Edinburgh	ಎಡಿನ್‌ಬರ್ಗ್
Bowden	ಬೌಡೆನ್
fort	ಫೋರ್ಟ್
Nellis	ನೆಲ್ಲಿಸ್
Track	ಟ್ರ್ಯಾಕ್
and	ಎಂಡ್
Field	ಫೀಲ್ಡ್
Bazpur	ಬಾಜ್‌ಪುರ್
Two	ಟು
International	ಇಂಟರ್ನ್ಯಾಷನಲ್
Finance	ಫೈನಾನ್ಸ್
Centre	ಸೆಂಟರ್
Andrew	ಆಂಡ್ರೂ
Flintoff	ಫ್ಲಿಂಟಾಫ್
Oud	ಊಡ್
Dion	ಡಯನ್
Nash	ನ್ಯಾಷ್
China	ಚೀನಾ
National	ನ್ಯಾಷನಲ್
Petroleum	ಪೆಟ್ರೋಲಿಯಂ
Fort	ಫೋರ್ಟ್
amsterdam	ಆಮ್‌ಸ್ಟರ್‌ಡ್ಯಾಮ್
Barnett	ಬಾರ್ನೆಟ್
Karpe	ಕರ್ಪೆ
Gohpur	ಗೋಹಪುರ್
Ek	ಏಕ್
Khilari	ಖಿಲಾಡಿ
Bawan	ಬಾವನ್
Pattey	ಪತ್ತೆ
Theophilus	ಥಿಯೋಫಿಲಸ್
Bansuri	ಬಾನ್ಸುರಿ
Kineta	ಕಿನೆಟಾ
Harendra	ಹರೇಂದ್ರ
Wylie	ವೈಲಿ
Edakkad	ಇದಕ್ಕಾಡ್
Agape	ಅಗಾಪೆ
Guy	ಗಯ್
Whittall	ವಿಟ್ಟಾಲ್
Aya	ಆಯಾ
Toofan	ತೂಫಾನ್
Julia	ಜೂಲಿಯಾ
Child	ಚೈಲ್ಡ್
Corporation	ಕಾರ್ಪೊರೇಶನ್
Bank	ಬ್ಯಾಂಕ್
Marimbas	ಮರಿಂಬಸ್
Cadbury's	ಕ್ಯಾಡ್ಬರೀಸ್
River	ರಿವರ್
Phoenix	ಫೀನಿಕ್ಸ್
Boca	ಬೋಕಾ
Raton	ರಾಟನ್
Community	ಕಮ್ಯುನಿಟಿ
Rafiah	ರಫಿಯಾ
Syed	ಸಯ್ಯದ್
Kirmani	ಕೀರ್ಮಾನಿ
Lataaparn	ಲತಾಪರ್ಣ
Balawali	ಬಲಾವಾಲಿ
Kaash	ಕಾಶ್
Millicent	ಮಿಲ್ಲಿಸೆಂಟ್
Roop	ರೂಪ್
Basant	ಬಸಂತ್
Glide	ಗ್ಲೈಡ್
Raajapaal	ರಾಜಪಾಲ್
Hertog	ಹೆರ್ಟಾಗ್
Hendrik	ಹೆಂಡ್ರಿಕ್
Aankhon	ಆಂಖೋ
Annkhon	ಆಂಖೋ
Mein	ಮೆ
Sanskriti	ಸಂಸ್ಕೃತಿ
Guj	ಗುಜ್
Alkali	ಅಲ್‌ಕಾಲಿ
Raton	ರಾತೋಂ
Ka	ಕಾ
Raja	ರಾಜಾ
Sabz	ಸಬ್ಜ್
Baag	ಬಾಗ್
Pinjra	ಪಿಂಜರಾ
Leagues	ಲೀಗ್ಸ್
Jack	ಜಾಕ್
Richards	ರಿಚರ್ಡ್ಸ್
Dirk	ಡಿರ್ಕ್
Viljoen	ವಿಲಿಜಿಯೊನ್
Eavan	ಈವಾನ್
Global	ಗ್ಲೋಬಲ್
Crossing	ಕ್ರಾಸಿಂಗ್
Pyar	ಪ್ಯಾರ್
Paap	ಪಾಪ್
Nahin	ನಹೀ
Jacqui	ಜ್ಯಾಕ್ಯೂ
Babruysk	ಬಬ್ರುಸ್ಕ್
fortress	ಫೋಟ್ರೆಸ್
Devdharkar	ದೇವಧರ್ಕರ್
Spiel	ಸ್ಪಿಲ್
des	ಡೆಸ್
Jahres	ಜಹ್ರೆಸ್
Agar	ಅಗರ್
Tum	ತುಮ್
Na	ನಾ
Hote	ಹೋತೆ
Adhikar	ಅಧಿಕಾರ್
Sooraj	ಸೂರಜ್
Royal	ರಾಯಲ್
Mail	ಮೈಲ್
Holdings	ಹೋಲ್ಡಿಂಗ್ಸ್
Nachiyar	ನಾಚಿಯಾರ್
Koil	ಕೋಯಿಲ್
Nalgoda	ನಲ್ಗೋದಾ
Jecy	ಜೇಸಿ
James	ಜೇಮ್ಸ್
Bahgat	ಬಹಗತ್
Antarnaad	ಅಂತರ್‌ನಾದ್
Walden	ವಾಲ್ಡನ್
Tirupatisaram	ತಿರುಪತಿಸಾರಂ
Bahira	ಬಹಿರಾ
Mishima	ಮಿಶಿಮಾ
Abhiroop	ಅಭಿರೂಪ್
Porttipahta	ಪೋರ್ತಿಪಹ್ತಾ
reservoir	ರಿಜರ್ವಾಯರ್
Ronna	ರೊನ್ನಾ
Bexar	ಬೆಕ್ಸರ್
Juno	ಜುನೊ
Award	ಅವಾರ್ಡ್
Abdus	ಅಬ್ದುಸ್
salaam	ಸಲಾಂ
Vaal	ವಾಲ್
dam	ಡ್ಯಾಮ್
Zizi	ಜಿಜೀ
Jeeval	ಜೀವಲ್
Mera	ಮೇರಾ
Lahoo	ಲಹೂ
Atlas	ಅಟ್ಲಾಸ್
Copco	ಕೋಪ್ಕೋ
Apna	ಅಪ್ನಾ
Paraya	ಪರಾಯಾ
Sarwate	ಸಾರ್ವಾತೆ
Tejaa	ತೇಜಾ
Darwin	ಡಾರ್ವಿನ್
Awards	ಅವಾರ್ಡ್ಸ್
Kodasalli	ಕೊಡಸಲ್ಲಿ
Dam	ಡ್ಯಾಮ್
Mangal	ಮಂಗಲ್
Jantar	ಜಂತರ್
Mantar	ಮಂತರ್
Glynn	ಗ್ಲೆನ್
Fort	ಫೋರ್ಟ್
tregantle	ಟ್ರೆಗಂಟಲ್
Jewish	ಜ್ಯುಯಿಶ್
Museum	ಮ್ಯೂಸಿಯಂ
Yavalkar	ಯವಾಲ್ಕರ್
Berry	ಬೆರ್ರಿ
head	ಹೆಡ್
fort	ಫೋರ್ಟ್
Sheikh	ಶೇಖ್
Chilli	ಚಿಲ್ಲಿ
Brean	ಬೀನ್
down	ಡೌನ್
fort	ಫೋರ್ಟ್
Galen	ಗೆಲನ್
Giller	ಗಿಲ್ಲರ್
Prize	ಪ್ರೈಜ್
Sainte	ಸೆಂಟ್
marie	ಮೆರೀ
Simon	ಸೈಮನ್
Pearce	ಪಿಯರ್ಸ್
Rishika	ಋಷಿಕಾ
Duf	ಡಫ್
Lele	ಲೆಲೆ
Mawahib	ಮವಾಹಿಬ್
Garth	ಗಾರ್ಥ್
Brooks	ಬ್ರೂಕ್ಸ್
Hindustaanee	ಹಿಂದುಸ್ತಾನೀ
Doug	ಡೋ
Walters	ವಾಲ್ಟರ್ಸ್
Schlesien	ಸ್ಕಿಲೆಸಿಯನ್
Linda	ಲಿಂಡಾ
Ronstadt	ರಾನ್ಸ್‌ಟಾಡ್
The	ದ
oriya	ಒರಿಯಾ
samaja	ಸಮಾಜ
Shungare	ಶುಂಗಾರೆ
Antah	ಅಂತಾ
Kaheesha	ಕಹೀಶಾ
Mitumba	ಮಿಟುಂಬಾ
Thisbe	ಥಿಶ್ಬೆ
Indian	ಇಂಡಿಯನ್
Bank	ಬ್ಯಾಂಕ್
Bisalwas	ಬಿಸಲ್ವಾಸ್
Kalan	ಕಲಾನ್
Pharmaxis	ಫಾರ್ಮಾಕ್ಸಿಸ್
Limited	ಲಿಮಿಟೆಡ್
Eifel	ಎಫೆಲ್
Paul	ಪೌಲ್
Mccarthy	ಮೆಕಾರ್ಥಿ
Atrauli	ಅತ್ರೌಲಿ
Road	ರೋಡ್
Girl	ಗರ್ಲ್
Friend	ಫ್ರೆಂಡ್
Presernova	ಪ್ರೆಸರ್ನೋವಾ
nagrada	ನಗ್ರಾಡಾ
Taysir	ತಾಯ್ಸಿರ್
Milan	ಮಿಲನ್
Cake	ಕೇಕ್
walk	ವಾಕ್
Tegan	ಟೇಗನ್
Abhisoka	ಅಭಿಶೋಕ
Murray	ಮುರೇ
Goodwin	ಗುಡ್ವಿನ್
Dark	ಡಾರ್ಕ್
Street	ಸ್ಟ್ರೀಟ್
Kottayam	ಕೊಟ್ಟಾಯಂ
Polar	ಪೋಲಾರ್
Music	ಮ್ಯೂಸಿಕ್
Prize	ಪ್ರೈಜ್
Max	ಮ್ಯಾಕ್ಸ್
Re	ರೆ
Capital	ಕ್ಯಾಪಿಟಲ್
Philips	ಫಿಲಿಪ್ಸ್
India	ಇಂಡಿಯಾ
Sumitra	ಸುಮಿತ್ರ
Hind	ಹಿಂದ್
Lahak	ಲಹಕ್
Jaanhvekar	ಜಾನ್ಹವೇಕರ್
Deryck	ಡೆರಿಕ್
Murray	ಮುರೇ
Riverside	ರಿವರ್ಸೈಡ್
Natesh	ನತೇಶ್
Reba	ರೀಬಾ
Mcentire	ಮೆಕೆಂಟೈರ್
Suchitra	ಸುಚಿತ್ರಾ
Bhadroli	ಭದ್ರೋಲಿ
Banyard	ಬ್ಯಾನ್‌ಯಾರ್ಡ್
Magnesium	ಮೆಗ್ನೀಸಿಯಂ
Randhawa	ರಂಧಾವಾ
Judson	ಜುಡ್ಸನ್
Cape	ಕೇಪ್
Cod	ಕಾಡ್
Babul	ಬಾಬುಲ್
Ki	ಕೀ
Galiyan	ಗಲಿಯಾ
Reprisal	ರೆಪ್ರೈಸಲ್
Muqabala	ಮುಕಾಬಲಾ
Woodlands	ವುಡ್‌ಲ್ಯಾಂಡ್ಸ್
fort	ಫೋರ್ಟ್
Hekla	ಹೆಕ್ಲಾ
Alexia	ಅಲೆಕ್ಸಿಯಾ
Adimoorti	ಆದಿಮೂರ್ತಿ
Shakuni	ಶಕುನಿ
Akram	ಅಕ್ರಮ್
Israel	ಇಸ್ರೇಲ್
Prize	ಪ್ರೈಜ್
Farooq	ಫಾರೂಕ್
Nisbat	ನಿಸ್ಬಾತ್
Aakhri	ಅಖಿರಿ
Muqabla	ಮುಕಾಬಲಾ
Hamburg	ಹ್ಯಾಬರ್ಗ್
Wadden	ವಾಡನ್
Sea	ಸೀ
Niharika	ನಿಹಾರಿಕಾ
Chandrak	ಚಂದ್ರಕ್
Allaudin	ಅಲಾವುದ್ದೀನ್
Ka	ಕಾ
Chirag	ಚಿರಾಗ್
Concor	ಕಾನ್ಕೋರ್
Frug	ಫ್ರಗ್
London	ಲಂಡನ್
Metropolitan	ಮೆಟ್ರೋಪಾಲಿಟನ್
University	ಯುನಿವರ್ಸಿಟಿ
Oak	ಓಕ್
Hills	ಹಿಲ್ಸ್
Presbyterian	ಪ್ರೆಸ್ಬಿಟೇರಿಯನ್
Arshad	ಅರ್ಶದ್
Ayub	ಅಯೂಬ್
Abheer	ಅಭೀರ್
Thermopylae	ಥರ್ಮೊಫೀಲಿಯಾ
Aswan	ಆಸ್ವಾನ್
Dams	ಡ್ಯಾಮ್
Ketana	ಕೇತನಾ
Lu'lu	ಲುಲು
Utah	ಉತಾ
Subros	ಸುಬ್ರೋಸ್
Neelam	ನೀಲಮ್
Pari	ಪರಿ
Despina	ಡೆಸ್ಪಿನಾ
Bombay	ಬಾಂಬೆ
Ka	ಕಾ
Maharaja	ಮಹರಾಜ್
Castelfidardo	ಕ್ಯಾಸ್ಟಲ್‌ಫಿಡಾರ್ಡೊ
Nastik	ನಸ್ತಿಕ್
Guru	ಗುರು
Dakshina	ದಕ್ಷಿಣಾ
Order	ಆರ್ಡರ್
of	ಆಫ್
Saint	ಸೇಂಟ್
George	ಜಾರ್ಜ್
Brazosport	ಬ್ರಾಝೊಸ್ಪೋರ್ಟ್
Christian	ಕ್ರಿಶ್ಚಿಯನ್
Center	ಸೆಂಟರ್
Draper	ಡ್ರಾಪರ್
Scottish	ಸ್ಕಾಟಿಶ್
Football	ಫುಟ್‌ಬಾಲ್
Museum	ಮ್ಯೂಸಿಯಂ
Olive	ಆಲಿವ್
Dutch	ಡಚ್
Civil	ಸಿವಿಲ್
War	ವಾರ್
Mranaalinee	ಮೃಣಾಲಿನಿ
Jalandhar	ಜಲಂಧರ್
Mike	ಮೈಕ್
Brearley	ಬಿಯರ್ಲಿ
Saheb	ಸಾಹೆಬ್
Sooryavanshee	ಸೂರ್ಯವಂಶೀ
Biswan	ಬಿಸ್ವಾನ್
Teri	ತೇರಿ
Meharbaniyan	ಮೆಹರಬಾನಿಯಾ
Omax	ಒಮೆಕ್ಸ್
Autos	ಆಟೋಸ್
Apna	ಅಪ್ನಾ
Khoon	ಖೂನ್
Apna	ಅಪ್ನಾ
Dushman	ದುಶಮನ್
Shampa	ಶಂಪಾ
Sarolkar	ಸಾರೋಲ್ಕರ್
Mervyn	ಮರ್ವಿನ್
Dillon	ದಿಲ್ಲಾನ್
Ahindra	ಅಹೀಂದ್ರ
Mohiniatam	ಮೋಹಿನಿಯಾಟ್ಟಂ
Muzaffer	ಮುಜಾಫೆರ್
Ozak	ಒಜಾಕ್
Chocolate	ಚಾಕಲೇಟ್
Fatehgarh	ಫತೇಗಢ್
Kobe	ಕೋಬ್
Steel	ಸ್ಟೀಲ್
Subhedar	ಸುಭೇದಾರ್
Museum	ಮ್ಯೂಸಿಯಂ
of	ಆಫ್
Romani	ರೊಮಾನಿ
Culture	ಕಲ್ಚರ್
Kanneswara	ಕನ್ನೇಶ್ವರ
Rama	ರಾಮ
Gujhandi	ಗುಜಹಂಡಿ
Rosalba	ರೋಸಾಲ್ಬಾ
Reynard	ರೆನಾರ್ಡ್
Kasam	ಕಸಮ್
Paida	ಫೈದಾ
Karne	ಕರ್ನೆ
Wale	ವಾಲೆ
Ki	ಕಿ
Zocha	ಝೋಚಾ
Hubaab	ಹುಬಾಬ್
Kesava	ಕೇಶವ
Patanga	ಪತಂಗಾ
Delhaize	ಡೆಲ್ಹೈಜ್
Group	ಗ್ರೂಪ್
Rockwall	ರಾಕ್ವೆಲ್
Acharyanandanaa	ಆಚಾರ್ಯನಂದನಾ
Citygroup	ಸಿಟಿಗ್ರುಪ್
Centre	ಸೆಂಟರ್
Gene	ಜೆನೀ
Andhra Pradesh	ಆಂಧ್ರಪ್ರದೇಶ್
Sealey	ಸೀಲೆ
Mark	ಮಾರ್ಕ್
Vermeulen	ವರ್ಮ್ಯೂಲನ್
Kurde	ಕುರ್ಡೆ
Salil	ಸಲೀಂಲ
Ankola	ಅಂಕೋಲಾ
Netaajee	ನೇತಾಜೀ
Business	ಬಿಜನೆಸ್
line	ಲೈನ್
Kajaria	ಕಜಾರಿಯಾ
Ceramic	ಸೆರಾಮಿಕ್ಸ್
Suresh	ಸುರೇಶ್
Ahladit	ಆಹ್ಲಾದಿತ್
Fatih	ಫತಿ
Shriman	ಶ್ರೀಮಾನ್
Shrimati	ಶ್ರೀಮತಿ
Motherson	ಮದರ್‌ಸನ್
Sumi	ಸುಮಿ
Jolie	ಜೋಲೀ
Gurudwara	ಗುರುದ್ವಾರ
Chakki	ಚಕ್ಕೀ
Sahib	ಸಾಹಿಬ್
Prasham	ಪ್ರಾಶಮ್
Union	ಯೂನಿಯನ್
pipe	ಪೈಪ್
Abhijwaala	ಅಭಿಜ್ವಾಲ
Gaenor	ಗಾಯನರ್
Cosmo	ಕಾಸ್ಮೋ
Oil	ಆಯಿಲ್
Prem	ಪ್ರೇಮ್
Samadhi	ಸಮಾಧಿ
Dwight	ಡ್ವೈಟ್
Lucus	ಲೂಕಾಸ್
Saatvik	ಸಾತ್ವಿಕ್
Dayton	ಡೇಟನ್
art	ಆರ್ಟ್
Institute	ಇನ್ಸ್ಟಿಟ್ಯೂಟ್
Beerasinh	ಬೀರಾಸಿಂಹ್
Rocky	ರಾಕಿ
Ananyaa	ಅನನ್ಯಾ
Gevrai	ಗೆವರಾಯಿ
Rudra	ರುದ್ರ
Pratap	ಪ್ರತಾಪ್
Singh	ಸಿಂಗ್
Sanaubar	ಸನೋಬರ್
Hanste	ಹಂಸ್ತೇ
Ansoo	ಆಸೂ
Pritikana	ಪ್ರೀತಿಕಾನಾ
Baalkrishna	ಬಾಲಕೃಷ್ಣ
Barakah	ಬಾರಾಕಾ
Guj	ಗುಜ್
State	ಸ್ಟೇಟ್
Petro	ಪೆಟ್ರೋ
Akar	ಆಕರ್
Makhijani	ಮಾಖೀಜಾನಿ
Faiqah	ಫೈಕಾಹ್
Barakat	ಬರಾಕಾತ್
Giverny	ಗಿವೆರ್ನೀ
Hindustan Petroleum	ಹ್ಂದುಸ್ತಾನೆಪೆಟ್ರೋಲಿಯಂ
Anusooyaa	ಅನುಸೂಯಾ
Catrin	ಕೇಟ್ರಿನ್
Mahesh	ಮಹೇಶ್
Rajiyah	ರಾಜಿಯಾ
Climbing	ಕ್ಲೈಂಬಿಂಗ್
Chinese	ಚೈನೀಸ್
Petroleum	ಪೆಟ್ರೋಲಿಯಂ
Kruger	ಕ್ರೂಗೆರ್
Ekachitt	ಏಕಚಿತ್
Derek	ಡೆರೆಕ್
Crookes	ಕ್ರೂಕ್ಸ್
Chaminda	ಚಮಿಂಡಾ
Mendis	ಮೆಂಡಿಸ್
Lucil	ಲೂಸಿಲ್
Ball	ಬಾಲ್
Sharaabi	ಶರಾಬಿ
Akaar	ಆಕಾರ್
Michael	ಮೈಕೇಲ್
James	ಜೇಮ್ಸ್
Cook	ಕುಕ್
University	ಯುನಿವರ್ಸಿಟಿ
University	ಯುನಿವರ್ಸಿಟಿ
of	ಆಫ್
Stirling	ಸ್ಟರ್ಲಿಂಗ್
Sunil	ಸುನಿಲ್
Joshi	ಜೋಶಿ
Mera	ಮೇರಾ
Salaam	ಸಲಾಮ್
Cardea	ಕಾರ್ಡೀ
Bansari	ಬನ್ಸಾರಿ
Saket	ಸಾಕೇತ್
Nutan	ನೂತನ್
Main	ಮೈ
Aur	ಔರ್
Tum	ತುಮ್
Fort	ಫೋರ್ಟ್
cumberland	ಕುಂಬರ್‌ಲ್ಯಾಂಡ್
Chale	ಚಲೆ
Hain	ಹೈ
Sasural	ಸಸುರಾಲ್
Vijayavargeey	ವಿಜಯವರ್ಗಿ
Cuica	ಸಿಕಾ
Jassi	ಜಸ್ಸಿ
Mustaqeem	ಮುಸ್ತಖೀಮ್
Ek	ಏಕ್
Kunwari	ಕುನ್ವಾರಿ
Ek	ಏಕ್
Kunwara	ಕುನ್ವಾರಾ
Curry	ಕರಿ
Ukhrul	ಉಕ್ರುಲ್
Tista	ತೀಸ್ತಾ
Gunah	ಗುನಾಹ್
Aur	ಔರ್
Kanoon	ಕಾನೂನ್
Pilani	ಪಿಲಾನಿ
Aneezah	ಅನೀಝಾ
Ayyoob	ಅಯೂಬ್
Lukayan	ಲುಕಾಯನ್
Caverns	ಕೇವರ್ನ್ಸ್
Brett	ಬ್ರೆಟ್
Lee	ಲೀ
Akmal	ಅಕ್ಮಲ್
Alfred	ಅಲ್ಫ್ರೆಡ್
Jhoota	ಝೂಠಾ
Kahin	ಕಹೀ
Ka	ಕಾ
Dhaban	ಧಾಬನ್
Vijay	ವಿಜಯ್
Dahiya	ದಹಿಯಾ
Shankar	ಶಂಕರ್
Hussain	ಹುಸೇನ್
Basra	ಬಸರಾ
Mass	ಮಾಸ್
Mutual	ಮ್ಯೂಚುವಲ್
Life	ಲೈಫ್
Leena	ಲೀನಾ
Na	ನಾ
Mumkin	ಮುಮಕಿನ್
Johari	ಜೌಹರಿ
Rangeen	ರಂಗೀನ್
Kahani	ಕಹಾನೀ
Soorat	ಸೂರತ್
Beshaque	ಬೇಶಕ್
Dickin	ಡಿಕ್ಕಿನ್
Medal	ಮೆಡಲ್
Fort	ಫೋರ್ಟ್
vredeburg	ವ್ರೆಡಿಬರ್ಗ್
Bahriyah	ಬಹ್ರಿಯಾ
Dashehra	ದಶಹರಾ
Tatkar	ತಾಟಕರ್
Aflatoon	ಆಫಲಾತೂನ್
Aurat	ಔರತ್
Hamnah	ಹಮ್ನಾ
Maalaa	ಮಾಲಾ
Bayonne	ಬೆಯಾನ್
Rukmani	ರುಕ್ಮಣಿ
Haran	ಹರಣ್
Eithne	ಈಥ್ನಿ
Dawson	ಡಾಸನ್
Inflexible	ಇನ್‌ಫ್ಲೆಕ್ಸಿಬಲ್
Kabul	ಕಾಬುಲ್
Mallika	ಮಲ್ಲಿಕಾ
Navendra	ನವೀಂದ್ರ
Ek	ಏಕ್
Phool	ಪೂಲ್
Ek	ಏಕ್
Bhool	ಭೂಲ್
Wilhem	ವ್ಹಿಲಮ್
Busch	ಬುಶ್
Museum	ಮ್ಯೂಸಿಯಂ
Gates	ಗೇಟ್ಸ್
Mahima	ಮಹಿಮಾ
Shu'a	ಶುವಾ
World	ವರ್ಲ್ಡ್
Championships	ಚಾಂಪಿಯನ್‌ಶಿಪ್ಸ್
in	ಇನ್
Biathlon	ಬೈತ್ಲಾನ್
Sumayrah	ಸುಮೇರಾ
Vinatee	ವಿನತೀ
Farragut	ಫರಾಗತ್
Amoort	ಅಮೂರ್ತ್
Quinta	ಕ್ವಿಂಟಾ
Nanette	ನನೆಟಿ
Paulina	ಪೌಲಿನಾ
Basi	ಬಸಿ
Kiratpur	ಕಿರತ್‌ಪುರ್
Omar	ಒಮರ್
Prashant	ಪ್ರಶಾಂತ್
Vaidya	ವೈದ್ಯ
Lalitmohan	ಲಲಿತಮೋಹನ
Madhuksara	ಮಧುಕ್ಷರಾ
Bagalkot	ಬಾಗಲಕೋಟ್
Pradosh	ಪ್ರದೋಷ್
Aloysius	ಅಲೋಷಿಯಸ್
Anastacia	ಎನಸ್ತೇಷಿಯಾ
Selma	ಸೆಲ್ಮಾ
Maan	ಮಾನ್
Apmaan	ಅಪಮಾನ್
Anou	ಅನೌ
Boussouil	ಬೌಸೋಯಿಲ್
Farid	ಫರಿದ್
Sydney	ಸಿಡ್ನಿ
Richard	ರಿಚರ್ಡ್
Johnson	ಜಾನ್ಸನ್
Leane	ಲೀನ್
Adity	ಆದಿತ್ಯ
Shane	ಶೇನ್
Bond	ಬಾಂಡ್
Leann	ಲೀನ್
Sainbi	ಸೈಬಿ
Aurat	ಔರತ್
Ki	ಕಿ
Zindagi	ಜಿಂದಗಿ
Norfolk	ನಾರ್‌ಫೋಕ್
Island	ಐಲ್ಯಾಂಡ್
Udhamsinghnagar	ಉಧಾಮ್ ಸಿಂಗ್ ನಗರ್
Laden	ಲೇಡನ್
Bijani	ಬಿಜಾನೀ
Kan	ಕಣ್
Kan	ಕಣ್
Men	ಮೆ
Bhagwan	ಭಗ್ವಾನ್
Makita	ಮಕಿಟಾ
Tsing	ತ್ಸಿಂಗ್
Ma	ಮಾ
Gary	ಗ್ಯಾರಿ
Troup	ಟ್ರೂಪ್
Millie	ಮಿಲಿ
Avadhi	ಅವಧಿ
Gurudwara	ಗುರುದ್ವಾರ
Dera	ದೇರಾ
Baba	ಬಾಬಾ
Deep	ದೀಪ್
Singh	ಸಿಂಗ್
Credit	ಕ್ರೆಡಿಟ್
Susse	ಸಾಸಿ
Andha	ಅಂಧಾ
Kanoon	ಕಾನೂನ್
Shimoga	ಶಿವಮೊಗ್ಗ
Cissy	ಸಿಸ್ಸಿ
Monica	ಮೋನಿಕಾ
Lewinsky	ಲೆವಿನ್ಸ್ಕಿ
Ek	ಏಕ್
Sapera	ಸಪೇರಾ
Ek	ಏಕ್
Lutera	ಲುಟೇರಾ
Fanish	ಫಣೀಶ್
Fort	ಫೋರ್ಟ್
winokapau	ವಿನೊಕಾಪೌ
Kampala	ಕಂಪಾಲಾ
Madura	ಮಧುರಾ
Garments	ಗಾರ್ಮೆಂಟ್ಸ್
Fahim	ಫಾಹಿಮ್
Constitution	ಕಾನ್‌ಸ್ಟಿಟ್ಯೂಶನ್
The	ದ
Open-Air	ಓಪನ್-ಏರ್
Water	ವಾಟರ್
Power	ಪವರ್
Museum	ಮ್ಯೂಸಿಯಂ
of	ಆಫ್
Dimitsana	ಡಿಮಿಟ್ಸಾನಾ
Ramdoot	ರಾಮದೂತ್
Ukulele	ಉಕುಲೆಲೆ
Mata	ಮಾತಾ
Mahakali	ಮಹಾಕಾಲೀ
Manzoor	ಮಂಜೂರ್
Elahi	ಇಲಾಹಿ
Sledding	ಸ್ಲೆಡಿಂಗ್
Mimi	ಮಿಮಿ
Ramu	ರಾಮೂ
Ustad	ಉಸ್ತಾದ್
Nirdosh	ನಿರ್ದೋಶ್
Peter	ಪೀಟರ್
Coman	ಕೋಮನ್
Janyu	ಜನ್ಯು
Raani	ರಾನೀ
Khan	ಖಾನ್
Dost	ದೋಸ್ತ್
Mahotsaah	ಮಹೋತ್ಸಾಹ
Prem	ಪ್ರೇಮ್
Sagar	ಸಾಗರ್
Sitakant	ಸೀತಾಕಾಂತ್
Mahapatra	ಮಹಾಪಾತ್ರ
Khunays	ಖುನೇಸ್
Benedetto	ಬೆನಿಡೆಟ್ಟೋ
Brin	ಬ್ರಿನ್
Leelavati	ಲೀಲಾವತಿ
Walker	ವಾಕರ್
Cuthbert	ಕತ್ಬರ್ಟ್
Tan	ತನ್
Badan	ಬದನ್
Fabio	ಫೇಬಿಯಾ
Chalis	ಚಾಲೀಸ್
Baba	ಬಾಬಾ
Ek	ಎಕ್
Chor	ಚೋರ್
Raaghav	ರಾಘವ್
Satyam	ಸತ್ಯಂ
Shivam	ಶಿವಂ
Sundaram	ಸುಂದರಂ
Rani	ರಾಣಿ
Falguni	ಫಲ್ಗುಣಿ
Michael	ಮೈಖೇಲ್
Douglas	ಡೌಗ್ಲಾಸ್
Exxon	ಎಕ್ಸಾನ್
Mobile	ಮೊಬಿಲ್
Madanamohan	ಮದನಮೋಹನ
Baffin	ಬಫಿನ್
Museum	ಮ್ಯೂಸಿಯಂ
and	ಅಂಡ್
Study	ಸ್ಟಡಿ
Centre	ಸೆಂಟರ್
of	ಆಫ್
the	ದ
Greek	ಗ್ರೀಕ್
Theatre	ಥಿಯೇಟರ್
Bryan	ಬ್ರಯಾನ್
Young	ಯಂಗ್
Duncan	ಡನ್‌ಕನ್
Fiji	ಫಿಜಿ
Lion	ಲಯನ್
New	ನ್ಯೂ
Kent	ಕೆಂಟ್
Fifi	ಫಿಫಿ
Kamraj	ಕಾಮರಾಜ್
Rangan	ರಂಗನ್
Felicia	ಫೆಲಿಸಿಯಾ
Fadil	ಫಾದಿಲ್
Richard	ರಿಚರ್ಡ್
Jones	ಜೋನ್ಸ್
Paraya	ಪರಾಯಾ
Ghar	ಘರ್
Venture	ವೆಂಚರ್
Christian	ಕ್ರಿಶ್ಚಿಯನ್
Sadhika	ಸಾಧಿಕಾ
Lady	ಲೇಡಿ
Nelson	ನೆಲ್ಸನ್
Rochan	ರೋಚನ್
Pat	ಪ್ಯಾಟ್
Robertson	ರಾಬರ್ಟ್‌ಸನ್
Ratia	ರತಿಯಾ
Gupte	ಗುಪ್ತೆ
Aap	ಆಪ್
Beeti	ಬೀತಿ
Abhinanda	ಅಭಿನಂದಾ
Dymchurch	ಡಿಮ್‌ಚರ್ಚ್
redoubt	ರಿಡೌಟ್
State	ಸ್ಟೇಟ್
Bank	ಬ್ಯಾಂಕ್
of	ಆಫ್
Indore	ಇಂದೋರ್
Nishith	ನಿಶಿತ್
Kamyab	ಕಾಮ್ಯಾಬ್
Falna	ಫಲನಾ
Everett	ಎವರೆಟ್
Rasia	ರೇಸಿಯಾ
Andrew	ಆಂಡ್ರ್ಯೂ
Puttick	ಪುಟಿಕ್
Murtaad	ಮುರ್ತಾದ್
Manabhaavan	ಮನಭಾವನ
Patrick	ಪ್ಯಾಟ್ರಿಕ್
Garam	ಗರಮ್
Kot	ಕೋಟ್
Main	ಮೈ
Suhagan	ಸುಹಾಗನ್
Hoon	ಹೂ
Fort	ಫೋರ್ಟ್
charles	ಚಾರ್ಲೆಸ್
Suhayl	ಸುಹೇಲ್
Umrao	ಉಮರಾವೋ
Jaan	ಜಾನ್
Order	ಆರ್ಡರ್
of	ಆಫ್
Victory	ವಿಕ್ಟರಿ
Shaun	ಶೌನ್
Graf	ಗ್ರಾಫ್
Amloh	ಅಮ್ಲೋ
Sushrut	ಸುಶ್ರುತ
Walt	ವಾಲ್ಟ್
Whitman	ವ್ಹಿಟ್‌ಮ್ಯಾನ್
Catriona	ಕೇಟ್ರಿಯೋನಾ
Naimur	ನೈಮುರ್
Rahman	ರೆಹಮಾನ್
Priyanka	ಪ್ರಿಯಾಂಕಾ
Khoon	ಖೂನ್
Ki	ಕಿ
Takkar	ತಕ್ಕರ್
San	ಸ್ಯಾನ್
Jorge	ಜೋರ್ಜ್
Kenton	ಕೆಂಟನ್
British	ಬ್ರಿಟಿಶ್
Gas	ಗ್ಯಾಸ್
Abdul	ಅಬ್ದುಲ್
haakim	ಹಾಕಿಂ
Suketu	ಸುಕೇತು
Bandhan	ಬಂಧನ್
Kachchey	ಕಚ್ಚೆ
Dhagon	ಧಾರ್ಗೋಂ
Ka	ಕಾ
Haweliana	ಹವೇಲಿಯಾನಾ
NICE-Systems	ನೈಸ್-ಸಿಸ್ಟಮ್ಸ್
Limited	ಲಿಮಿಟೆಡ್
Shadyanta	ಷಡಯಂತ್ರ್
Bamra	ಬಾಮರಾ
Duncan	ಡಂಕನ್
Fletcher	ಫ್ಲೆಚರ್
Shyaam	ಶ್ಯಾಮ್
Salam	ಸಲಾಮ್
Bombay	ಬಾಂಬೆ
Lakhimpur	ಲಖೀಂಪುರ್
Gregory	ಗ್ರೆಗೋರಿ
Satinderpal	ಸತೀಂದರ್‌ಪಾಲ್
Girikshit	ಗಿರೀಕ್ಷಿತ್
Kameshwar	ಕಾಮೇಶ್ವರ್
Ibn	ಇಬ್ನ್
Khafif	ಖಫೀಫ್
Tirukkannankudi	ತಿರುಕನ್ನಾಂಕುಡಿ
Piet	ಪಿಯೆಟ್
Hein	ಹೀನ್
Abhiru	ಅಭೀರು
Ibhanan	ಇಭಾನನ್
Sood	ಸೂದ್
Ayatollah	ಅಯಾತುಲ್ಲಾ
Khomeini	ಖೊಮೇನಿ
Badri	ಬದ್ರಿ
Neeraf	ನಿರಫ್
Kanhaiyalal	ಕನೈಯಾಲಾಲ್
Saint	ಸೆಂಟ್
Francis	ಫ್ರಾನ್ಸಿಸ್
D'Assisi	ಡಿಅಸಿಸಿ
High	ಹೈ
School	ಸ್ಕೂಲ್
Taka	ತಾಕಾ
Bone	ಬೋನ್
Rate	ರಾಟೆ
Jacinda	ಜಾಕಿಂದ
Davina	ಡವಿನಾ
Dudley	ಡುಡ್ಲೆ
Isi	ಇಸೀ
Ka	ಕಾ
Naam	ನಾಮ್
Duniya	ದುನಿಯಾ
Hai	ಹೈ
Candida	ಕ್ಯಾಂಡಿಡಾ
Karkhanis	ಕಾರ್ಕಾನಿಸ್
Raakesh	ರಾಕೇಶ್
Stockholm-Arlanda	ಸ್ಟಾಕ್‌ಹೋಮ್-ಅರ್ಲಾಂಡಾ
Bhangra	ಬಾಂಗ್ರಾ
Fort	ಫೋರ್ಟ್
ellice	ಎಲ್ಲಿಸ್
Musta'eenah	ಮುಸ್ತಾಯಿನಾ
Waqt	ವಕ್ತ್
Ki	ಕೀ
Awaaz	ಆವಾಜ್
Archan	ಅರ್ಚನ್
Children's	ಚಿಲ್ಡ್ರನ್ಸ್
Laureate	ಲಾರೀಟ್
Matilda	ಮಟಿಲ್ದಾ
Aanchal	ಆಂಚಲ್
Ke	ಕೆ
Phool	ಪೂಲ್
Asahi	ಆಸಹೀ
India	ಇಂಡಿಯಾ
Graphite	ಗ್ರಾಫೈಟ್
India	ಇಂಡಿಯಾ
Ashley	ಆಶ್ಲೆ
Mallett	ಮಲೆಟ್
Albeli	ಅಲ್ಬೇಲೀ
Ravij	ರವಿಜ್
Nigahen	ನಿಗಾಹೇ
Juthamah	ಜುಥಮಾಯಿ
Ghosunda	ಘೋಸುಂದಾ
Anjaam	ಅಂಜಾಮ್
Khuda	ಖುದಾ
Jane	ಜಾನೆ
Mahadane	ಮಹಾದಾನೆ
Ghosipura	ಘೋಶಿಪುರಾ
Yeh	ಯೇ
Nazdikiyan	ನಜದೀಕಿಯಾ
Siddhamalli	ಸಿದ್ಧಾಮಲ್ಲಿ
Reservoir	ರಿಜರ್ವಾಯರ್
Woorkeri	ವೂರ್ಕರಿ
Raman	ರಮಣ್
Vic	ವಿಕ್
Pollard	ಪೋಲರ್ಡ್
Axcan	ಅಕ್ಸಕಾನ್
Pharma	ಫಾರ್ಮಾ
Pugachev's	ಪುಗಚೆವ್ಸ್
Rebellion	ರೆಬಿಲಿಯನ್
Sanyog	ಸಂಯೋಗ್
Dauram	ದೌರಂ
Madhpura	ಮಧ್ಪುರಾ
Karan	ಕರಣ್
Neagle	ನೀಗಲ್
Do	ದೋ
Aadmi	ಆದ್ಮೀ
Mashooqa	ಮಾಶೂಕಾ
Garcha	ಗರಚಾ
Alpha	ಆಲ್ಫಾ
Matriculation	ಮೆಟ್ರಿಕ್ಯುಲೇಶನ್
Higher	ಹೈಯ್ಯರ್
Secondary	ಸೆಕೆಂಡರಿ
School,	ಸ್ಕೂಲ್,
Chennai	ಚೆನ್ನೈ
Vilmos	ವಿಲ್ಮೋಸ್
Vandan	ವಂದನ್
Mayoorashikhaa	ಮಯೂರ್‌ಶಿಖಾ
Usamah	ಉಸಮಾ
Etawah	ಇತಾವಾ
Wood	ವುಡ್
Burren	ಬುರೆನ್
Leavitt	ಲೆವಿಟ್
Junior	ಜೂನಿಯರ್
Murray	ಮುರೇ
Amalesh	ಅಮಲೇಶ್
Barasat	ಬಾರಾಸತ್
Rajdrohi	ರಾಜದ್ರೋಹಿ
troposphere	ಟ್ರೋಪೋಸ್ಫಿಯರ್
Khurana	ಖುರಾನಾ
Pitambar	ಪೀತಾಂಬರಿ
Shikwa	ಶಿಕವಾ
Basta	ಬಸ್ತಾ
Scotia	ಸ್ಕೋಟಿಯಾ
Plaza	ಪ್ಲಾಜಾ
Tarangire	ತರಂಗಿರೆ
Premio	ಪ್ರೆಮಿಯೊ
Valmor	ವಲ್ಮೋರ್
David	ಡೇವಿಡ್
Heyn	ಹೇಯ್ನ್
Al	ಅಲ್
Ghazali	ಗಜಾಲಿ
Flynn	ಫ್ಲಿನ್
Gurudwara	ಗುರುದ್ವಾರ
Tahliana	ತಹಲೀಯಾನಾ
Sahib	ಸಾಹಿಬ್
Preet	ಪ್ರೀತ್
Shaarangee	ಶಾರಂಗೀ
Fort	ಫೋರ್ಟ್
worden	ವೊರ್ಡನ್
Rahnuma	ರಹನುಮಾ
The	ದ
Little	ಲಿಟಲ್
Rock	ರಾಕ್
Niger	ನೈಗರ್
Vaibhav	ವೈಭವ್
Shekhar	ಶೇಖರ್
Yoland	ಯ್ಯೋಲಂದ
Shekel	ಶೆಕೆಲ್
Jacques	ಜಾಕಿಸ್
Kallis	ಕಾಲಿಸ್
Sarangi	ಸಾರಂಗಿ
Dahleez	ದಹಲೀಜ್
Major	ಮೆಜರ್
League	ಲೀಗ್
Lacrosse	ಲಾಕ್ರೊಸ್
Most	ಮೊಸ್ಟ್
Improved	ಇಂಪ್ರೂಡ್
Player	ಪ್ಲೇಯರ್
of	ಆಫ್
the	ದ
Year	ಈಯರ್
Award	ಅವಾರ್ಡ್
Daliya	ದಲಿಯಾ
Rudy	ರೂಡಿ
Giuliani	ಗ್ಯುಲಾನಿ
Aasif	ಆಸಿಫ್
Altaaf	ಅಲ್ತಾಫ್
Mekhalaadrijaa	ಮೇಖಲಾದ್ರಿಜಾ
Omari	ಒಮರಿ
Banks	ಬ್ಯಾಂಕ್ಸ್
Amadeus	ಅಮೆಡ್ಯೂಸ್
Mozart	ಮೋಜಾರ್ಟ್
Baap	ಬಾಪ್
Beti	ಬೇಟಿ
Surinderjeet	ಸುರಿಂದರ್‌ಜಿತ್
Sulwyn	ಸುಲ್ವಿನ್
Keith	ಕೀತ್
Arthurton	ಆರ್ಥರ್ಟನ್
Mallah	ಮಲ್ಲಾಹ್
Dalila	ದಲಿಲಾ
Dhatri	ಧಾತ್ರಿ
Saleem	ಸಲೀಮ್
Fort	ಫೋರ್ಟ್
nathan	ನಾಥನ್
hale	ಹಲೆ
Loews	ಲೋವ್ಸ್
Dilwara	ದಿಲ್ವಾರ್
Temple	ಟೆಂಪಲ್
War	ವಾರ್
of	ಆಫ್
the	ದಿ
Second	ಸೆಕೆಂಡ್
Coalition	ಕೊಯಲಿಶನ್
Paresh	ಪರೇಶ್
Aoulakh	ಔಲಾಕ್
Barberton	ಬಾರ್ಬೆರ್ಟಾನ್
Friends	ಫ್ರೆಂಡ್ಸ್
La	ಲಾ
Trobe	ಟ್ರೋಬ್
University	ಯುನಿವರ್ಸಿಟಿ
Union	ಯೂನಿಯನ್
Bank	ಬ್ಯಾಂಕ್
Aadat	ಆದತ್
Se	ಸೆ
Majboor	ಮಜಬೂರ್
Naag	ನಾಗ್
Mere	ಮೇರಿ
Sathi	ಸಾಥಿ
Shpella	ಶ್ಪೆಲ್ಲಾ
Shachi	ಶಚಿ
Maura	ಮೌರಾ
Balaraam	ಬಲರಾಮ್
Ourra-tul-'ain	ಆರಾ-ತುಲ್-ಏನ್
Abdul	ಅಬ್ದುಲ್
musawwir	ಮುಸವ್ವಿರ್
Ansoo	ಆಂಸೂ
Ban	ಬನ್
Gaye	ಗಯೆ
Phool	ಪೂಲ್
Sikandar-E-Azam	ಸಿಕಂದರ್-ಎ-ಆಜಮ್
Munkadir	ಮುಂಕಾದಿರ್
Panshula	ಪಂಶುಲಾ
Presidio	ಪ್ರೆಸಿಡಿ
of	ಆಫ್
monterey	ಮಾಂಟೆರಿ
Shah	ಶಾಹ್
E	ಎ
Iran	ಇರಾನ್
Janelle	ಜನೆಲ್ಲಿ
Veereshwar	ವೀರೇಶ್ವರ್
Babhnan	ಬಬ್ನಾನ್
Addo	ಅಡೋ
Elephant	ಎಲಿಫೆಂಟ್
Johnny	ಜಾನಿ
Mitchell	ಮಿಚೆಲ್
Duskheda	ದುಸ್ಕೇಡಾ
Pulwama	ಪುಲ್ವಾಮ
Morse	ಮಾರ್ಸೆ
Madam	ಮೇಡಮ್
Zapatta	ಜಪಟ್ಟಾ
Chile	ಚಿಲಿ
Sinai	ಸಿನಾಯ್
Ghar	ಘರ್
Ghar	ಘರ್
Ki	ಕಿ
Kahani	ಕಹಾನಿ
Kalpesh	ಕಲ್ಪೇಶ್
Patel	ಪಟೇಲ್
Kahf	ಕಾಫ್
Hoti	ಹೋಟಿ
Mukeria	ಮುಕೆರಿಯಾ
Big	ಬಿಗ್
apple	ಆಪಲ್
Balram	ಬಲ್ರಾಮ್
Banff	ಬನ್ಫ್
Rajnandini	ರಾಜನಂದಿನಿ
Trumble	ಟ್ರಂಬಲ್
Badmaash	ಬದಮಾಶ್
Rosa	ರೋಸಾ
Rishte	ರಿಶ್ತೆ
Naate	ನಾತೆ
Trintech	ಟ್ರಿನ್ಟೆಕ್
Group	ಗ್ರೂಪ್
Ranjan	ರಂಜನ್
Das	ದಾಸ್
Fancy	ಫ್ಯಾನ್ಸಿ
Julius	ಜುಲಿಯಸ್
Khoon	ಖೂನ್
Khoon	ಖೂನ್
Naya	ನಯಾ
Daur	ದೌರ್
Bareerah	ಬಾರೀರಾಹ್
Glasgow	ಗ್ಲಾಸ್ಗಾ
Orrick	ಒರಿಕ್
Ariadnah	ಆರಿಯಾಡ್ನಾ
Fort	ಫೋರ್ಟ್
monckton	ಮಾಂಕ್ಟನ್
Akul	ಅಕುಲ್
Jacques	ಜಾಕ್ಸ್
Marchais	ಮಾರ್ಕೆಸ್
Museum	ಮ್ಯೂಸಿಯಂ
of	ಆಫ್
Taiban	ತೈಬನ್
Art	ಆರ್ಟ್
Deen	ದೀನ್
Aur	ಔರ್
Iman	ಇಮಾಮ್
Mouth	ಮೌತ್
River	ರಿವರ್
Dhakiyah	ಧಾಕಿಯಾ
Sanjula	ಸಂಜುಲಾ
Ghar	ಘರ್
Lelia	ಲಿಲಿಯಾ
Nottingham	ನಾಟಿಂಗ್ಹಾಮ್
East	ಈಸ್ಟ್
Midlands	ಮಿಡ್ಲಾಂಡ್ಸ್
Bandhu	ಬಂಧು
Sreesanth	ಶ್ರೀನಾಥ್
Dandiya	ದಂಡಿಯಾ
Charulata	ಚಾರುಲತಾ
Lily	ಲಿಲಿ
Tomlin	ಟಾಮ್ಲಿನ್
Sirohi	ಸಿರೋಹಿ
Nazli	ನಜ್ಲಿ
Jaclyn	ಜ್ಯಾಕ್ಲಿನ್
Elders	ಎಲ್ಡರ್ಸ್
Alstom	ಆಲ್ಸ್ಟಾಮ್
Projects	ಪ್ರಾಜೆಕ್ಟ್ಸ್
Anadoluhisar	ಅಂಡೋಲ್ಹಿಸಾರ್
fort	ಫೋರ್ಟ್
Seemeen	ಸೀಮೀನ್
Gufic	ಗ್ರುಫಿಕ್
Bio	ಬಯೋ
BiJunctionor	ಬಿಜಂಕ್ಷನರ್
Kotnis	ಕೋಟ್ನಿಸ್
Jaago	ಜಾಗೋ
Bhabhar	ಭಾಭರ್
Rashtriya	ರಾಷ್ಟ್ರೀಯ
Chem	ಕೆಮ್
Mansurah	ಮನ್ಸೂರಾ
Gumwant	ಗುಣವಂತ್
Aaqib	ಆಕಿಬ್
Insaaf	ಇನ್ಸಾಫ್
Ki	ಕಿ
Awaz	ಆವಾಜ್
Fort	ಫೋರ್ಟ್
william	ವಿಲಿಯಮ್
and	ಅಂಡ್
mary	ಮೇರಿ
Barnagar	ಬಾರ್‌ನಗರ್
Patita	ಪತಿತಾ
Edalene	ಎಡಲೀನ್
Deepabali	ದೀಪಬಾಲಿ
Agni	ಅಗ್ನಿ
Morcha	ಮೋರ್ಚಾ
Rhine	ರೈನ್
Sati	ಸತಿ
Renuka	ರೇಣುಕಾ
Rashk	ರಶ್ಕ್
E	ಎ
Laila	ಲೈಲಾ
Danny	ಡ್ಯಾನಿ
Sawyer	ಸಾಯರ್
Aag	ಆಗ್
Aandhi	ಆಂಧಿ
Aur	ಔರ್
Toofan	ತೂಫಾನ್
Shajarah	ಶಜರಾಹ್
Marietta	ಮರಿಯಟಾ
Alvin	ಆಲ್ವಿನ್
Kallicharran	ಕಾಳಿಚರಣ್
Ariana	ಏರಿಯಾನಾ
Sampatti	ಸಂಪತ್ತಿ
Wimco	ವಿಮ್ಕೊ
Dave	ದಾವ್
fort	ಫೋರ್ಟ್
Steve	ಸ್ಟೀವ್
Smith	ಸ್ಮಿತ್
Cognizant	ಕೋಗ್ನೈಸೆಂಟ್
Yugoslavia	ಯುಗೋಸ್ಲಾವಿಯಾ
Satyanarayan	ಸತ್ಯನಾರಾಯಣ
Naqab	ನಕಾಬ್
Abdul	ಅಬ್ದುಲ್
muhayi	ಮುಹಾಯಿ
Conyers	ಕಾನ್ಯರ್ಸ್
Darabaar	ದರಬಾರ್
Nevado	ನೆವಾಡೊ
de	ಡಿ
Colima	ಕೊಲಿಮಾ
Bond	ಬಾಂಡ್
Clutterbuckganj	ಕ್ಲುಟರ್‌ಬುಕ್‌ಗಂಜ್
Daurala	ದೌರಾಲಾ
Muttaqi	ಮುತ್ತಕಿ
Ghusun	ಗುಸನ್
Kaveri	ಕಾವೇರಿ
Fort	ಫೋರ್ಟ್
clarence	ಕ್ಲಾರೆನ್ಸ್
Yvette	ವ್ಯೆಟ್ಟಿ
Venus	ವೀನಸ್
Aatik	ಆತಿಕ್
Conroy	ಕಾನ್ರಾಯ್
Ranjan	ರಂಜನ್
Gunatilleke	ಗುಣತಿಲಕೆ
Aatif	ಆತಿಫ್
Kutumbale	ಕುಟುಂಬಲೆ
Bhivani	ಭಿವಾನಿ
Sati	ಸತಿ
Narmada	ನರ್ಮದಾ
Samudragupta	ಸಮುದ್ರಗುಪ್ತ
Ruchi	ರುಚಿ
Soya	ಸೋಯಾ
Indra	ಇಂದ್ರ
Sabha	ಸಭಾ
Bade	ಬಡೇ
Bhaiya	ಬಯ್ಯಾ
Mawaali	ಮವಾಲೀ
Aage	ಆಗ್
Ki	ಕೀ
Soch	ಸೋಚ್
Nai	ನಯೀ
Maa	ಮಾ
Gwenllian	ಗ್ವೆನ್ಲಿಯನ್
Miss	ಮಿಸ್
Manorama	ಮನೋರಮಾ
Sathanur	ಸಾಥನೂರ್
Reservoir	ರಿಜರ್ವಾಯರ್
Indiana	ಇಂಡಿಯಾನಾ
Madine	ಮದೀದೆ
Ki	ಕಿ
Galiyan	ಗಲಿಯಾ
Kaushalya	ಕೌಶಲ್ಯಾ
Weeraratne	ವೀರರತ್ನೆ
Tiara	ಟಿಯಾರಾ
Michael	ಮೈಖೇಲ್
Ontaze	ಓಂಟೇಜ್
Nongkrem	ನೊಂಗ್‌ಕ್ರೆಮ್
Baalachandra	ಬಾಲಚಂದ್ರ
Prickett's	ಪ್ರಿಕೆಟ್ಸ್
fort	ಫೋರ್ಟ್
Gold	ಗೋಲ್ಡ್
Chitrakot	ಚಿತ್ರಕೋಟ್
Mere	ಮೇರೆ
Jeevan	ಜೀವನ್
Saathi	ಸಾಥಿ
Martin	ಮಾರ್ಟಿನ್
Sheen	ಶೀನ್
Barabil	ಬಾರಾಬಿಲ್
Akola	ಅಕೋಲಾ
Junction	ಜಂಕ್ಷನ್
Renault	ರೆನಾಲ್ಟ್
Tickner	ಟಿಕ್ನರ್
Hameed	ಹಮೀದ್
Tharya	ಥಾರ್ಯಾ
Ghitbah	ಗಿತ್ಬಾಹ್
Amit	ಅಮಿತ್
Bornhem	ಬಾರ್ನ್‌ಹೆಮ್
fort	ಫೋರ್ಟ್
Giran	ಗಿರನ್
Compugen	ಕಂಪ್ಯೂಜೆನ್
Begham	ಬೇಗಂ
Atchafalaya	ಅಚಾಫಲಯ
United	ಯುನೈಟೆಡ್
Kingdom	ಕಿಂಗ್‌ಡಂ
Dharmabad	ಧರ್ಮಬಾದ್
Sidhi	ಸಿದ್ಧಿ
Fort	ಫೋರ್ಟ್
stark	ಸ್ಟಾರ್ಕ್
Hukum	ಹುಕುಮ್
Ka	ಕಾ
Ikka	ಇಕ್ಕಾ
Kaustav	ಕೌಸ್ತವ್
Marengo	ಮರೆಂಗೊ
Amar	ಅಮರ್
Shaheed	ಶಹೀದ್
Raghav	ರಾಘವ್
Fateenah	ಫತೀನಾ
Lokapaal	ಲೋಕಪಾಲ್
Jo	ಜೋ
Angel	ಏಂಜೆಲ್
Sati	ಸತಿ
Nagkanaya	ನಾಗಕನ್ಯಾ
Nova	ನೋವಾ
Intikhab	ಇಂತಿಕಾಬ್
Megan	ಮೇಗನ್
Gajare	ಗಜಾರೆ
Sheldon	ಶೆಲ್ಡನ್
Vakratund	ವಕ್ರತುಂಡ್
Maajha	ಮಾಝಾ
Ishtiyaq	ಇಶ್ತಿಯಾಕ್
Mere	ಮೇರೆ
Huzoor	ಹುಜೂರ್
Gurbhagat	ಗುರುಭಗತ್
Vikram	ವಿಕ್ರಮ್
Vetal	ಬೇತಾಲ್
Randall	ರೇಂಡಲ್
Nona	ನೋನಾ
Ghatsila	ಘಟಸಿಲಾ
Andheri	ಅಂಧೇರಿ
Raat	ರಾತ್
Mein	ಮೆ
Diya	ದಿಯಾ
Tere	ತೇರಿ
Hath	ಹಾತ್
Mein	ಮೆ
Vijay	ವಿಜಯ್
Bharadwaj	ಭಾರದ್ವಾಜ್
Bougainville	ಬೌಗನ್‌ವಿಲ್ಲೆ
Cindy	ಸಿಂಡಿ
Sareen	ಸರೀನ್
Daund	ದೌನ್ದ್
Junction	ಜಂಕ್ಷನ್
Afaf	ಅಫಾಫ್
Meijer	ಮೈಜೆರ್
Samita	ಸಮಿತಾ
Cole	ಕೋಲ್
Prize	ಪ್ರೈಜ್
Jogeeshvar	ಜೋಗೀಶ್ವರ್
Vasant	ವಸಂತ್
Nayab	ನಯಾಬ್
Utkarsh	ಉತ್ಕರ್ಷ
Dhriti	ಧೃತಿ
Amartya	ಅಮರ್ತ್ಯ
Delvada	ದೆಲವಾಡಾ
Urmila	ಊರ್ಮಿಳಾ
Saangha	ಸಾಂಘಾ
Pal	ಪಲ್
Do	ದೊ
Pal	ಪಲ್
Ka	ಕಾ
Sath	ಸಾತ್
Morocco	ಮೊರೊಕ್ಕೋ
Damara	ಡಮಾರಾ
Aalim	ಆಲಿಮ್
Sikka	ಸಿಕ್ಕಾ
Avedis	ಅವೆಡಿಸ್
Bombarde	ಬಂಬಾರ್ಡಿ
Chris	ಕ್ರಿಸ್
Harris	ಹ್ಯಾರಿಸ್
Orange	ಆರೆಂಜ್
Prize	ಪ್ರೈಜ್
for	ಫಾರ್
Fiction	ಫಿಕ್ಷನ್
Bhupen	ಭೂಪೇನ್
Dewanganj	ದೇವನ್‌ಗಂಜ್
Qurbani	ಕುರ್ಬಾನಿ
Dionne	ಡಿಯೊನ್ನೆ
Rafe	ರೇಫ್
War	ವಾರ್
of	ಆಫ್
Jenkins'	ಜೆನ್ಕಿನ್ಸ್
Ear	ಇಯರ್
Dhandari	ಧಂಡಾರಿ
Kalan	ಕಲನ್
Chennai	ಚೆನ್ನೈ
Petro	ಪೆಟ್ರೋ
Insaaf	ಇನ್ಸಾಫ್
Ki	ಕಿ
Pukar	ಪುಕಾರ್
Philomena	ಫಿಲೋಮಿನಾ
Bageshwar	ಬಾಗೇಶ್ವರ್
Germain	ಜರ್ಮೆನ್
Intel	ಇಂಟೆಲ್
Kunwara	ಕುನ್ವಾರಾ
Baap	ಬಾಪ್
Sitar	ಸಿತಾರ್
Abhisok	ಅಭಿಶೋಕ್
Savage	ಸಾವೇಜ್
Prem	ಪ್ರೇಮ್
Sangeet	ಸಂಗೀತ್
Shree	ಶ್ರೀ
Ram	ರಾಮ
Bhakta	ಭಕ್ತ
Hanuman	ಹನುಮಾನ್
Bairaag	ಬೈರಾಗ್
David	ಡೇವಿಡ್
Brain	ಬ್ರೈನ್
Strait	ಸ್ಟೈಟ್
of	ಆಫ್
Hormuz	ಹೊಜ್‌ಮುಜ್
Yadu	ಯಾದು
Do	ದೋ
Musafir	ಮುಸಾಫಿರ್
Mahaabodhi	ಮಹಾಬೋಧಿ
Doda	ದೋಡಾ
Agartala	ಅಗರ್ತಲಾ
Mawdud	ಮಾವ್‌ದುದ್
Jai	ಜೈ
Mahalaxmi	ಮಹಾಲಕ್ಷ್ಮಿ
Maa	ಮಾ
Khalsa	ಖಾಲಸಾ
Chhabili	ಛಬಿಲಿ
Ranjini	ರಂಜಿನಿ
Abdul	ಅಬ್ಜುಲ್
afuw	ಅಫೂವ್
Pahu	ಪಹು
Deepak	ದೀಪಕ್
Fert	ಫರ್ಟಿಲೈಸರ್ಸ್
Indivar	ಇಂದೀವರ
Khalda	ಖಾಲಡಾ
Manager	ಮೇನೇಜರ್
Thomas	ಥಾಮಸ್
Paine	ಪೆಯ್ನಿ
Talibah	ತಾಲಿಬಾ
Lake	ಲೇಕ್
District	ಡಿಸ್ಟ್ರಿಕ್ಟ್
Kaylana	ಕೆಲಾನಾ
Suhayr	ಸುಹೇರ್
River	ರಿವರ್
of	ಆಫ್
Life	ಲೈಫ್
Family	ಫ್ಯಾಮಿಲಿ
Andy	ಆಂಡಿ
Bichel	ಬಿಚೆಲ್
Norwood	ನಾರ್ವುದ್
Jyotirmoyee	ಜ್ಯೋತಿರ್ಮಯಿ
Trend	ಟ್ರೆಂಡ್
Micro	ಮೈಕ್ರೋ
Incorporated	ಇನ್ಕಾರ್ಪೊರೇಟೆಡ್
Mohammad	ಮೊಹ್ಮದ್
Salim	ಸಲೀಂ
Arivalagan	ಅರಿವಳಗನ್
Gatita	ಗೇಟಿಟಾ
Meghachand	ಮೇಘಚಂದ್
Zindagani	ಜಿಂದಗಾನಿ
Order	ಆರ್ಡರ್
of	ಆಫ್
Vytis	ವ್ಯಟಿಸ್
Devdutta	ದೇವದತ್ತಾ
Aaj	ಆಜ್
Ke	ಕೆ
Angaarey	ಅಂಗಾರೆ
Boliviano	ಬೊಲಿವಿಯಾನೊ
Mahaaraajaa	ಮಹಾರಾಜ
Jakhad	ಜಾಖಡ್
Sudakshima	ಸುದಕ್ಷಿಮಾ
Bob	ಬಾಬ್
Dylan	ಡಿಲೆನ್
Peetaa	ಪೀತಾ
Sidki	ಸಿದಕಿ
Maayaaraam	ಮಾಯಾರಾಮ್
Garhwal	ಗರ್ವಾಲ್
Gualtier	ಗಾಲ್ಟಿಯರ್
Major	ಮೇಜರ್
League	ಲೀಗ್
Lacrosse	ಲಾಕ್ರೊಸ್
Defensive	ಡಿಫೆನ್ಸಿವ್
player	ಪ್ಲೇಯರ್
of	ಆಫ್
the	ದ
Year	ಈಯರ್
Award	ಅವಾರ್ಡ್
Kudrat	ಕುದರತ್
Ka	ಕಾ
Kanoon	ಕಾನೂನ್
Maili	ಮೈಲಿ
Gullpur	ಗುಲ್ಲಪುರ್
Qanoun	ಕಾನೌನ್
Pick	ಪಿಕ್
Pocket	ಪಾಕೆಟ್
Beverly	ಬೆವೆರ್ಲಿ
Sills	ಸಿಲ್ಸ್
Chambal	ಚಂಬಲ್
Ki	ಕಿ
Kasam	ಕಸಮ್
Japendra	ಜಪೇಂದ್ರ
Willingdon	ವಿಲ್ಲಿಂಗ್‌ಡನ್
Reservoir	ರಿಜರ್ವಾಯರ್
Mountain	ಮೌಂಟನ್
Zebra	ಜೀಬ್ರಾ
Prahlad	ಪ್ರಹ್ಲಾದ್
Jenibelle	ಜೆನೀಬೆಲ್ಲಾ
Aloarakh	ಆಲೋರಖ್
Kapish	ಕಪೀಶ
Aaina	ಆಯಿನಾ
Livingston	ಲಿವಿಂಗ್ಸ್ಟನ್
Sofon	ಸೋಫೋನ್
Suphapong	ಸುಫಾಪೋಂಗ್
Franz	ಫ್ರಾನ್ಜ್
Haniel	ಹೇನಿಯಲ್
Chandlodiya	ಚಂದಲೋದಿಯಾ
Aayi	ಆಯಿ
Yaad	ಯಾದ್
Teri	ತೆರಿ
James	ಜೇಮ್ಸ್
Marshall	ಮಾರ್ಷಲ್
Crescent	ಕ್ರೆಸೆಂಟ್
City	ಸಿಟಿ
Barauni	ಬಾರೌನಿ
Junction	ಜಂಕ್ಷನ್
Albela	ಅಲ್ಬೇಲಾ
Mastana	ಮಸ್ತಾನಾ
Dindori	ದಿಂಡೋರಿ
Sadagoppan	ಸಡಗೋಪನ್
Ramesh	ರಮೇಶ್
Anuyaayita	ಅನುಯಾಯಿತಾ
Ian	ಇಯಾನ್
Bradshaw	ಬ್ರಾಡ್‌ಶಾ
Rod	ರಾಡ್
Latham	ಲಥಾಮ್
Aparnesh	ಅಪರ್ಣೇಶ್
Jenaya	ಜೆನೆಯಾ
Mercia	ಮೆರ್ಸಿಯಾ
Sigmund	ಸಿಗ್ಮಂಡ್
Freud	ಫ್ರಾಯ್ಡ್
Saint	ಸೆಂಟ್
John's	ಜಾನ್ಸ್
High	ಹೈ
School,	ಸ್ಕೂಲ್,
Chandigarh	ಚಂಡೀಗಢ್
Janda	ಜಂದಾ
Pannet	ಪ್ಯಾನೆಟ್
Bhogpur	ಭೋಗಪುರ್
Sirwal	ಸಿರವಾಲ್
Goldene	ಗೋಲ್ಡ್‌ನ್
Kamera	ಕಮೇರಾ
Suhaylah	ಸುಹೇಲಾ
Ranade	ರಾನಡೆ
Bhagwan	ಭಗವಾನ್
Sare	ಸಾರೆ
Sansar	ಸನ್ಸಾರ್
Mein	ಮೆ
Maa	ಮಾ
Ki	ಕೀ
Mamta	ಮಮತಾ
Yar	ಯಾರ್
Archie	ಆರ್ಚೀ
Fawwaz	ಫವಾಜ್
Bethlehem	ಬೆತ್ಲೆಹೆಮ್
Lutheran	ಲುಥೆರಾನ್
Gomati	ಗೋಮತಿ
Nagar	ನಗರ್
Thawab	ಥಾವಬ್
Marwah	ಮರಾವಾಹ್
Minjonet	ಮಿಂಜೋನೆಟ್
Dickens	ಡಿಕ್ಸನ್
Smoutakker	ಸ್ಮೌವ್‌ತಕ್ಕರ್
Sahirah	ಸಹೀರಾ
Kalista	ಕಲಿಸ್ತಾ
Johar	ಜೋಹರ್
Mehmood	ಮೆಹಮೂದ್
In	ಇನ್
Goa	ಗೋವಾ
Rubicon	ರುಬಿಕನ್
Dhana	ಧಾನಾ
Kherli	ಖೆರಲೀ
Akshay	ಅಕ್ಷಯ್
Naman	ನಮನ್
Abhihit	ಅಭಿಹಿತ್
Block	ಬ್ಲಾಕ್
Island	ಐಲ್ಯಾಂಡ್
Order	ಆರ್ಡರ್
of	ಆಫ್
the	ದ
Phoenix	ಫೋನಿಕ್ಸ್
Azaraqi	ಅಜರಾಕಿ
Norina	ನೋರಿನಾ
Bhabhi	ಭಾಭೀ
Ka	ಕಾ
Ashirwad	ಆಶೀರ್ವಾದ್
Danniell	ಡ್ಯಾನಿಯಲ್
Bade	ಬಡೇ
Ghar	ಘರ್
Ki	ಕಿ
Bahu	ಬಹು
Dave	ಡೇವ್
Mohammed	ಮೊಹಮ್ಮದ್
Ganesh	ಗಣೇಶ್
Jamshedpur	ಜಂಷೆಡ್ಪುರ್
Blue	ಬ್ಲೂ
Ridge	ರಿಡ್ಜ್
Nikhilesh	ನಿಖಿಲೇಶ್
Lake	ಲೇಕ್
Shikhar	ಶಿಖರ್
Madhunisha	ಮಧುನಿಶಾ
Steele	ಸ್ಟೀಲೆ
Prize	ಪ್ರೈಜ್
Mumin	ಮುಮಿನ್
Yaar	ಯಾರ್
Kasam	ಕಸಮ್
Staddon	ಸ್ಟ್ಯಾಡನ್
fort	ಫೋರ್ಟ್
Devabrata	ದೆವಬ್ರತಾ
Jassal	ಜಸ್ಸಲ್
Behram	ಬೆಹರಮ್
Khan	ಖಾನ್
Gwenifer	ಗ್ವೆನಿಫರ್
Muralimanohar	ಮುರಳಿಮನೋಹರ
Shrawan	ಶ್ರವಣ
Kumar	ಕುಮಾರ
Duniya	ದುನಿಯಾ
Nachegi	ನಾಚೇಗೀ
Ojaswini	ಓಜಸ್ವಿನಿ
Thais	ಥಾಯಿಸ್
Tahir	ತಾಹಿರ್
Ansar	ಅನ್ಸರ್
Andhi	ಅಂಧಿ
Gali	ಗಲೀ
Mick	ಮಿಕ್
Lewis	ಲೆವಿಸ್
Dina	ದಿನಾ
Nagar	ನಗರ್
Anneliese	ಅನ್ನೆಲೀಸ್
Mehboobnagar	ಮೆಹಬೂಬನಗರ್
Anupamaa	ಅನುಪಮಾ
Afif	ಅಫೀಫ್
Anaum	ಅನಾಮ್
Veer	ವೀರ್
Bhimsen	ಭೀಮಸಿಂಹ್
Dudwindi	ದುದ್ವಿಂಡಿ
Akasha	ಆಕಾಶ
The	ದಿ
alamo	ಅಲಾಮೊ
Sinead	ಸಿನಿಯಾಡ್
Tekla	ಟೆಕ್ಲಾ
Taj	ತಾಜ್
Sadguna	ಸದ್ಗುಣ
International	ಇಂಟರ್‌ನ್ಯಾಶನಲ್
Center	ಸೆಂಟರ್
of	ಆಫ್
Photography	ಫೋಟೊಗ್ರಫಿ
Manamaujee	ಮನಮೌಜೀ
Milton	ಮಿಲ್ಟನ್
Ballard	ಬಲಾರ್ಡ್
Power	ಪವರ್
Systems	ಸಿಸ್ಟಮ್ಸ್
Adam	ಆದಂ
Bacher	ಬ್ಯಾಚರ್
Chuck	ಚುಕ್
Norris	ನೋರಿಸ್
Lazzaro	ಲಝಾರೊ
Pathanamthitta	ಪಟ್ಟಣಂತಿಟ್ಟ
Abdul	ಅಬ್ದುಲ್
muhaasin	ಮುಹಾಸಿನ್
Aa	ಆ
Gale	ಗಲೇ
Lag	ಲಗ್
Ja	ಜಾ
Kalyani	ಕಲ್ಯಾಣಿ
Petronas	ಪೆಟ್ರೋನಾಸ್
Peter	ಪೀಟರ್
Webb	ವೆಬ್
Nartaki	ನರ್ತಕಿ
Chitra	ಚಿತ್ರ
Shrirang	ಶ್ರೀರಂಗ
Shabbeer	ಶಬೀರ್
Qaisar	ಖೇಸರ್
Sati	ಸತಿ
Anjani	ಅಂಜನಿ
Eltek	ಎಲ್ಟೆಕ್
Harmonium	ಹಾರ್ಮೋನಿಯಂ
Bhuvaneswari	ಭುವನೇಶ್ವರಿ
Hindu	ಹಿಂದು
Yudhishthir	ಯುಧಿಷ್ಟರ್
Yaagyik	ಯಾಜ್ಞಿಕ್
Halwani	ಹಲ್ವಾನಿ
Chunneelaal	ಚುನ್ನೀಲಾಲ್
Kortenaer	ಕೋರ್ಟೆನರ್
Mistah	ಮಿಸ್ತಾ
Kirayedar	ಕಿರಾಯೆದಾರ್
Wrestling	ರೆಸ್ಲಿಂಗ್
Russian	ರಷ್ಯನ್
Federation	ಫೆಡರೇಶನ್
Order	ಆರ್ಡರ್
of	ಆಫ್
the	ದ
Golden	ಗೊಲ್ಡನ್
Fleece	ಫ್ಲೀಸ್
Choudhary	ಚೌಧರಿ
Janasah	ಜನಸಾಹ್
Fort	ಫೋರ್ಟ್
wool	ವುಲ್
Cardinal	ಕಾರ್ಡಿನಲ್
Health	ಹೆಲ್ತ್
Raghunath	ರಘುನಾಥ
Shakeel	ಶಕೀಲಾ
Nalin	ನಳಿನ್
Kopargaonkar	ಕೋಪರ್‌ಗಾಂವಕರ್
Chihuahuan	ಚಿಹುವಾಹುವಾನ್
Pujit	ಪೂಜಿತ್
Khuraymah	ಖುರೇಮಾ
Dianne	ಡಿಯಾನ್ನೆ
Dainik	ದೈನಿಕ್
jugasankha	ಜುಗಸಂಖ್
Kapindra	ಕಪೀಂದ್ರ
Vinaya	ವಿನಯಾ
Rockingham	ರಾಂಕಿಂಗ್‌ಹ್ಯಾಂ
James	ಜೇಮ್ಸ್
Kamande	ಕಮಾಂಡೆ
Dougal	ಡೌಗಲ್
Grace	ಗ್ರೇಸ್
Family	ಫ್ಯಾಮಿಲಿ
Gotegaon	ಗೊಟೆಗಾಂವ್
Orthofix	ಆರ್ಥಓಫಿಕ್ಸ್
International	ಇಂಟರ್ನ್ಯಾಷನಲ್
Anjar	ಅಂಜರ್
Angus	ಅಂಗಸ್
Lambodar	ಲಂಬೋದರ
Solange	ಸೋಲಂಜ್
Myrilla	ಮಾಯಿರಿಲಾ
Ho-Am	ಹೊ-ಎಮ್
Prize	ಪ್ರೈಜ್
High	ಹೈ
Island	ಐಲ್ಯಾಂಡ್
Reservoir	ರಿಜರ್ವಾಯರ್
Pura	ಪುರಾ
Khoon	ಖೂನ್
Aur	ಔರ್
Paani	ಪಾನಿ
Phiroza	ಫಿರೋಜಾ
Kudremukh	ಕುದುರೆಮುಖ್
Rasheed	ರಶೀದ್
Chandrakin	ಚಂದ್ರಕಿನ್
John	ಜಾನ್
Aubuchon	ಆಬುಚೋನ್
Freedom	ಫ್ರೀಡಮ್
Maine	ಮೈ
Pyar	ಪ್ಯಾರ್
Kiya	ಕಿಯಾ
Phir	ಫಿರ್
Janam	ಜನಮ್
Lenge	ಲೇಂಗೆ
Hum	ಹಮ್
Mark	ಮಾರ್ಕ್
Ramprakash	ರಾಮಪ್ರಕಾಶ್
Tarzan	ಟಾರ್ಜನ್
And	ಅಂಡ್
Cobra	ಕೋಬರಾ
Jwar	ಜ್ವಾರ್
Bhata	ಭಾಟಾ
Jad	ಜದ್
Purushottam	ಪುರುಷೋತ್ತಮ
Peetaabh	ಪೀತಾಭ್
Charita	ಚರಿತಾ
Bipin	ಬಿಪಿನ್
Ruma	ರೂಮಾ
Bal	ಬಾಲ
Brahmachari	ಬ್ರಹ್ಮಾಚಾರಿ
Hashmat	ಹಶ್ಮತ್
Summerside	ಸಮ್ಮರ್‌ಸೈಡ್
United	ಯುನೈಟೆಡ್
Methodist	ಮೆಥೋಡಿಸ್ಟ್
Raeanne	ರೇನಿ
New	ನ್ಯೂ
Beginnings	ಬಿಗಿನಿಂಗ್ಸ್
Christian	ಕ್ರಿಶ್ಚಿಯನ್
Punia	ಪುನಿಯಾ
Manprasad	ಮನಪ್ರಸಾದ್
Suresh	ಸುರೇಶ್
Raina	ರಾಯನ್
Shahriar	ಶಹರಿಯಾರ್
Hossain	ಹುಸೇನ್
Christine	ಕ್ರಿಸ್ಟೀನ್
Darbhanga	ದರಭಾಂಗಾ
Junction	ಜಂಕ್ಷನ್
The	ದ
Dahesh	ದಹೇಶ್
Museum	ಮ್ಯೂಸಿಯಂ
Ranthambhore	ರಣತಂಬೋರ್
fort	ಫೋರ್ಟ್
Peelaa	ಪೀಲಾ
Lav	ಲಾವ್
Bannerghatta	ಬನ್ನೇರುಘಟ್ಟ
Bryan	ಬ್ರಯಾನ್
Strang	ಸ್ಟ್ರಾಂಗ್
Manmohan	ಮನಮೋಹನ
Cha	ಚಾ
Cha	ಚಾ
Cha	ಚಾ
Capital	ಕ್ಯಾಪಿಟಲ್
Tower	ಟವರ್
Choquella	ಚೋಕೆಲಾ
Fort	ಫೋರ್ಟ್
victoria	ವಿಕ್ಟೋರಿಯಾ
Delta	ಡೆಲ್ಟಾ
Galil	ಗಲೀಲ್
Industries	ಇಂಡಸ್ಟ್ರೀಸ್
Prem	ಪ್ರೇಮ್
Pujari	ಪುಜಾರಿ
Koyna	ಕೋಯ್ನಾ
Dam	ಡ್ಯಾಮ್
Avanindar	ಅವನಿಂದರ್
Rose	ರೋಸ್
Hill	ಹಿಲ್
Evangelical	ಇವಾಂಜಲಿಕಲ್
Free	ಫ್ರೀ
Afra	ಅಫ್ರಾ
Tula	ಟುಲಾ
Munich	ಮ್ಯೂನಿಚ್
Re	ರಿ
Group	ಗ್ರೂಪ್
Margo	ಮಾರ್ಗೋ
Caribe	ಕೇರಿಬ್
French	ಫ್ರೆಂಚ್
Revolutionary	ರೆವಲ್ಯೂಶನರಿ
Wars	ವಾರ್ಸ್
Aacharyasutaa	ಆಚಾರ್ಯಸುತಾ
Emberlynn	ಏಂಬರ್ಲಿನ್
Groupama	ಗ್ರೂಪಮಾ
Ova	ಓವಾ
Rakesh	ರಾಕೇಶ್
Ganga	ಗಂಗಾ
Mang	ಮಾಗ
Rahi	ರಹೀ
Balidan	ಬಲಿದಾನ್
Beeraam	ಬೀರಾಮ್
Nibodh	ನಿಬೋಧ್
Fattanwala	ಫತ್ತಣವಾಲಾ
Bhore	ಭೋರೆ
University	ಯುನಿವರ್ಸಿಟಿ
of	ಆಫ್
Luton	ಲೂಟನ್
The	ದ
British	ಬ್ರಿಟಿಷ್
School,	ಸ್ಕೂಲ್,
New	ನ್ಯೂ
Delhi	ಡೆಲ್ಲಿ
Maxwell	ಮ್ಯಾಕ್ಸ್‌ವೆಲ್
Anou	ಅನೌ
Timedouine	ಟೈಮ್ಡೂಯಿನ್
Nripesh	ನೃಪೇಶ್
Kusumakar	ಕುಸುಮಾಕರ
Bholi	ಭೋಲೀ
Ellen	ಎಲೆನ್
Swaraj	ಸ್ವರಾಜ್
Engines	ಇಂಜಿನ್ಸ್
Colum	ಕೋಲಂ
George	ಜಾರ್ಜ್
Harrison	ಹ್ಯಾರಿಸನ್
Rijuta	ಋಜುತಾ
Ahamad	ಅಹಮದ್
Zahoor	ಜಹೂರ್
Elahi	ಇಲಾಹಿ
Dujanah	ದುಜಾನಾ
Arzoo	ಆರಜೂ
Dharam	ಧರಮ್
Shatru	ಶತ್ರು
Mudra	ಮುದ್ರಾ
Vince	ವಿನ್ಸಿ
Aatmaja	ಆತ್ಮಜ
Iqbal	ಇಖ್ಬಾಲ್
Siddiqui	ಸಿದ್ದಿಕಿ
Apoorvaa	ಅಪೂರ್ವಾ
Avinash	ಅವಿನಾಶ್
Timila	ತಿಮಿಲಾ
Capodistria	ಕ್ಯಾಪೊಡಿಸ್ಟ್ರಿಯಾ
Museum	ಮ್ಯೂಸಿಯಂ
Phil	ಫಿಲ್
Osaka	ಒಸಾಕ
Derron	ಡೆರೋನ್
Kinshasa	ಕಿನ್ಶಾಸಾ
Keoladeo	ಕಿಲಾಡಿಯೊ
Ghana	ಘನಾ
Danske	ದಾನ್ಸ್ಕೆ
Bank	ಬ್ಯಾಂಕ್
Group	ಗ್ರೂಪ್
Juliette	ಜೂಲಿಯೆಟ್
Ghareebah	ಗರೀಬಾಹ್
Malaga	ಮಲಗಾ
Do	ದೋ
Matwale	ಮತವಾಲೆ
Miftah	ಮಿಫ್ತಾ
Meerut	ಮೀರತ್
Danish	ದನೀಶ್
Kaneria	ಕನೇರಿಯಾ
Myron	ಮಾಯರನ್
Abdul	ಅಬ್ದುಲ್
kareem	ಕರೀಂ
Carl	ಕಾರ್ಲ್
Cachopa	ಕಚೋಪಾ
Duer	ಡುವರ್
Gujarati	ಗುಜರಾತಿ
Alana	ಅಲಾನಾ
Restoration	ರಿಸ್ಟೋರೇಶನ್
Riyal	ರಿಯಾಲ್
Jura	ಜುರಾ
Ashraf	ಅಶ್ರಫ್
Ali	ಅಲಿ
Guma	ಗುಮಾ
Shuk	ಶುಕ್
Rambha	ರಂಭಾ
Fudail	ಫ್ಯೂಡೇಲ್
Stu	ಸ್ಟು
Ghunayn	ಗುತಾಯನ್
Marnie	ಮಾರ್ನೀ
Bedreddin	ಬೆಡ್ರೆದ್ದಿನ್
Ramesh	ರಮೇಶ್
Basbas	ಬಸ್ಬಾಸ್
Richard	ರಿಚರ್ಡ್
Austin	ಆಸ್ಟಿನ್
Carl	ಕಾರ್ಲ್
Tuckett	ಟಕೆಟ್
Saadi	ಸಾದಿ
Shirazi	ಶಿರಾಜಿ
Yeh	ಯೇ
Woh	ವಹ್
Manzil	ಮಂಜಿಲ್
To	ತೋ
Nahin	ನಹೀ
Worth	ವರ್ಥ್
Galaxidi	ಗೆಲ್ಯಾಕ್ಸಿಡಿ
Maritime	ಮೆರಿಟೈಮ್
Museum	ಮ್ಯೂಸಿಯಂ
Lamya	ಲಮ್ಯ
Vidya	ವಿದ್ಯಾ
Balaghat	ಬಲಘಾಟ್
Prix	ಪ್ರಿಕ್ಸ್
Renaudot	ರೆನೌಡಾಟ್
Hibernia	ಹಿಬರ್ನಿಯಾ
Caulfield	ಕಾಲ್‌ಫೀಲ್ಡ್
Cup	ಕಪ್
Chowki	ಚೌಕಿ
Number	ನಂಬರ್
Jyotiba	ಜ್ಯೋತಿಬಾ
Phule	ಫುಲೆ
Nagar	ನಗರ್
Barkat	ಬರ್ಕತ್
Tyagarajar	ತ್ಯಾಗರಾಜ
Hamara	ಹಮಾರಾ
Watan	ವತನ್
Electricite	ಎಲೆಕ್ಟ್ರಿಸೈಟ್
De	ಡಿ
France	ಫ್ರಾನ್ಸ್
Vishvaamitr	ವಿಶ್ವಾಮಿತ್ರ್
Jouhikko	ಜೌಹಿಕೊ
Hua	ಹುವಾ
Savera	ಸವೇರಾ
Draupadi	ದ್ರೌಪದೀ
Vastra	ವಸ್ತ್ರ
Haran	ಹರಣ್
Dahshat	ದಹಶತ್
Ali	ಆಲಿ
Shah	ಶಾ
Saburah	ಸಬುರಾ
Aadinaarayan	ಆದಿನಾರಾಯಣ
Shariful	ಶರೀಫುಲ್
Haque	ಹಕ್
One-step	ಒನ್-ಸ್ಟೆಪ್
Xadrian	ಜಾರ್ಡಿಯನ್
Sharifah	ಶರೀಫಾ
Mandir	ಮಂದಿರ್
Kato	ಕಾಟೋ
Coral	ಕೋರಲ್
Guilford	ಗಿಲ್ಫೋರ್ಡ್
Apurv	ಅಪೂರ್ವ
Abdul	ಅಬ್ದುಲ್
hadi	ಹದೀ
Sinharaja	ಸಿನ್ಹರಾಜಾ
Forest	ಫಾರೆಸ್ಟ್
Reserve	ರಿಸರ್ವ್
Nordea	ನಾರ್ಡಿಯಾ
Bank	ಬ್ಯಾಂಕ್
Naya	ನಯಾ
Ghar	ಘರ್
Nateeja	ನತೀಜಾ
Bakhtiyarpur	ಬಕ್ತಿಯಾರ್‌ಪುರ್
Junction	ಜಂಕ್ಷನ್
Novamerican	ನೋವಾಮೆರಿಕನ್
Steel	ಸ್ಟೀಲ್
Valerian	ವೆಲೆರಿಯನ್
Suparnak	ಸುಪರ್ಣಕ್
Rituparan	ಋತುಪರ್ಣ
Bossa	ಬುಸ್ಸಾ
nova	ನೋವಾ
Numa	ನುಮಾ
Sall	ಸಲ್ಲ್
Aberdeen	ಅಬರ್ಡೀನ್
Apaanpati	ಅಪಾನ್‌ಪತಿ
Kelavarapalli	ಕೆಲಾವರಪಲ್ಲಿ
Reservoir	ರಿಜರ್ವಾಯರ್
Sai	ಸಾಯಿ
Baba	ಬಾಬಾ
of	ಆಫ್
Shirdi	ಶಿರ್ಡಿ
Jhansi	ಝಾಂನ್ಸಿ
Ki	ಕಿ
Rani	ರಾಣಿ
Oswald	ಆಸ್ವರ್ಡ್
Veblen	ವೆಬ್ಲನ್
Prize	ಪ್ರೈಜ್
in	ಇನ್
Geometry	ಜಾಮಿಟ್ರಿ
Bahiru	ಬಹಿರೂ
Idd	ಈದ್
Mubarak	ಮುಬಾರಕ್
Saeed	ಸಯೀದ್
Anwar	ಅನ್ವರ್
Achinty	ಅಚಿಂತ್ಯ
Kahani	ಕಹಾನಿ
Hum	ಹಮ್
Sab	ಸಬ್
Ki	ಕಿ
Meadow	ಮೀಡೊ
Gulzarbagh	ಗುಲ್ಜಾರ್‌ಬಾಗ್
Ian	ಇಯಾನ್
Bishop	ಬಿಷಪ್
Hambada	ಹಂಬಡಾ
Glatton	ಗ್ಲಾಟನ್
Ishq	ಇಶ್ಕ್
Ishq	ಇಶ್ಕ್
Ishq	ಇಶ್ಕ್
Schiller	ಸ್ಕಿಲ್ಲರ್
Prize	ಪ್ರೈಜ್
Pragati	ಪ್ರಗತಿ
Sidath	ಸಿದಾತ್
Wettimuny	ವೆಟ್ಟಿಮುನಿ
Arivumani	ಅರಿವುಮಣಿ
Lasker	ಲಾಸ್ಕರ್
Award	ಅವಾರ್ಡ್
Geometric	ಜ್ಯಾಮಿಟ್ರಿಕ್
Software	ಸಾಫ್ಟ್ವೇರ್
Solutions	ಸಲ್ಯೂಷನ್ಸ್
Yogini	ಯೋಗಿನಿ
Cura	ಕ್ಯುರಾ
Wasna	ವಸ್ನಾ
Hafsah	ಹಫ್ಸಾ
Thabit	ಥಾಬಿತ್
Koning	ಕೊನಿಂಗ್
der	ಡೆರ್
Nederlanden	ನೆದರ್‌ಲ್ಯಾಂಡೆನ್
Avishka	ಅವಿಷ್ಕಾ
Gunawardene	ಗುಣವರ್ಧನೆ
Bartaman	ಬರ್ತಮಾನ್
patrika	ಪತ್ರಿಕಾ
Taank	ಟಾಂಕ್
Aamer	ಆಮಿರ್
Sohail	ಸೊಹೈಲ್
Juaari	ಜುವಾರಿ
Moira	ಮೋಯಿರಾ
Abdul	ಅಬ್ದುಲ್
adheem	ಅಧೀಮ್
Borkar	ಬೋರಕರ್
Patthar	ಪತ್ಧರ್
Ka	ಕಾ
Khwab	ಖ್ವಾಬ್
Chhina	ಛಿನಾ
Jung	ಜಂಗ್
Bahadur	ಬಹಾದುರ್
Fort	ಫೋರ್ಟ್
independence	ಇಂಡಿಪೆಂಡೆನ್ಸ್
Chand	ಚಂದ್
Ki	ಕಿ
Duniya	ದುನಿಯಾ
Bir	ಬರ್
Protik	ಪ್ರೊಟಿಕ್
Bombay	ಬಾಂಬೆ
Race	ರೇಸ್
Course	ಕೋರ್ಸ್
Raseem	ರಸೀಂ
Ladies	ಲೇಡೀಸ್
Tailor	ಟೇಲರ್
Avariella	ಅವರಿಯೆಲಾ
Iago	ಇಯಾಗೋ
Stirling	ಸ್ಟಿರ್ಲಿಂಗ್
Prize	ಪ್ರೈಜ್
Mula	ಮುಲಾ
Prawara	ಪ್ರವರ
Bharath	ಭಾರತ್
Reddy	ರೆಡ್ಡಿ
Wilson	ವಿಲ್ಸನ್
Rawlins	ರಾಲಿನ್ಸ್
Ardh	ಅರ್ಧ್
Satya	ಸತ್ಯ
Afroze	ಅಫ್ರೋಜ್
Iqbal	ಇಕ್ಬಾಲ್
Sikander	ಸಿಕಂದರ್
Pratibha	ಪ್ರತಿಭಾ
Raghubir	ರಘುಬಿರ್
Somakant	ಸೋಮಕಾಂತ್
Laasya	ಲಾಸ್ಯ
Balaraaj	ಬಾಲರಾಜ್
Alpine	ಅಲ್ಪೈನ್
Skiing	ಸ್ಕೀಯಿಂಗ್
World	ವರ್ಲ್ಡ್
Cup	ಕಪ್
Bhutto	ಭುಟ್ಟೊ
Dhruva	ಧೃವಾ
Navratri	ನವರಾತ್ರಿ
Steve	ಸ್ಟೀವ್
Waugh	ಕ್ಲಾರ್ಕ್
Brahma	ಬ್ರಹ್ಮ
Amanjeet	ಅಮನ್‌ಜೀತ್
Shivapriyaa	ಶಿವಪ್ರಿಯ
Gaurinath	ಗೌರೀನಾಥ್
kullu	ಕುಲ್ಲು
Mohammad	ಮೊಹ್ಮದ್
Kaif	ಕೈಫ್
Qatl	ಕತ್ಲ್
Raibareli	ರಾಯ್ ಬರೇಲಿ
Prem	ಪ್ರೇಮ್
Sandesh	ಸಂದೇಶ್
Manjural	ಮಂಜುರಲ್
Islam	ಇಸ್ಲಾಂ
Rana	ರಾಣಾ
Country	ಕಂಟ್ರಿ
western	ವೆಸ್ಟ್ರನ್
two-step	ಟೂ-ಸ್ಟೆಪ್
Shahdol	ಶಾದೂಲ್
Rivaaj	ರಿವಾಜ್
Wamil	ವಾಮಿಲ್
Sudeepta	ಸುದೀಪ್ತ
Sesa	ಸೀಸಾ
Goa	ಗೋವಾ
Ian	ಇಯಾನ್
Daniel	ಡೇನಿಯಲ್
National	ನ್ಯಾಶನಲ್
Art	ಆರ್ಟ್
Gallery	ಗ್ಯಾಲರಿ
and	ಅಂಡ್
Alexandros	ಅಲೆಕ್ಸಾಂಡ್ರೋಸ್
Soutzos	ಸುಝಾಸ್
Museum	ಮ್ಯೂಸಿಯಂ
Agent	ಏಜೆಂಟ್
Vinod	ವಿನೋದ್
Gidang	ಗಿದಂಗ್
Museum	ಮ್ಯೂಸಿಯಂ
Ek	ಏಕ್
Masoom	ಮಾಸೂಮ್
Loharganj	ಲೋಹರಗಂಜ್
Mark	ಮಾರ್ಕ್
Bailey	ಬೈಲೀ
Gulf	ಗಲ್ಫ್
Oil	ಆಯಿಲ್
Minsk	ಮಿನ್ಸ್‌ಕ್
Hamari	ಹಮಾರಿ
Duniya	ದುನಿಯಾ
Yala	ಯಾಲಾ
New	ನ್ಯೂ
Springs	ಸ್ಪ್ರಿಂಗ್ಸ್
Christian	ಕ್ರಿಶ್ಚಿಯನ್
Adair	ಅಡೈರ್
Morpheus	ಮಾರ್ಫೆಅಸ್
Kael	ಕೇಲ್
Fort	ಫೋರ್ಟ್
meigs	ಮಿಗ್ಸ್
The	ದಿ
Broads	ಬ್ರಾಡ್ಸ್
Priestley	ಪ್ರಿಸ್ಟ್ಲೇ
Medal	ಮೆಡಲ್
Charles	ಚಾರ್ಲ್ಸ್
Lamb	ಲ್ಯಾಂಬ್
Delhi	ದೆಲ್ಲಿ
Junction	ಜಂಕ್ಷನ್
Door	ದೂರ್
Gagan	ಗಗನ್
Ki	ಕೀ
Chhaon	ಛಾವ
Mein	ಮೇ
Christ	ಕ್ರಿಸ್ಟ್
the	ದ
King	ಕಿಂಗ್
Lutheran	ಲುಥೆರಾನ್
Aur	ಔರ್
Pyar	ಪ್ಯಾರ್
Ho	ಹೋ
Gaya	ಗಯಾ
Jacksonville	ಜಾಕ್ಸನ್ ವಿಲ್ಲೆ
Baaz	ಬಾಝ್
Bahadur	ಬಹಾದೂರ್
Alamatti	ಆಲಮಟ್ಟಿ
Dam	ಡ್ಯಾಮ್
Humayrah	ಹುಮೇರಾ
Rokeby	ರೋಕಬಾಯ್
Museum	ಮ್ಯೂಸಿಯಂ
Anoop	ಅನೂಪ್
Anwesha	ಅನ್ವೇಷ
Grimme	ಗ್ರಿಮ್ಮಿ
Preis	ಫ್ರೀಸ್
Wahid	ವಹಿದ್
Bahlul	ಬಾಹ್ಲಲ್
Ghulam	ಗುಲಾಂ
Ali	ಅಲಿ
Sushamaa	ಸುಶಮಾ
Sri	ಶ್ರೀ
Thendayuthapani	ದಂಡಾಯುಧಪಾಣಿ
Tim	ಟಿಮ್
Allan	ಅಲನ್
Order	ಆರ್ಡರ್
of	ಆಫ್
the	ದ
Red	ರೆಡ್
Banner	ಬ್ಯಾನರ್
Cents	ಸೆಂಟ್ಸ್
Sara	ಸರಾ
Mushfiq	ಮುಷ್ಫಿಕ್
Conan	ಕೋನಾನ್
Sawa	ಸಾವಾ
Abdul	ಅಬ್ದುಲ್
muid	ಮುಯೀದ್
Troy	ಟ್ರೋಯ್
Angela	ಏಂಜೆಲಾ
Satvat	ಸತ್ವತ್
Bahlol	ಬಹಲೋಲ್
Kanhere	ಕಾನ್ಹೇರೆ
Dumariya	ದುಮಾರಿಯಾ
Yavanikaa	ಯವನಿಕಾ
Kingston	ಕಿಂಗ್‌ಸ್ಟನ್
University	ಯುನಿವರ್ಸಿಟಿ
Maulavee	ಮೌಲ್ವೀ
Jadzia	ಜಾಡ್ಜಿಯಾ
Rianna	ರಿಯಾನ್ನಾ
Farica	ಫ್ಯಾರಿಕಾ
Wafadaar	ವಫಾದಾರ್
Dominic	ಡಾಮಿನಿಕ್
Cork	ಕೋರ್ಕ್
Nyika	ನೀಕಾ
Plateau	ಪ್ಲ್ಯಾಟೊ
Virata	ವಿರಾಟ
Ashwinee	ಅಶ್ವಿನೀ
Bensonvale	ಬೆನ್ಸೋನ್ವಾಲೆ
Covenant	ಕೊವೆನೆಂಟ್
Sarala	ಸರಳಾ
Jhanak	ಝನಕ್
Jhanak	ಝನಕ್
Payal	ಪಾಯಲ್
Baje	ಬಜೆ
Chata	ಚಾತಾ
Amulya	ಅಮೂಲ್ಯ
Meri	ಮೇರಿ
Surat	ಸೂರತ್
Teri	ತೇರಿ
Ankhen	ಆಂಖೇ
Fiachra	ಫಿಯಾಚ್ರಾ
Grah	ಗೃಹ
Pravesh	ಪ್ರವೇಶ್
Gode	ಗೋಡೆ
Ardelis	ಆರ್ಡೆಲಿಸ್
Mainak	ಮೈನಕ್
Egypt	ಈಜಿಪ್ಟ್
Taha	ತಾಹಾ
Krishnamurari	ಕೃಷ್ಣಮುರಾರಿ
Ashtputre	ಅಷ್ಟಪುತ್ರೆ
Nadeem	ನದೀಂ
Ghauri	ಘೋರಿ
Mohul	ಮೊಹುಲ್
Winslow	ವಿನ್‌ಸ್ಲೋ
Ijaazat	ಇಜಾಜತ್
Encana	ಎಂಕಾನಾ
Arakku	ಅರಾಕು
Alfred	ಆಲ್‌ಫ್ರೆಡ್
Tennison	ಟೆನಿಸನ್
Dhanya	ಧನ್ಯಾ
Alayna	ಅಲೇನಾ
Ulla	ಉಲ್ಲಾ
Ulka	ಉಲ್ಕಾ
War	ವಾರ್
of	ಆಫ್
the	ದಿ
First	ಫರ್ಸ್ಟ
Coalition	ಕೋಯಲಿಶನ್
Khul	ಖುಲ್
Ja	ಜಾ
Sim	ಸಿಮ್
Sim	ಸಿಮ್
Richa	ರಿಚಾ
Kaumajet	ಕೌಮಾಜೆಟ್
Jeeva	ಜೀವಾ
Brian	ಬ್ರಿಯಾನ್
Bijuri	ಬಿಜುರೀ
Kishanganj	ಕಿಶನ್ ಗಂಜ್
Badshah	ಬಾದಶಾಹ್
Salamat	ಸಲಾಮತ್
Pope	ಪೋಪ್
Paul	ಪೌಲ್
Dakhineswar	ದಕ್ಷಿಣೇಶ್ವರ್
Radiology	ರೇಡಿಯಾಲಜಿ
Vandanamaalaa	ವಂದನಮಾಲಾ
Russell	ರಸೆಲ್
Krovi	ಕ್ರೋವಿ
Geoff	ಜೆಫ್
Howarth	ಹೋವರ್ತ್
Izz	ಇಜ್ಜ್
Krishna ji	ಕೃಷ್ಣಾಜಿ
Aru	ಅರು
Fort	ಫೋರ್ಟ್
point	ಪಾಯಿಂಟ್
Jeevan	ಜೀವನ್
Sathi	ಸಾಥಿ
Embourg	ಎಂಬರ್ಗ್
Furqan	ಫುರ್ಖಾನ್
Escorts	ಎಸ್‌ಕಾರ್ಟ್ಸ್
Arbon	ಅರ್ಬನ್
Munzir	ಮುಂಜಿರ್
Carl	ಕಾರ್ಲ್
Shagird	ಶಾಗಿರ್ದ್
Shendaye	ಶೆಂಡಯೆ
Chitrasen	ಚಿತ್ರಸೇನ್
Sanghi	ಸಾಂಘೀ
Wajih	ವಜೀಹ್
Hafizur	ಹಫಿಝುರ್
Rahman	ರಹಮಾನ್
Air	ಏರ್
Mail	ಮೇಲ್
Leuseur	ಲುಸೇರ್
Afasana	ಅಫಸಾನಾ
Jean	ಜೀನ್
Bart	ಬಾರ್ಟ್
Sharvari	ಶರ್ವತಿ
Avaneendra	ಅವನೀಂದ್ರ
Fabrizio	ಫೆಬ್ರಿಝಿಯೊ
Chandha	ಚಾಂಧಾ
Warren	ವಾರೆನ್
Bettie	ಬೆಟ್ಟೀ
Preyasi	ಪ್ರೇಯಸಿ
Keagan	ಕೀಗಾನ್
Malvarkar	ಮಾಲ್ವರ್ಕರ್
Shatayu	ಶತಾಯು
Barlai	ಬರ್ಲಾ
Hopman	ಹಾಪ್‌ಮ್ಯಾನ್
Cup	ಕಪ್
Oscar	ಆಸ್ಕರ್
Raitah	ರೈತಾ
Raajiv	ರಾಜಿವ್
Satyadev	ಸತ್ಯದೇವ
Laraine	ಲಾರೈನೆ
Kaun	ಕೌನ್
Kitney	ಕಿತನೆ
Pani	ಪಾನೆ
Mein	ಮೆ
Chodiala	ಚೋಡಿಯಾಲಾ
Nawab	ನವಾಬ್
Sirazuddaula	ಸಿರಾಜುದ್‌ದೌಲಾ
Sasti	ಸಸ್ತೀ
Dulhan	ದುಲ್ಹನ್
Mahenga	ಮಹೆಂಗಾ
Doolha	ದುಲ್ಹಾ
Sirius	ಸಿರಿಯಸ್
Alakh	ಅಲಖ್
Niranjan	ನಿರಂಜನ್
Ek	ಏಕ್
Se	ಸೇ
Bhale	ಭಲೆ
Do	ದೋ
Donakonda	ದೊನಕೊಂಡ
Rasika	ರಸಿಕಾ
Bratindra	ಬ್ರತಿಂದ್ರ
Birur	ಬಿರೂರ್
Junction	ಜಂಕ್ಷನ್
Janam	ಜನಮ್
Janam	ಜನಮ್
Corsica	ಕಾರ್ಸಿಕಾ
Century	ಸೆಂಚುರಿ
sangbad	ಸಂಗಬಾದ್
Yudhisthir	ಯುಧಿಷ್ಟರ್
Melva	ಮೆಲ್ವಾ
Amareshwar	ಅಮರೇಶ್ವರ
Shiva	ಶಿವ
Bhutesh	ಭೂತೇಶ್
Louanna	ಲುವಾನ್ನಾ
Gunahon	ಗುನಾಹೋ
Ka	ಕಾ
Devta	ದೇವತಾ
Yuvati	ಯುವತಿ
Bilaspur	ಬಿಲಾಸ್‌ಪುರ್
Junction	ಜಂಕ್ಷನ್
Ashok	ಅಶೋಕ್
Patel	ಪಟೇಲ್
Clea	ಕ್ಲೀ
Coca-Cola	ಕೋಕಾ-ಕೋಲಾ
India	ಇಂಡಿಯಾ
Wafiq	ವಫೀಕ್
Nirvan	ನಿರ್ವಾಣ್
Drummond	ಡ್ರಮ್ಮಂಡ್
Khidr	ಖಿದ್ರ
Meriel	ಮೆರಿಯಲ್
Harindar	ಹರೀಂದರ್
Central	ಸೆಂಟ್ರಲ್
Oahu	ಓಹು
Bible	ಬೈಬಲ್
Shandaar	ಶಾನ್ದಾರ್
Lala	ಲಾಲಾ
Olympia	ಒಲಿಂಪಿಯಾ
Tapani	ತಪನಿ
Parth	ಪಾರ್ಥ್
Dixit	ದೀಕ್ಷಿತ್
Matrix	ಮ್ಯಾಟ್ರಿಕ್ಸ್
Lab	ಲ್ಯಾಬ್
Marged	ಮಾರ್ಗಡ್
Jim	ಜಿಮ್
Troughton	ಟ್ರಾಟನ್
Twyla	ಟ್ವೈಲಾ
Gayatri	ಗಾಯತ್ರಿ
Clermont	ಕ್ಲೆಮಂಟ್
Robyn	ರಾಬಿನ್
Venice	ವೆನಿಸ್
Marco	ಮಾರ್ಕೋ
Polo	ಪೋಲೋ
Shane	ಶೇನ್
Warne	ವಾರ್ನ್
Masood	ಮಸೂದ್
Walker	ವಾಕರ್
Museum	ಮ್ಯೂಸಿಯಂ
VocalTec	ವೋಕಲ್‌ಟೆಕ್
Communications	ಕಮ್ಯೂನಿಕೇಶನ್ಸ್
Fattah	ಫತ್ತಾ
Berkelium	ಬೆರ್ಕೇಲಿಯಂ
Royal	ರಾಯಲ್
Ontario	ಆಂಟಾರಿಯಾ
Museum	ಮ್ಯೂಸಿಯಂ
Bogota	ಬೊಗೊಟಾ
Raichur	ರಾಯಚೂರ್
Telma	ತೆಲ್ಮಿ
Aaj	ಆಜ್
Ke	ಕೆ
Shahanshah	ಶಹಂಶಾಹ್
Patty	ಪ್ಯಾಟಿ
Katyayani	ಕಾತ್ಯಾಯನಿ
Colton	ಕೋಲ್ಟನ್
Rachelle	ರಶೇಲ್
Shamshad	ಶಮ್ಶದ್
George	ಜಾರ್ಜ್
Carlin	ಕಾರ್ಲಿನ್
Fresno	ಫ್ರೆಸ್ನೋ
Art	ಆರ್ಟ್
Museum	ಮ್ಯೂಸಿಯಂ
Khooni	ಖೂನ್
Kaun	ಕೌನ್
Matlabi	ಮತಲಬೀ
Pritilata	ಪ್ರೀತಿಲತಾ
Amalia	ಅಮಾಲಿಯಾ
Baba	ಬಾಬಾ
Rexheb	ರೆಕ್ಸೆಬ್
Christopher	ಕ್ರಿಸ್ಟೋಫರ್
Marlowe	ಮಾರ್ಲೋವೆ
Trinity	ಟ್ರಿನಿಟಿ
Lutheran	ತುತೆರಾನ್
Coca	ಕೋಕಾ
Cola	ಕೋಲಾ
Enterprises	ಎಂಟರ್‌ಪ್ರೈಸ್
Vijay	ವಿಜಯ್
Yadav	ಯಾದವ್
Gurla	ಗುರ್ಲಾ
Sainath	ಸಾಯಿನಾಥ್
Tushaar	ತುಷಾರ್
Hemantha	ಹೇಮಂತ
Wickramaratne	ವಿಕ್ರಮರತ್ನೆ
Ek	ಏಕ್
Shola	ಶೋಲಾ
Medhaavinee	ಮೇಧಾವಿನೀ
Kali	ಕಾಲಿ
Raat	ರಾತ್
World	ವರ್ಲ್ಡ್
Association	ಅಸೋಸಿಯೇಶನ್
of	ಆಫ್
Newspapers's	ನ್ಯೂಸ್
Golden	ಪೇಪರ್ಸ್
Pen	ಗೋಲ್ಡನ್
of	ಪೆನ್
Freedom	ಆಫ್
Award	ಫ್ರೀಡಂ
Medhekar	ಮೆಢೆಕರ್
Betelsmann	ಬೀಟೆಲ್ಸ್ ಮನ್
Immanuel	ಇಮ್ಯಾನುಯೆಲ್
Baptist	ಬ್ಯಾಪ್ಟಿಸ್ಟ್
Raajakunvaree	ರಾಜಕುನ್ವರೀ
Calum	ಕಾಲಂ
Aoife	ಆಯ್ಫಿ
Ek	ಏಕ್
Jhalak	ಝಲಕ್
Milun	ಮಿಲುನ್
Cara	ಕಾರಾ
Earl	ಅರ್ಲ್
Manasvee	ಮನಸ್ವೀ
Sanjushree	ಸಂಜುಶ್ರೀ
Aakhri	ಆಖಿರಿ
Nishchay	ನಿಶ್ಚಯ್
Caja	ಕಾಜಾ
Saarth	ಸಾರ್ಥ್
Ashok	ಅಶೋಕ್
Malhotra	ಮಲ್ಹೋತ್ರಾ
Arth	ಅರ್ಥ್
Shaili	ಶೈಲಿ
Baqa	ಬಕ
Mangu	ಮಂಗು
Dada	ದಾದಾ
Arch	ಆರ್ಚ್
Okanogan	ಒಕಾನೊಗಾನ್
Baha	ಬಹಾ
Bala	ಬಾಲ
Larry	ಲ್ಯಾರಿ
King	ಕಿಂಗ್
Pawana	ಪವಾನಾ
Gulnar	ಗುಲ್‌ನಾರ್
Manchali	ಮಂಚಾಲೀ
Insaniyat	ಇನ್ಸಾನಿಯತ್
Ke	ಕೆ
Dushman	ದುಶ್ಮನ್
Bruce	ಬ್ರೂಸ್
Taylor	ಟೇಲರ್
Pyase	ಪ್ಯಾಸಿ
Nain	ನೈನ್
Orckit	ಆರ್ಕಿಟ್
Communications	ಕಮ್ಯೂನಿಕೇಶನ್ಸ್
Medzhybizh	ಮೆಡ್ಜ್‌ಬಿಜ್
Dectron	ಡೆಕ್ಟ್ರಾನ್
International	ಇಂಟರ್ನ್ಯಾಷನಲ್
Krataaraam	ಕ್ರಾತಾರಾಮ್
Diya	ದಿಯಾ
Ajir	ಅಜಿರ್
asom	ಅಸೋಮ್
Amelia	ಅಮೇಲಿಯಾ
Richard	ರಿಚರ್ಡ್
Ramirez	ರಮೀರೆಜ್
Disa	ದಿಸಾ
Haashim	ಹಾಶಿಮ್
Mala	ಮಾಲಾ
Quetzal	ಕ್ವೆಜಾಲ್
Maha	ಮಹಾ
Actress	ಆಕ್ಟ್ರೆಸ್
Analiese	ಅನಲೀಸ್
Snaith	ಸ್ನೈಥ್
David	ಡೇವಿಡ್
Tikolo	ಟಿಕೊಲೊ
Shauna	ಶಾನಾ
Ahmed	ಅಹಮದ್
Yesevi	ಯೆಸೆವಿ
Robinson	ರಾಬಿನ್ಸನ್
Christian	ಕ್ರಿಶ್ಚಿಯನ್
Kitty	ಕಿಟಿ
Hawk	ಹಾಕ್
Charl	ಚಾರ್ಲ್
Willoughby	ವಿಲೋಬಿ
Dada	ದಾದಾ
Fort	ಫೋರ್ಟ್
foster	ಫಾಸ್ಟರ್
Alimaa	ಅಲಿಮಾ
Shenzhen	ಶೆಂಜೆನ್
Special	ಸ್ಪೆಶಲ್
Zone	ಝೋನ್
Daily	ಡೈಲಿ
Tower	ಟವರ್
Bert	ಬರ್ಟ್
Vance	ವಾನ್ಸ್
Pallav	ಪಲ್ಲವ್
Sampoorna	ಸಂಪೂರ್ಣ
Raana	ರಾನಾ
Prem	ಪ್ರೇಮ್
Ki	ಕಿ
Jyoti	ಜ್ಯೋತಿ
Liam	ಲಿಯಾಮ್
Plunkett	ಪ್ಲಂಕೆಟ್
Chloe	ಕ್ಲೋ
Gala	ಗಾಲಾ
Reen	ರೀನ್
Angaar	ಅಂಗಾರ್
Grace	ಗ್ರೇಸ್
Lutheran	ತುಥೆರನ್
Mangalagiri	ಮಂಗಳಗಿರಿ
Kapde	ಕಾಪಡೆ
Bushnell's	ಬುಶನೆಲ್ಸ್
Museum	ಮ್ಯೂಸಿಯಂ
Philpot	ಫಿಲ್‌ಪಾಟ್
Saugaat	ಸೌಗಾತ್
Ladke	ಲಡಕೆ
Baap	ಬಾಪ್
Se	ಸೆ
Badh	ಬಢ್
Ke	ಕೆ
University	ಯುನಿವರ್ಸಿಟಿ
of	ಆಫ್
Alabama	ಅಲಬಾಮಾ
Babagon	ಬಾಬಾಗೋನ್
Dam	ಡ್ಯಾಮ್
Abdul	ಅಬ್ದುಲ್
basir	ಬಸೀರ್
Mindo	ಮಿಂದೋ
Tsavo	ಸಾವೋ
East	ಈಸ್ಟ್
Black	ಬ್ಲ್ಯಾಕ್
Mailer	ಮೆಲರ್
Farmaish	ಫರ್ಮಾಯಿಶ್
Chaman	ಚಮನ್
Rei	ರೀ
Agro	ಆಗ್ರೋ
Aztec	ಅಜ್ಟೆಕ್
Software	ಸಾಫ್ಟ್‌ವೇರ್
Baghdad	ಬಗ್ದಾದ್
Ka	ಕಾ
Jadu	ಜಾದೂ
Samta	ಸಮತಾ
University	ಯುನಿವರ್ಸಿಟಿ
of	ಆಫ್
Saint	ಸೈಂಟ್
Andrews	ಆಂಡ್ರ್ಯೂಸ್
Sawatch	ಸವಾಚ್
Buzdil	ಬುಜದಿಲ್
Shakuhachi	ಶಾಕುಹಚಿ
Richmond	ರಿಚ್ಮಂಡ್
Niteesh	ನಿತೀಶ್
Chunauti	ಚುನೌತಿ
Queens	ಕ್ವೀನ್ಸ್
County	ಕಂಟ್ರಿ
Farm	ಫಾರ್ಮ್
Museum	ಮ್ಯೂಸಿಯಂ
Wein	ವೀನ್
Marvell	ಮಾರ್ವೆಲ್
Technology	ಟೆಕ್ನಾಲಜಿ
Group	ಗ್ರೂಪ್
Apollo	ಅಪೋಲೋ
Consolidated	ಕನ್ಸಾಲಿಡೇಟೆಡ್
Water	ವಾಟರ್
Bolarum	ಬೊಲಾರಮ್
University	ಯುನಿವರ್ಸಿಟಿ
of	ಆಫ್
Alaska	ಅಲಸ್ಕಾ
Ian	ಇಯಾನ್
Austin	ಆಸ್ಟಿನ್
Beqasoor	ಬೆಖಸೂರ್
Baba	ಬಾಬಾ
Tajuddin	ತಜುದ್ದೀನ್
Hum	ಹಮ್
Panch	ಪಾಂಚ್
Nagavahan	ನಗವಾಹನ್
Danone	ಡೆನೊನೆ
International	ಇಂಟರ್‌ನ್ಯಾಶನಲ್
Prize	ಪ್ರೈಜ್
for	ಫಾರ್
Nutrition	ನ್ಯೂಟ್ರೀಶನ್
Lewis	ಲಿವಿಸ್
Ignosh	ಇಗ್ನೋಶ್
Abdul	ಅಬ್ದುಲ್
kabeer	ಕಬೀರ್
Kohli	ಕೊಹಲಿ
Dodda	ದೊಡ್ಡ
Ganesh	ಗಣೇಶ್
Shah	ಶಾಹ್
E	ಎ
Misar	ಮಿಸಾರ್
Princess	ಪ್ರಿನ್ಸೆಸ್
Alice	ಆಲೀಸ್
Night	ನೈಟ್
In	ಇನ್
Calcutta	ಕಲಕತ್ತಾ
Dev	ದೇವ್
gaayak	ಗಾಯಕ್
Vishvag	ವಿಶ್ವಗ್
Vern	ವರ್ನ
Adwaakee	ಅದ್ವಾಕೀ
Trikaya	ತ್ರಿಕಾಯ
Katha	ಕಥಾ
Curtly	ಕರ್ಟ್ಲಿ
Ambrose	ಅಂಬ್ರೋಸ್
Samata	ಸಮತಾ
Aagale	ಆಗಲೇ
Angaara	ಅಂಗಾರಾ
Kuchh	ಕುಛ್
Naya	ನಯಾ
Marchovelette	ಮಾರ್ಕೋವೆಲೆಟ್
Himmat	ಹಿಮ್ಮತ್
Gopalpur	ಗೋಪಾಲಪುರ್
Gustav	ಗುಸ್ತಾವ್
Fort	ಫೋರ್ಟ್
george	ಜಾರ್ಜ್
Anil	ಅನಿಲ್
Dalpat	ದಲಪತ್
Adishvar	ಆದೀಶ್ವರ್
Muthumudalige	ಮುತ್ತುಮುದಲಿಗೆ
Pushpakumara	ಪುಷ್ಪಕುಮಾರ
Qanit	ಕಾನಿತ್
Maa	ಮಾ
Ka	ಕಾ
Pyar	ಪ್ಯಾರ್
Balkan	ಬಾಲ್ಕನ್
Mahashweta	ಮಹಾಸ್ವೇತಾ
Devi	ದೇವಿ
Dhadvaiwale	ಧಾಡ್ವೈವಾಲೆ
Kirkan	ಕಿರ್ಕನ್
Fort	ಫೋರ್ಟ್
marlborough	ಮಾಲ್ಬರ್ಗೊ
Floyd	ಫ್ಲಾಯ್ಡ್
Reifer	ರೀಫರ್
Reetaa	ರೀತಾ
Oxford	ಆಕ್ಸ್‌ಫರ್ಡ್
Ana	ಅನಾ
Mawiyah	ಮಾವಿಯಾ
Minas	ಮಿನಾಸ್
Gerais	ಗೆರಾಯ್ಸ್
Thana	ಥಾನಾ
Bhupinderpal	ಭೂಪಿಂದರ್‌ಪಾಲ್
Gertrude	ಗರ್ಟರೂಡ್
University	ಯುನಿವರ್ಸಿಟಿ
of	ಆಫ್
California	ಕ್ಯಾಲಿಫೋರ್ನಿಯಾ
Dobro	ಡೋಬ್ರೊ
Rocky	ರಾಕಿ
Mount	ಮೌಂಟ್
Kartikeya	ಕಾರ್ತಿಕೇಯ
National	ನ್ಯಾಶನಲ್
Museum	ಮ್ಯೂಸಿಯಂ
of	ಆಫ್
China	ಚೈನಾ
Sarra	ಸರಾ
Akash	ಆಕಾಶ್
Pari	ಪರಿ
Fateh	ಫತೆಹ್
Singhpura	ಸಿಂಗಪುರ
Kantele	ಕಂಟೆಲೆ
Vattamalaikarai	ವಟ್ಟಮಲೈಕರೈ
Odai	ಒಡೈ
Reservoir	ರಿಜರ್ವಾಯರ್
Kashi	ಕಾಶಿ
Newstime	ನ್ಯೂಸ್‌ಟೈಮ್
Aasimah	ಆಸಿಮಾ
Balawala	ಬಲಾವಾಲಾ
Jabalah	ಜಬಾಲೆಹ್
Jenn	ಜೆನ್
Hukumachan_d	ಹುಕುಂಚಂದ್
Kyria	ಕಿರಿಯಾ
Kuber	ಕುಬೇರ
Kennings	ಕೆನಿಂಗ್ಸ್
Plover	ಪ್ಲೋವರ್
Cove	ಕೋವ್
Reservoir	ರಿಜರ್ವಾಯರ್
Ashok	ಅಶೋಕ್
Mankad	ಮಂಕಡ್
Pemex	ಪೆಮೆಕ್ಸ್
Barton	ಬಾರ್ಟನ್
Mimis	ಮಿಮಿಸ್
ILOG	ಐಲಾಗ್
ILOG	ಐಲಾಗ್
Yomiuri	ಯೊಮಿಯುರಿ
Prize	ಪ್ರೈಜ್
for	ಫಾರ್
Literature	ಲಿಟರೇಚರ್
Jhumroo	ಝುಮರು
Raja	ರಾಜಾ
Radhika	ರಾಧಿಕಾ
Prasad	ಪ್ರಸಾದ್
Susanna	ಸುಸನ್ನಾ
Anjaan	ಅಂಜಾನ್
Rahen	ರಾಹೇ
Girish	ಗಿರೀಶ್
Sugandh	ಸುಗಂಧ್
Spyridon	ಸ್ಪೈರಿಡನ್
Mahananda	ಮಹಾನಂದ್
Great	ಗ್ರೇಟ್
Britain	ಬ್ರಿಟನ್
Bel	ಬೆಲ್
AIr	ಅಲ್ರ್
United	ಯುನೈಟೆಡ್
Methodist	ಮೆಥಡಿಸ್ಟ್
Bhajaraam	ಭಜರಾಮ್
Fritzi	ಫ್ರಿಟ್ಸಿ
Sri	ಶ್ರೀ
Ramkrishna	ರಾಮಕೃಷ್ಣಾ
Vidyashala	ವಿದ್ಯಾಶಾಲಾ
Ethan	ಎಥನ್
Allen	ಅಲ್ಲೆನ್
Homestead	ಹೋಮ್‌ಸ್ಟೆಡ್
Museum	ಮ್ಯೂಸಿಯಂ
Sarbani	ಸರ್ಬಾನಿ
Banphool	ಬನಪೂಲ್
Aahlad	ಆಹ್ಲಾದ್
Velankar	ವೇಲಣಕರ್
Auzaar	ಔಜಾರ್
Hammaam	ಹಮ್ಮಾಮ್
Sanyo	ಸಾನ್ಯೋ
Electric	ಎಲೆಕ್ಟ್ರಿಕ್
Bhai	ಭಾಯಿ
Bahen	ಬೆಹನ್
Allen	ಅಲೆನ್
Ginsberg	ಗಿನ್ಸ್‌ಬರ್ಗ್
Neon	ನಿಯಾನ್
Teams	ಟೀಮ್ಸ್
Roop	ರೂಪ್
Kahani	ಕಹಾನಿ
Agra	ಆಗ್ರಾ
fort	ಫೋರ್ಟ್
Mihir	ಮಿಹಿರ್
Cricket	ಕ್ರಿಕೆಟ್
World	ವರ್ಲ್ಡ್
Cup	ಕಪ್
Modern	ಮಾಡರ್ನ್
Girl	ಗರ್ಲ್
Gazala	ಗಜಲಾ
Arumugan	ಆರುಮುಗನ್
Loyola	ಲೊಯೊಲಾ
University	ಯುನಿವರ್ಸಿಟಿ
Chicago	ಚಿಕಾಗೊ
Mandsaur	ಮಾಂಡ್ಸಾರ್
Shaun	ಶೌನ್
Liverpool	ಲಿವರ್‌ಪೂಲ್
John	ಜಾನ್
Moores	ಮೂರ್ಸ್
University	ಯುನಿವರ್ಸಿಟಿ
Amar	ಅಮರ್
ujala	ಉಜಾಲಾ
Vishakhadutt	ವಿಶಾಖದತ್
Vanburn	ವೇನ್ಬರ್ನ್
Holder	ಹೋಲ್ಡರ್
Aamne	ಆಮ್ಮೆ
Samne	ಸಾಮ್ನೆ
Lei	ಲೈ
yue	ಯು
mun	ಮುನ್
fort	ಫೋರ್ಟ್
Stapleton	ಸ್ಟಾಪ್ಲೆಟನ್
Bhadraksh	ಭದ್ರಾಕ್ಷ
Baramua	ಬಾರಾಮುವಾ
Aakhri	ಆಖಿರ್
Chetawani	ಚೆತಾವನೀ
South	ಸೌತ್
Gate	ಗೇಟ್
United	ಯುನೈಟೆಡ್
Methodist	ಮೆಥೋಡಿಸ್ಟ್
Chamundeswari	ಚಾಮುಂಡೇಶ್ವರಿ
Queen	ಕ್ವೀನ್
Anne's	ಆನ್ಸ್
War	ವಾರ್
Ajmer	ಆಜ್ಮೆರ್
Junction	ಜಂಕ್ಷನ್
Dahanu	ದಹಾನು
Road	ರೋಡ್
Brahmadutt	ಬ್ರಹ್ಮದತ್
Leala	ಲೀಲಾ
Kavli	ಕಾವ್ಲಿ
Prize	ಪ್ರೈಸ್
Ian	ಇಯಾನ್
Gould	ಗೋಲ್ಡ್
Naach	ನಾಚ್
Utha	ಉಠಾ
Sansar	ಸನ್ಸಾರ್
Shatranj	ಶತರಂಜ್
Kumar	ಕುಮಾರ
Sangakkara	ಸಂಗಕ್ಕರ
Clodia	ಕ್ಲಾಡಿಯಾ
Count	ಕೌಂಟ್
Dracula	ಡ್ರಾಕುಲಾ
Seetaasaran	ಸೀತಾಶರಣ್
Chakori	ಚಕೋರಿ
Khatri	ಖತ್ರಿ
Prajit	ಪ್ರಜಿತ್
Naoki	ನಾಯ್ಕಿ
Prize	ಪ್ರೈಜ್
Finland	ಫಿನ್ಲೆಂಡ್
Insaan	ಇನ್ಸಾನ್
Aur	ಔರ್
Shaitan	ಶೈತಾನ್
Balauda	ಬಲೌಡಾ
Takun	ತಕುನ್
Nocil	ನಾಸಿಲ್
Sandra	ಸಾಂಡ್ರಾ
Delta	ಡೆಲ್ಟಾ
Modern	ಮಾಡ್ರನ್
Senior	ಸೀನಿಯರ್
Secondary	ಸೆಕೆಂಡರಿ
School,	ಸ್ಕೂಲ್,
Patiala	ಪಾಟಿಯಾಲಾ
Dhaanesh	ಧಾನೇಶ್
Baghpat	ಬಾಗ್ಪತ್
Ram	ರಾಮ್
Avtar	ಅವತಾರ್
Wratten	ರಾಟನ್
Fort	ಫೋರ್ಟ್
trumbull	ಟ್ರುಂಬಲ್
Arivumadhi	ಅರಿವುಮಧಿ
Fineen	ಫಿನೀನ್
Saarangadhar	ಸಾರಂಗಧರ
Boogie	ಬೂಗಿ
woogie	ವೂಗಿ
Chor	ಚೋರ್
Ke	ಕೆ
Ghar	ಘರ್
Chorni	ಚೋರನಿ
Buddy	ಬಡ್ಡೀ
Holly	ಹಾಲಿ
Wahidul	ವಹಿದುಲ್
Gani	ಗನಿ
Viklaant	ವಿಕ್ಲಾಂತ್
Dainik	ದೈನಿಕ್
purvoday	ಪೂರ್ವೋದಯ್
Amrapali	ಅಮ್ರಪಾಲಿ
Kostas	ಕೋಸ್ತಾಸ್
Frontzos	ಫ್ರಂಟ್‌ಜೋಸ್
Museum	ಮ್ಯೂಸಿಯಂ
of	ಆಫ್
Epirus'	ಎಪೀರಸ್
Folk	ಫೋಕ್
Art	ಆರ್ಟ್
Chandi	ಚಾಂದೀ
Ki	ಕಿ
Deewar	ದೀವಾರ್
Lorena	ಲೊರೆನಾ
Gul	ಗುಲ್
Sanobar	ಸನೋಬರ್
Kushinagar	ಕಾಶಿನಗರ್
Zameen	ಜಮೀನ್
Aasman	ಆಸಮಾನ್
Orson	ಓರ್ಸಾನ್
Wales	ವೇಲ್ಸ್
Maharani	ಮಹಾರಾಣಿ
Jhansi	ಝಾನ್ಸಿ
Sitapur	ಸೀತಾಪುರ್
Cordoba	ಕೊರ್ಡೋಬಾ
Safwah	ಸಫ್ವಾ
Kajjali	ಕಜ್ಜಾಲಿ
Dean	ಡೀನ್
Steinfeld	ಸ್ಟೆನ್‌ಫೀಲ್ಡ್
Cup	ಕಪ್
Prince	ಪ್ರಿನ್ಸ್
Edward	ಎಡ್ವರ್ಡ್
Mahaganapati	ಮಹಾಗಣಪತಿ
Carla	ಕಾರ್ಲಾ
Badhti	ಬಟ್ಟಿ
Ka	ಕಾ
Naam	ನಾಮ್
Dadhi	ದಾಢಿ
Oldonyo	ಆಲ್ಡೋನ್ಯೋ
Sapuk	ಸಪುಕ್
Wacoal	ವಾಕೋವಲ್
Holdings	ಹೋಲ್ಡಿಂಗ್ಸ್
Corporation	ಕಾರ್ಪೊರೇಶನ್
Harry	ಹ್ಯಾರಿ
Potter	ಪಾಟರ್
Captain	ಕ್ಯಾಪ್ಟನ್
Sheroo	ಶೆರೂ
Weymouth	ವೆಯ್‌ಮೌಥ್
Laakshaa	ಲಕ್ಷಾ
Gyara	ಗ್ಯಾರಾ
Hazar	ಹಜಾರ್
Ladkiyan	ಲಡಕಿಯಾ
Tribhwan	ತ್ರಿಭವಣ್
Mariel	ಮ್ಯಾರೀಲ್
Millennium	ಮಿಲೇನಿಯಮ್
Technology	ಟೆಕ್ನಾಲಜಿ
Prize	ಪ್ರೈಜ್
Imran	ಇಮ್ರಾನ್
Nazir	ನಜೀರ್
Raamalaal	ರಾಮಲಾಲ್
Sun	ಸನ್
Microsystems	ಮೈಕ್ರೋಸಿಸ್ಟಮ್ಸ್
Kausar	ಕೌಸರ್
Kalka	ಕಾಲ್ಕಾ
Doust	ಡೌಸ್ಟ್
Mahbub	ಮಹಬೂಬ್
Kavi	ಕವಿ
Sammelan	ಸಮ್ಮೇಲನ್
Mahanadi	ಮಹಾನದಿ
Wilma	ವಿಲ್ಮಾ
Azhar	ಅಜರ್
Sadyojat	ಸದ್ಯೋಜಾತ
Cabo	ಕ್ಯಾಬೊ
Orange	ಆರೆಂಜ್
Canberra	ಕ್ಯಾನ್ ಬೆರಾ
Ambassador	ಅಂಬಾಸಿಡರ್
Zoraster	ಜೋರಾಸ್ಟರ್
Begusarai	ಬೆಗುಸರಾಯ್
Leatrix	ಲಿಯಾಟ್ರಿಕ್ಸ್
Barun	ಬರುನ್
Gandharin	ಗಾಂಧಾರಿನ್
Robert	ರಾಬರ್ಟ್
Atkins	ಅಟ್ಕಿನ್ಸ್
Deergharaagaa	ದೀರ್ಘರಾಗಾ
King	ಕಿಂಗ್
Charlemagne	ಚಾರ್ಲ್‌ಮೆಯ್ನ್
Canoe	ಕೆನೋ
Lagardère	ಲಾಗಾರ್ಡೀರ್
Groupe	ಗ್ರೂಪಿ
Milonga	ಮಿಲೊಂಗಾ
Maikhana	ಮೈಖಾನಾ
Sab	ಸಬ್
Ka	ಕಾ
Ustad	ಉಸ್ತಾದ್
Garwah	ಗರ್ವಾ
Meri	ಮೇರಿ
Biwi	ಬೀವಿ
Ki	ಕೀ
Shaadi	ಶಾದಿ
Fort	ಫೋರ್ಟ್
aan	ಆನ್
de	ಡಿ
biltstraat	ಬಿಲ್‌ಸ್ಟ್ರಾಟ್
Abou	ಅಬು
Ben	ಬೆನ್
Adhem	ಅಧೇಮ್
Vafia	ವಾಫಿಯಾ
Descartes	ಡೆಸ್ಕಾರ್ಟಿಸ್
Systems	ಸಿಸ್ಟಮ್ಸ್
Group	ಗ್ರೂಪ್
Forster	ಫಾರ್ಸ್ಟರ್
Vishala	ವಿಶಾಲಾ
Achalesvar	ಅಚಲೇಶ್ವರ್
Linore	ಲಿನೋರ್
Ijaz	ಇಜಾಜ್
Faqih	ಫಕೀ
Leila	ಲೀಲಾ
Chitadhan	ಚಿತ್‌ಧನ್
Chawa	ಚಾವಾ
Dhanashri	ಧನಶ್ರೀ
Goodrum	ಗೂಡ್ರಮ್
Baptist	ಬ್ಯಾಪ್ಟಿಸ್ಟ್
Wolfgang	ವೋಲ್ಫಾಂಗ್
Ajeeb	ಅಜೀಬ್
Ladki	ಲಡಕಿ
Metal	ಮೆಟಲ್
Storm	ಸ್ಟಾರ್ಮ್
Limited	ಲಿಮಿಟೆಡ್
Fayre	ಫೇಯರ್
Paraguay	ಪರಾಗ್ವೆ
Craig	ಕ್ರೆಗ್
Wishart	ವಿಶಾರ್ಟ್
Ticonderoga	ಟಿಕೊಂಡೆರೊಗಾ
Lahu	ಲಾಹೂ
Pukarega	ಪುಕಾರೇಗಾ
Johannesburg	ಜೋಹಾನ್ಸ್ ಬರ್ಗ್
Raja	ರಾಜಾ
Kaka	ಕಾಕಾ
Fort	ಫೋರ್ಟ್
popham	ಪೋಪಹಮ್
Powerful	ಪವರ್‌ಫುಲ್
Praj	ಪ್ರಜ್
Industries	ಇಂಡಸ್ಟ್ರೀಸ್
Bholaanaath	ಭೋಲಾನಾಥ್
Tridev	ತ್ರಿದೇವ್
Piya	ಪಿಯಾ
Ghar	ಕಾ
Aja	ಘರ್
Lakshmi	ಲಕ್ಷ್ಮೀ
Khimsar	ಕ್ಹಿಮ್‌ಸಾರ್
Sabiqah	ಸಬೀಕಾ
Antimony	ಆಂಟಿಮೊನಿ
Taconic	ಟ್ಯಾಕೊನಿಕ್
Rajalakshmi	ರಾಜಲಕ್ಷ್ಮಿ
Pitsberg	ಪಿಟ್ಸ್‌ಬರ್ಗ್
Jeena	ಜೀನಾ
Hai	ಹೈ
Pyar	ಪ್ಯಾರ್
Mein	ಮೆ
Paul	ಪೌಲ್
Simon	ಸೈಮನ್
Dixmude	ಡಿಕ್ಸ್‌ಮುಡೆ
Keitha	ಕೀಥಾ
John	ಜಾನ್
Traicos	ಟ್ರೈಕೋಸ್
Adonis	ಅಡೋನಿಸ್
Charlize	ಚಾರ್ಲೀಜ್
Fort	ಫೋರ್ಟ್
gaines	ಗೈನ್ಸ್
Clarimonde	ಕ್ಲಾರಿಮೊಂಡಿ
John	ಜಾನ್
Rennie	ರೆನ್ನೀ
Badaruddeen	ಬದ್ರುದ್ದೀನ್
Denesh	ದೇನೆಶ್
Ramdin	ರಾಮ್ದಿನ್
Jeevan	ಜೀವನ್
Yatra	ಯಾತ್ರಾ
Evers	ಇವರ್ಸ್
Bobby	ಬಾಬೀ
Devavarya	ದೇವವರ್ಯ
Regina	ರೆಜಿನಾ
Maria	ಮಾರಿಯಾ
Pia	ಪೀ
Schopenhauer	ಶೋಪೆನ್‌ಹೋವರ್
Peter	ಪೀಟರ್
Al	ಅಲ್
Pacino	ಪಸಿನೋ
Conte	ಕಾಂಟಿ
di	ಡಿ
Cavour	ಕ್ಯಾವೋರ್
Ringo	ರಿಂಗೋ
Star	ಸ್ಟಾರ್
Baghban	ಬಾಗಬಾಂ
Gursimrah	ಗುರುಸಿಮರಾಹ್
Devasthali	ದೇವಸ್ಥಳಿ
Lisette	ಲಿಸೆಟ್
Bheem	ಭೀಮ್
John Long	ಜಾನ್‌ಲಾಂಗ್
Dutchess	ಡಚೆಸ್
Gayatri	ಗಾಯತ್ರೀ
Mahima	ಮಹಿಮಾ
Govilkar	ಗೋವಿಲ್ಕರ್
Fleur	ಫ್ಲ್ಯೂರ್
Turley	ಟರ್ಲೆ
Manzilen	ಮನ್ಜಿಲೇ
Aur	ಔರ್
Bhi	ಭೀ
Hain	ಹೈ
Dakshayani	ದಾಕ್ಷಾಯನಿ
Safeenah	ಸಫೀನಾ
Albion	ಅಲ್ಬಿಯನ್
Abundant	ಅಬಂಡಂಟ್
Life	ಲೈಫ್
Christian	ಕ್ರಿಶ್ಚಿಯನ್
Fellowship	ಫೆಲೊಶಿಪ್
Sonipat	ಸೋನಿಪತ್
Satara	ಸತಾರಾ
Talika	ತಲಿಕಾ
Malini	ಮಾಲಿನಿ
Jadu	ಜಾದೂ
Nagri	ನಗರೀ
Barabanki	ಬಾರಾಬಂಕಿ
Junction	ಜಂಕ್ಷನ್
Mashkoor	ಮಶಕೂರ್
Reporter	ರಿಪೋರ್ಟರ್
Raju	ರಾಜು
Samandaron	ಸಮಂದರೋ
Ki	ಕಿ
Malika	ಮಲಿಕಾ
Maadhav	ಮಾಧವ್
Fredrica	ಫ್ರೆಡ್ರಿಕಾ
Chinchpada	ಚಿಂಚಪಾಡಾ
Marigold	ಮ್ಯಾರಿಗೋಲ್ಡ್
Aafiya	ಆಫಿಯಾ
Ladki	ಲಡಕಿ
Jawan	ಜವಾನ್
Ho	ಹೋ
Gai	ಗಯಿ
Yangtze	ಯಾಂಗ್ಟೆ
ki	ಕಿ
yang	ಯಾಂಗ್
Almanij	ಅಲ್ಮನಿಜ್
Brian	ಬ್ರಿಯಾನ್
Close	ಕ್ಲೋಸ್
Sangram	ಸಂಗಮ್
Irrisistible	ಇರ್ರೆಸಿಸ್ಟಬಲ್
Gul	ಗುಲ್
Sanovar	ಸನೋವರ್
Gannon	ಗೆನನ್
Atyachar	ಅತ್ಯಾಚಾರ್
I^jeeniyar	ಇಂಜಿನಿಯರ್
Fort	ಫೋರ್ಟ್
bij	ಬಿಜ್
jutphaas	ಜುಟ್‌ಫಾಸ್
Jeevan	ಜೀವನ್
Rekha	ರೇಖಾ
Fort	ಫೋರ್ಟ್
spion	ಸ್ಪಿಯನ್
Iberdrola	ಈಬರ್ಡ್ರೋಲಾ
Vidler	ವಿಡ್ಲರ್
Amla	ಅಮ್ಲಾ
Junction	ಜಂಕ್ಷನ್
Lepanto	ಲೆಪಾಂಟೊ
Mulla	ಮುಲ್ಲಾ
Sadra	ಸದರಾ
Sarama	ಸರಮಾ
Fatwa	ಫತ್ವಾ
Adidas	ಆಡಿಡಾಸ್
Sarada	ಸಾರದಾ
Dai	ದಾಯ್
Nippon	ನಿಪ್ಪಾನ್
Printing	ಪ್ರಿಂಟಿಂಗ್
Supekar	ಸುಪೇಕರ್
Tina	ಟೀನಾ
Turner	ಟರ್ನರ್
Eyab	ಎಯಾಬ್
Gajadant	ಗಜದಂತ
Pravesh	ಪ್ರವೇಶ್
Renee	ರೀನೀ
Zellweger	ಜೆಲವೆಗರ್
Manjulika	ಮಂಜುಳಿಕಾ
Ek	ಏಕ್
Misaal	ಮಿಸಾಲ್
Babu	ಬಾಬು
Jayananda	ಜಯಾನಂದ
Warnaweera	ವರ್ಣವೀರ
Pantanal	ಪಂಟಾನಲ್
Matogrossense	ಮಟಾಗ್ರೋಸ್ಸೆನ್ಸಿ
Kshanika	ಕ್ಷಣಿಕ
Arundhatinaath	ಅರುಂಧತಿನಾಥ್
Morepen	ಮೊರೆಪೆನ್
Laboratories	ಲ್ಯಾಬೊರೇಟರೀಸ್
Chaunrah	ಚಾನರಾಹ್
Delphi	ಡೆಲ್ಫಿ
Mukarram	ಮುಕರ್ರಮ್
Attah	ಅಟ್ಟಾ
Canada	ಕೆನಡಾ
Livett	ಲಿವೆಟ್
John	ಜಾನ್
Keats	ಕೀಟ್ಸ್
Kyoto	ಕ್ಯೋಟೊ
Prize	ಪ್ರೈಜ್
Naag	ನಾಗ್
Devta	ದೇವತಾ
Manobhu	ಮನೋಭು
Feland	ಫೆಲ್ಯಾಂಡ್
Nivedita	ನಿವೇದಿತಾ
Dhodra	ಧೋದ್ರಾ
Mohar	ಮೊಹರ್
Bhavna	ಭಾವನಾ
Apoorva	ಅಪೂರ್ವ
Bhemswadi	ಭೀಮ್ಸ್‌ವಾಡಿ
Nishan-E-Jung	ನಿಶಾನ್-ಎ-ಜಂಗ್
Vanani	ವನನಿ
Laxmi	ಲಕ್ಷ್ಮಿ
Narayan	ನಾರಾಯಣ್
Titan	ಟೈಟಾನ್
Order	ಆರ್ಡರ್
of	ಆಫ್
the	ದ
Tower	ಟವರ್
and	ಆಂಡ್
Sword	ಸ್ವೋರ್ಡ್
King	ಕಿಂಗ್
Bhagat	ಭಗತ್
LeoNardo	ಲಿಯೋನಾರ್ಡೋ
Di	ಡೀ
Vinci	ವಿನ್ಸಿ
Diqrah	ಡಿಕ್ಕಾ
Srapanch	ಸರಪಂಚ್
Berlin	ಬರ್ಲಿನ್
Sajili	ಸಜಿಲಿ
Chander	ಚಂದರ್
Umer	ಉಮರ್
Akele	ಅಕೇಲೆ
Hum	ಹಮ್
Akele	ಅಕೇಲೆ
Tum	ತುಮ್
Chip	ಚಿಪ್
Ellison	ಎಲಿಸನ್
Ajnabi	ಅಜನಬಿ
Saaya	ಸಾಯಾ
Buddha	ಬುದ್ಧ
Malka	ಮಲ್ಕಾ
Mari	ಮಾರಿ
Aakhri	ಆಖಿರ್
Cheekh	ಚೀಖ್
Viyogee	ವಿಯೋಗಿ
Fort	ಫೋರ್ಟ್
bragg	ಬ್ರ್ಯಾಗ್
Ze'ev	ಝೇವ್
Prize	ಪ್ರೈಜ್
Kanishka	ಕನಿಷ್ಕ
Kinshuk	ಕಿನ್ಶುಕ್
Maharaja	ಮಹಾರಾಜಾ
Vikram	ವಿಕ್ರಮ್
Sau	ಸೌ
Saal	ಸಾಲ್
Baad	ಬಾದ್
Fillmore	ಫಿಲ್ಮೋರ್
Uranium	ಯುರೇನಿಯಂ
Dover	ಡೋವರ್
turret	ಟುರೆಟ್
fort	ಫೋರ್ಟ್
Ekadant	ಏಕದಂತ
Pomona	ಪೊಮೋನಾ
Peter	ಪೀಟರ್
Ueberroth	ಯೂಬರೋತ್
Abul	ಅಬುಲ್
Fazal	ಫಜಲ್
Gul	ಗುಲ್
Bahar	ಬಹಾರ್
Skirth	ಸ್ಕಿರ್ತ್
Meghanaad	ಮೇಘನಾದ
Kerri	ಕೆರಿ
Saffron	ಸೇಫ್ರನ್
Chandi	ಚಂಡೀ
Pooja	ಪೂಜಾ
Gopal	ಗೋಪಾಲ್
Sharma	ಶರ್ಮಾ
Utaybah	ಉತಯ್ಬಾ
Pardesi	ಪರದೇಸೀ
Pankhi	ಪಂಖೀ
Sant	ಸಂತ್
Kaitabhajit	ಕೈಟಭಜಿತ್
Bokha	ಬೋಖಾ
Monte	ಮಾಂಟಿ
Pascoal	ಪ್ಯಾಸ್ಕೋಲ್
Abhrakasin	ಅಭ್ರಕಾಸಿನ್
Naache	ನಾಚೆ
Nagin	ನಗಿನ್
Gali	ಗಲೀ
Gali	ಗಲೀ
Chaamd	ಚಾಂದ್
El	ಎಲ್
Potosi	ಪೊಟೋಸಿ
Raman	ರಮಣ್
Lamba	ಲಂಬಾ
Lance	ಲ್ಯಾನ್ಸ್
Klusener	ಕ್ಲೂಸ್ನರ್
Nahar	ನಹಾರ್
Spinning	ಸ್ಪಿನ್ನಿಂಗ್
Hajeeb	ಹಜೀಬ್
Babul	ಬಾಬುಲ್
Nimat	ನಿಮತ್
Gurudwara	ಗುರುದ್ವಾರ
Tarantaaran	ತಾರಣ್‌ತರಣ್
Sahib	ಸಾಹಿಬ್
Jimmy	ಜಿಮ್ಮಿ
Maher	ಮಹೆರ್
Chhabi	ಚಬ್ಬಿ
Baraigram	ಬಾರೈಗ್ರಾಮ್
Junction	ಜಂಕ್ಷನ್
Kan_haiyaalaal	ಕನೈಯಾಲಾಲ್
Jashn	ಜಶ್ನ್
Azad	ಆಜಾದ್
Desh	ದೇಶ್
Ke	ಕೆ
Ghulam	ಗುಲಾಮ್
Cerise	ಸೆರಿಸ್
Anokha	ಅನೋಖಾ
Pyar	ಪ್ಯಾರ್
Chakar	ಚಕರ್
Beijing	ಬೀಜಿಂಗ್
Bombay	ಬಾಂಬೆ
War	ವಾರ್
Yashogaan	ಯಾಶೋಗಾನ್
Baalagopal	ಬಾಲಗೋಪಾಲ್
Dil	ದಿಲ್
Aur	ಔರ್
Deewar	ದೀವಾರ್
Halal	ಹಲಾಲ್
Ki	ಕಿ
Kamai	ಕಮಾಯಿ
Claudio	ಕ್ಲಾಡಿಯೊ
Ukkusiksalik	ಉಕುಸಿಕ್ಸಾಲಿಕ್
Hashim	ಹಾಶಿಮ್
Gaylord	ಗೆಲಾರ್ಡ್
Yojana	ಯೋಜನಾ
Keral	ಕೇರಳ
Basmah	ಬಸಮಾ
Ek	ಏಕ್
Naya	ನಯಾ
Rishta	ರಿಶ್ತಾ
Carr	ಕಾರ್
Allaudin	ಅಲಾವುದ್ದೀನ್
Laila	ಲೈಲಾ
Vibhuti	ವಿಭೂತೀ
Deidra	ಡಿಡ್ರಾ
Hawthornden	ಹಾವ್ಥೊಂಡೆನ್
Prize	ಪ್ರೈಜ್
Aatikah	ಆತಿಕಾ
Fort	ಫೋರ್ಟ್
canning	ಕ್ಯಾನಿಂಗ್
Order	ಆರ್ಡರ್
of	ಆಫ್
the	ದ
Golden	ಗೊಲ್ಡನ್
Eagle	ಈಗಲ್
Biyavra	ಬಿಯಾವ್ರಾ
Rajgarh	ರಾಜ್‌ಗಢ್
Chamraura	ಚಮರೌರಾ
Reporter	ರಿಪೋರ್ಟರ್
Fort	ಫೋರ್ಟ್
san	ಸ್ಯಾನ್
cristobal	ಕ್ರಿಸ್ಟೋಬಲ್
Mullah	ಮುಲ್ಲಾ
Shah	ಶಾ
Badakhshi	ಬದಾಕ್ಷಿ
Watson	ವ್ಯಾಟ್ಸನ್
Tremain	ಟ್ರೆಮಿಯನ್
Central	ಸೆಂಟ್ರಲ್
Bank	ಬ್ಯಾಂಕ್
Ursala	ಉರ್ಸಲಾ
Poshakhwale	ಪೋಶಾಖ್‌ವಾಲೆ
Dilruba	ದಿಲರುಬಾ
Tangewali	ಟಾಂಗೆವಾಲೀ
Ajgain	ಅಜ್‌ಗೈನ್
Bruce	ಬ್ರೂಸ್
Willis	ವಿಲಿಸ್
Crystal	ಕ್ರಿಸ್ಟಲ್
Globe	ಗ್ಲೋಬ್
SelaQui	ಸೆಲಾಕಿ
World	ವರ್ಲ್ಡ್
School,	ಸ್ಕೂಲ್,
Dehradun	ಡೆಹ್ರಾಡೂನ್
Mu'awwiz	ಮುಆವ್ವಿಜ್
Fort	ಫೋರ್ಟ್
niagara	ನಯಾಗರಾ
Rupesh	ರೂಪೇಶ್
Shera	ಶೇರಾ
Shamshera	ಶರಶೇರಾ
Paper	ಪೇಪರ್
Products	ಪ್ರಾಡೆಕ್ಟ್ಸ್
Ganga	ಗಂಗಾ
Aur	ಔರ್
Suraj	ಸೂರಜ್
Ashok	ಅಶೋಕ್
Nagar	ನಗರ್
Ramaia	ರಮಯ್ಯಾ
Minhajul	ಮಿನಾಜುಲ್
Abedin	ಅಬೇದಿನ್
Maricopa	ಮಾರಿಕೊಪಾ
University	ಯುನಿವರ್ಸಿಟಿ
of	ಆಫ್
Technology	ಟೆಕ್ನಾಲಜಿ
Lincoln	ಲಿಂಕನ್
University	ಯುನಿವರ್ಸಿಟಿ
Mike	ಮೈಕ್
Smith	ಸ್ಮಿತ್
Cynthia	ಸಿಂಥಿಯಾ
Daku	ಡಾಕೂ
Bijlee	ಬಿಜಲಿ
Do	ದೋ
Dost	ದೋಸ್ತ್
Nagendra	ನಾಗೇಂದ್ರ
Gurudwara	ಗುರುದ್ವಾರ
Sachha	ಸಚ್ಚಾ
Souda	ಸೌದಾ
Radhika	ರಾಧಿಕಾ
Jacques	ಜ್ಯಾಕ್ವಿಸ್
His	ಹಿಸ್
Church	ಚರ್ಚ್
World	ವರ್ಲ್ಡ್
Outreach	ಔಟ್‌ರೀಚ್
Center	ಸೆಂಟರ್
Georgette	ಜಾರ್ಜೆಟ್
Bandra	ಬಾಂದ್ರಾ
Terminus	ಟರ್ಮಿನಸ್
Tyagaraja	ತ್ಯಾಗರಾಜ
Dilbar	ದಿಲ್‌ಬರ್
Bankimchandra	ಬಂಕಿಮಚಂದ್
Chatarjee	ಚಟರ್ಜಿ
John	ಜಾನ್
Kenneth	ಕೆನೆತ್
Galbraith	ಗಾಲ್ಬ್ರೆಥ್
Pingalia	ಪಿಂಗಲಿಯಾ
Lusaka	ಲುಸಾಕಾ
Mausmi	ಮೌಸ್ಮಿ
Emmly	ಎಮ್ಲಿ
Begunah	ಬೇಗುನಾಹ್
Solent	ಸೋಲೆಂಟ್
Bandana	ಬಂದನಾ
Ruggiero	ರುಗ್ಗಿಯೆರೊ
Aster	ಆಸ್ಟರ್
Khwab	ಖ್ವಾಬ್
Ki	ಕಿ
Duniya	ದುನಿಯಾ
Raja	ರಾಜಾ
Vikram	ವಿಕ್ರಮ್
Ghar	ಘರ್
Ki	ಕಿ
Laaj	ಲಾಜ್
Valero	ವೆಲೆರೊ
Energy	ಎನರ್ಜಿ
City	ಸಿಟಿ
Union	ಯೂನಿಯನ್
Bank	ಬ್ಯಾಂಕ್
Gavin	ಗೆವಿಂಗ್
Rennie	ರೆನೀ
Golden	ಗೋಲ್ಡನ್
Gate	ಗೇಟ್
Highlands	ಹೈಲ್ಯಾಂಡ್ಸ್
Shaurya	ಶೌರ್ಯಾ
Chakra	ಚಕ್ರ
Sant	ಸಂತ
Raghu	ರಘು
Amar	ಅಮರ್
Akbar	ಅಕ್ಬರ್
Anthony	ಆಂಟೊನಿ
Paanch	ಪಾಂಚ್
Ratan	ರತನ್
Fort	ಫೋರ್ಟ್
manoel	ಮ್ಯಾನೊಲ್
Adele	ಅಡೀಲ್
Coalhouse	ಕೋಲ್‌ಹೌಸ್
fort	ಫೋರ್ಟ್
Ret	ರೆತ್
Mahal	ಮಹಲ್
Balkrishna	ಬಾಲಕೃಷ್ಣ
Ind	ಇಂಡಸ್ಟ್ರೀಸ್
Usayd	ಉಸೇದ್
Grady	ಗ್ರೆಡಿ
Chakkar	ಚಕ್ಕರ್
Pe	ಪೆ
Chakkar	ಚಕ್ಕರ್
Jawdan	ಜಾವದಾನ್
Sana	ಸನಾ
Akram	ಅಕ್ರಮ
Khan	ಖಾನ್
Damascus	ದಮಾಸ್ಕಸ್
Sourabh	ಸೌರಭ್
Deependu	ದೀಪೇಂದು
Shyaamataa	ಶ್ಯಾಮತಾ
Weldon	ವೆಲ್ಡನ್
Rutland	ರುಟ್ಲಾಂಡ್
Shuraym	ಶುರಾಯ್ಮ್
Francis	ಫ್ರಾನ್ಸಿಸ್
Ford	ಫೋರ್ಡ್
Coppola	ಕೋಪೋಲಾ
Silicon	ಸಿಲಿಕಾನ್
Motion	ಮೋಷನ್
Technology	ಟೆಕ್ನಾಲಜಿ
Corporation	ಕಾರ್ಪೊರೇಶನ್
Tonya	ಟೋನ್ಯ
University	ಯುನಿವರ್ಸಿಟಿ
of	ಆಫ್
Bradford	ಬ್ರಾಡ್ಫರ್ಡ್
Usariya	ಉಸರಿಯಾ
Mitsubishi	ಮಿತ್ಸುಬಿಷಿ
Chemical	ಕೆಮಿಕಲ್
Shay	ಶೆ
Dahar	ದಹರ್
Ka	ಕಾ
Balaji	ಬಾಲಾಜಿ
Raunaq	ರೌನಕ್
Bieszczady	ಬಿಜ್‌ಜ್ಯಾಡಿ
Dilwale	ದಿಲ್ವಾಲೆ
Dulhania	ದುಲ್ಹನಿಯಾ
Le	ಲೇ
Jaayenge	ಜಾಯೆಂಗೆ
Devinder	ದೇವೀಂದರ್
Saptakoteshwar	ಸಪ್ತಕೋಟೇಶ್ವರ
Maruf	ಮಾರುಫ್
Kaithal	ಕೈಥಾಲ್
Helen	ಹೆಲೆನ್
Keller	ಕೆಲ್ಲರ್
Prospect	ಪ್ರಾಸ್ಪೆಕ್ಟ್
Missionary	ಮಿಶನರಿ
Baptist	ಬ್ಯಾಪ್ಟಿಸ್ಟ್
Dooj	ದೂಜ್
Ka	ಕಾ
Chand	ಚಾಂದ್
Sarasvat	ಸಾರಸ್ವತ್
Marut	ಮಾರುತ್
Aahlaadit	ಆಹ್ಲಾದಿತ್
Jiten_dar	ಜಿತೇಂದರ್
Bahu	ಬಹು
Rani	ರಾನಿ
Leeds	ಲೀಡ್ಸ್
Metropolitan	ಮೆಟ್ರೋಪಾಲಿಟನ್
University	ಯುನಿವರ್ಸಿಟಿ
Banavaareelaal	ಬನ್ವಾರಿಲಾಲ್
Chaksu	ಚಕ್ಸು
Pallington	ಪ್ಯಾಲಿಂಗ್ಟನ್
Khadilkar	ಖಡ್ಲಿಕರ್
Faustine	ಫಾಸ್ಟೀನ್
Dongargaon	ದೊಂಗರ್ಗಾವ್
Tapesh	ತಪೇಶ್
Hind	ಹಿಂದ್
Sanitary	ಸ್ಯಾನಿಟರಿ
Guntakal	ಗುಂತಕಲ್
Junction	ಜಂಕ್ಷನ್
Hasmukh	ಹಸಮುಖ್
Tushar	ತುಷಾರ್
Imran	ಇಮ್ರಾನ್
Baion	ಬೈಯೊನ್
Aileen	ಐಲೀನ್
Ramayana	ರಾಮಾಯಣ
Nikkos	ನಿಕ್ಕೋಸ್
Phaansi	ಫಾನ್ಸಿ
Lowes	ಲೋವೆಸ್
Gulati	ಗುಲಾಟಿ
Faasle	ಫಾಸಲೆ
Cosima	ಕೋಸಿಮಾ
Shokaghn	ಶೋಕಾಘ್ನ್
Gadra	ಗಾದರಾ
Road	ರೋಡ್
Nardo	ನರ್ದೊ
Medal	ಮೆಡಲ್
of	ಆಫ್
Zhukov	ಝುಕೋವ್
Miss	ಮಿಸ್
Good	ಗುಡ್
Night	ನೈಟ್
Ghauth	ಗೌಥ್
Prapitameshwar	ಪ್ರಪಿತಾಮೇಶ್ವರ
Naeem	ನಯೀಂ
Ashraf	ಅಶ್ರಫ್
Bankura	ಬಂಕುರಾ
Muttiah	ಮುತ್ತಯ್ಯ
Muralitharan	ಮುರಳೀಧರನ್
King	ಕಿಂಗ್
Edward	ಎಡ್ವರ್ಡ್
VII	VII
Inam	ಇನಾಮ್
Dus	ದಸ್
Hazar	ಹಜಾರ್
Fort	ಫೋರ್ಟ್
saint	ಸೆಂಟ್
james	ಜೇಮ್ಸ್
Vihuela	ವಿಹುವೆಲ
Lovey	ಲೋವೆ
Varna	ವರ್ಣ
Sassi	ಸಸ್ಸೀ
Punnu	ಪುನ್ನಾ
Bharani	ಭರಣಿ
Hamdan	ಹಮದನ್
Kangada	ಕಾಂಗ್ಡಾ
Salene	ಸೆಲೀನ್
Ishaq	ಇಶಾಕ್
Ranjit	ರಂಜಿತ್
Fernando	ಫರ್ನಾಂಡೊ
Apne	ಅಪ್ನೆ
Dam	ದಮ್
Par	ಪರ್
Gregg	ಗ್ರೆಗ್
Bharti	ಭಾರತಿ
Air	ಏರ್
Hamburg	ಹ್ಯಾಂಬರ್ಗ್
Kusumlata	ಕುಸುಮಲತಾ
Dinanath	ದೀನನಾಥ
Sharmila	ಶರ್ಮಿಲಾ
Veerandhar	ವೀರಾಂಧರ್
Tavita	ತವಿತಾ
Shiv	ಶಿವ
Bhakta	ಭಕ್ತಿ
Mount	ಮೌಂಟ್
Abu	ಅಬು
Thailand	ಥಾಯ್ಲೆಂಡ್
Resham	ರೇಶಮ್
Aansoo	ಆಂಸೂ
Dan	ಡಾನ್
Cullen	ಕಲ್ಲನ್
Prem	ಪ್ರೇಮ್
Bandhan	ಬಂಧನ್
Rabia	ರಬೀಯಾ
al-Adawiya	ಅಲ್-ಅದಾವಿಯಾ
Ajay	ಅಜಯ್
Jadeja	ಜಡೇಜಾ
Kushal	ಕುಶಲ
Bavla	ಬಾವ್ಲಾ
Sohi	ಸೋಹಿ
Hana	ಹನಾ
Teva	ಟೆವಾ
Pharmaceutical	ಫಾರ್ಮಾಸ್ಯೂಟಿಕಲ್
Industries	ಇಂಡಸ್ಟ್ರೀಸ್
Limited	ಲಿಮಿಟೆಡ್
Fiona	ಫಿಯೋನಾ
Schoenfeld	ಶಾನ್ಫೆಲ್ಡ್
Philander	ಫಿಲಾಂಡೆರ್
Abhyudita	ಅಭ್ಯುದಿತಾ
Shaheenah	ಶಹೀನ್ಹಾ
Maha	ಮಹಾ
Shaktimaan	ಶಕ್ತಿಮಾನ್
Sodi	ಸೋಢಿ
Akhtar	ಅಖ್ತರ್
Qadim	ಕಾದಿಮ್
Dharm	ಧರ್ಮ್
Patni	ಪತ್ನಿ
Nafrat	ನಫರತ್
Ki	ಕಿ
Andhi	ಆಂಧೀ
Sawwaf	ಸವ್ವಾಫ್
Ardhangini	ಅರ್ಧಾಂಗಿನಿ
Sajiv	ಸಜೀವ್
Murti	ಮೂರ್ತಿ
Cargill	ಕಾರ್ಜಿಲ್
Tim	ಟಿಮ್
Cary	ಕೆರಿ
Deewangee	ದೀವಾನಗೀ
Mawsil	ಮಾವಸಿಲ್
Jagadhidh	ಜಗದೀಧ್
Nusrat	ನುಸರತ್
Fateh	ಫತೇ
Ali	ಅಲಿ
Khan	ಖಾನ್
Darnell	ಡಾರ್ನೆಲ್
Abdul	ಅಬ್ದುಲ್
awwal	ಅವ್ವಲ್
Akalmash	ಅಕಲ್ಮಶ್
Rekhi	ರೇಖಿ
Gulam	ಗುಲಾಮ್
Begum	ಬೇಗಮ್
Badshah	ಬಾದಶಾಹ್
Bhatakti	ಭಟಕ್ತೀ
Maina	ಮೈನಾ
Andoy	ಆಂಡೊ
fort	ಫೋರ್ಟ್
Sangha	ಸಂಘಾ
Malkauns	ಮಾಲಕೌಂಸ್
Abdul	ಅಬ್ದುಲ್
rahim	ರಹೀಂ
Archaa	ಅರ್ಚಾ
Rober	ರಾಬರ್
Bosch	ಬಾಶ್
Nippon	ನಿಪಾನ್
Oil	ಆಯಿಲ್
Balli	ಬಾಲಿ
Yuvraj	ಯುವರಾಜ್
Singh	ಸಿಂಗ್
Pehla	ಪಹಲಾ
Pehla	ಪಹಲಾ
Pyar	ಪ್ಯಾರ್
Sekisui	ಸೆಕಿಸುಯ್
House	ಹೌಸ್
Galion	ಗಲಿಯೋಂ
Ka	ಕಾ
Badshah	ಬಾದಶಾಹ್
Geoff	ಜೆಫ್
Arnold	ಅರ್ನೋಲ್ಡ್
Toni	ಟೋನಿ
Satyawan	ಸತ್ಯವಾನ್
Prajaapat	ಪ್ರಜಾಪತ್
Theodora	ಥಿಯೋಡೊರಾ
Kashif	ಕಾಶಿಫ್
Raza	ರಾಜಾ
Desdemona	ಡೆಸ್ಟೆಮೊನಾ
Ismah	ಇಸ್ಮಾ
Anguree	ಅಂಗುರೀ
Nayyab	ನಯ್ಯಬ್
Faisal	ಫೈಸಲ್
Iqbal	ಇಕ್ಬಾಲ್
Balharshah	ಬಾಲಹರ್‌ಶಾ
Nestor	ನೆಸ್ಟರ್
Bhai	ಭಾಯಿ
Saheb	ಸಾಬ್
Vijaynagar	ವಿಯಜನಗರ್
Damini	ದಾಮಿನಿ
Apollo	ಅಪೋಲೋ
Hospital	ಹಾಸ್ಪಿಟಲ್
Lakkad	ಲಕ್ಕಡ್
Basai	ಬಸಾಯ್
Cape	ಕೇಪ್
Horn	ಹಾರ್ನ್
Chhatre	ಛಾತ್ರೆ
Bhadbhoke	ಭಾಡಭೋಕೆ
Althea	ಅಲ್ಥಿಯಾ
Gustavo	ಗುಸ್ತಾವೊ
Premio	ಪ್ರೆಮಿಯೊ
Bancarella	ಬಾನ್ಕರೆಲ್ಲಾ
Dhamija	ಧಾಮಿಜಾ
Aashir	ಆಶಿರ್
Basar	ಬಸಾರ್
Khafid	ಖಫಿದ್
Chetan	ಚೇತನ್
Chandi	ಚಾಂದೀ
Sona	ಸೋನಾ
Wenda	ವೆಂಡಿ
Sullivan	ಸುಲಿವಾನ್
Jariyah	ಜರಿಯಾಹ್
Rio	ರಿಯೋ
Grande	ಗ್ರಾಂಡೆ
River	ರಿವರ್
Arghya	ಅರ್ಘ್ಯಾ
Rajasthan	ರಾಜಾಸ್ತಾನ್
patrika	ಪತ್ರಿಕಾ
Rohini	ರೋಹಿಣೀ
Salifah	ಸಲೀಫಾ
Avyakt	ಅವ್ಯಕ್ತ
Aragon	ಅರಗಾನ್
Haupango	ಹೌಪಾಂಗೊ
Fort	ಫೋರ್ಟ್
ticonderoga	ಟಿಕೋನ್‌ಡೆರ್ಗೋ
Milan	ಮಿಲಾನ್
Linate	ಲೈನೇಟ್
Bambai	ಬಂಬಾಯ್
Ka	ಕಿ
Babu	ಬಹು
Prabhuraam	ಪ್ರಭುರಾಮ್
Nicole	ನಿಕೋಲ್
Kidman	ಕಿಡ್‌ಮನ್
Russell	ರಸೆಲ್
Metro	ಮೆಟ್ರೋ
Tyres	ಟೈರ್ಸ್
Chandralekha	ಚಂದ್ರಲೇಖಾ
Colorado	ಕೊಲೊರೇಡೋ
Plains	ಪ್ಲೈನ್ಸ್
All	ಆಲ್
Amer	ಅಮೆರ್
Pipe	ಪೈಪ್
Princess	ಪ್ರಿನ್ಸೆಸ್
Sarah	ಸಾರಾ
Ferguson	ಫೆರ್ಗ್ಯೂಸನ್
Vermont	ವೆರ್ಮಂಟ್
Marble	ಮಾರ್ಬಲ್
Museum	ಮ್ಯೂಸಿಯಂ
Saed	ಸೈದ್
E	ಎ
Havas	ಹವಾಸ್
Winnipeg	ವಿನ್ನಿಪೆಗ್
Gondhalekar	ಗೋಂಧಾಳೆಕರ್
Fitzwilliam	ಫಿಟ್ಜ್‌ವಿಲಿಯಂ
Merlin	ಮೆರ್ಲಿನ್
Aag	ಆಗ್
Hi	ಹಿ
Aag	ಆಗ್
Dilawarnagar	ದಿಲಾವರನಗರ್
Aaj	ಆಜ್
Ka	ಕಾ
Gunda	ಗುಂಡಾ
Bahar	ಬಹಾರ್
Hyderabad	ಹೈದರಾಬಾದ್
Public	ಪಬ್ಲಿಕ್
School	ಸ್ಕೂಲ್
Exmouth	ಎಕ್ಸ್‌ಮೌಥ್
Salilaa	ಸಲಿಲಾ
Akashi-Kaikyo	ಅಕಾಶಿ-ಕೈಕ್ಯೊ
Hersey	ಹೆರ್ಸಿ
Devilal	ದೇವಿಲಾಲ್
Solferino	ಸೋಲ್ಫೆರಿನೊ
Kori	ಕೋರಿ
Merch	ಮೆರ್ಚ್
Aatirah	ಆತಿರಾ
Bawal	ಬವಾಲ್
Elizabeth	ಎಲಿಜಬೆತ್
Tailor	ಟೇಲರ್
Achaleswara	ಅಚಲೇಶ್ವರ
Ezra	ಎರ್ಜಾ
Moseley	ಮೂಸ್ಲಿ
Griggs	ಗ್ರಿಗ್ಸ್
Sidhdhi	ಸಿದ್ಧಿ
Solapur	ಸೋಲಾಪುರ್
Nirmal	ನಿರ್ಮಲ್
Cala	ಕೇಲಾ
Heeraalaal	ಹೀರಾಲಾಲ್
Chirantan	ಚಿರಂತನ್
Raat	ರಾತ್
Aur	ಔರ್
Din	ದಿನ್
Dombivili	ದೊಂಬಿವಿಲಿ
Ek	ಏಕ್
Musafir	ಮುಸಾಫಿರ್
Ek	ಏಕ್
Hasina	ಹಸೀನಾ
Tumhare	ತುಮ್ಹಾರೆ
Bina	ಬಿನಾ
Order	ಆರ್ಡರ್
of	ಆಫ್
the	ದ
Dutch	ಡಚ್
Lion	ಲಯನ್
Bhupia	ಭುಪಿಯಾ
Mau	ಮಾವ್
Jogi	ಜೋಗಿ
Najiyah	ನಜೀಯಾ
Toshiba	ತೋಷಿಬಾ
Krodhi	ಕ್ರೋಧಿ
Colong	ಕೊಲೊಂಗ್
Franz	ಫ್ರಾಂಜ್
Chanda	ಚಂದಾ
Fort	ಫೋರ್ಟ್
Adinaarayan	ಆದಿನಾರಾಯಣ
Badli	ಬದಲೀ
Jennifer	ಜೆನೀಫರ್
Westfallen	ವೆಸ್ಟ್‌ಫಾಲೆನ್
Baba	ಬಾಬಾ
Nigeria	ನೈಜೀರಿಯ
Ram	ರಾಮ
Nagari	ನಗರೀ
Anandini	ಆನಂದಿನಿ
Richard	ರಿಚರ್ಡ್
Dawson	ಡಾಸನ್
Wipro	ವಿಪ್ರೋ
Andrew	ಆಂಡ್ರಿವ್
Martin	ಮಾರ್ಟಿನ್
Fort	ಫೋರ್ಟ್
saint	ಸೆಂಟ್
philip	ಫಿಲಿಪ್
Chris	ಕ್ರಿಸ್
Read	ರೀಡ್
Sampoorna	ಸಂಪೂರ್ಣ
Devi	ದೇವಿ
Darshan	ದರ್ಶನ್
Modak	ಮೋಡಕ್
Madliena	ಮಡ್ಲಿನಾ
tower	ಟವರ್
fort	ಫೋರ್ಟ್
Shire	ಶೈರ್
Slough	ಸ್ಲೌಗ್
fort	ಫೋರ್ಟ್
Tacy	ಟ್ಯಾಸಿ
Gowing	ಗೌವಿಂಗ್
Durgapur	ದುರ್ಗಾಪುರ
Salihah	ಸಲೀಹಾ
Kevin	ಕೆವಿನ್
Wright	ರೈಟ್
Lille	ಲಿಲೀ
Shiv	ಶಿವ
Ratri	ರಾತ್ರಿ
Lute	ಲೂಟ್
Samudra	ಸಮುದ್ರ
Mayurakshi	ಮಯೂರಾಕ್ಷಿ
Keshavdas	ಕೇಶವದಾಸ್
Shafiq	ಶಫೀಕ್
Ahmed	ಅಹ್ಮದ್
Writers	ರೈಟರ್ಸ್
of	ಆಫ್
the	ದಿ
Future	ಫ್ಯೂಚರ್
Andre	ಆಂಡ್ರೆ
Nel	ನಿಲ್
Yashpal	ಯಶಪಾಲ್
Sharma	ಶರ್ಮಾ
Rajdulari	ರಾಜದುಲಾರಿ
Baali	ಬಾಲಿ
Rozalia	ರೋಝಾಲಿಯಾ
Bijoor	ಬಿಜೂರ್
Amritesh	ಅಮೃತೇಶ್
Brest	ಬ್ರೆಸ್ಟ್
fortress	ಫೋರ್ಟ್ರೆಸ್
Marsha	ಮಾರ್ಶಾ
Clark	ಕ್ಲಾರ್ಕ್
Mundia	ಮುಂಡಿಯಾ
Bheegi	ಭೀಗೀ
Raat	ರಾತ್
Bagbahra	ಬಾಗ್‌ಬಹ್ರಾ
Prasannjit	ಪ್ರಸನ್ನಜಿತ್
New	ನ್ಯೂ
Haven	ಹಾವೆನ್
Road	ರೋಡ್
Church	ಚರ್ಚ್
of	ಆಪ್
God	ಗಾಡ್
Maanasee	ಮಾನಸೀ
Punjab	ಪಂಜಾಬ್
kesari	ಕೇಸರಿ
Gary	ಗ್ಯಾರಿ
Cosier	ಕೋಸಿಯರ್
Suraksha	ಸುರಕ್ಷಾ
Moorat	ಮೂರತ್
Sterlite	ಸ್ಟರ್ಲೈಟ್
Moscow	ಮಾಸ್ಕೋ
State	ಸ್ಟೇಟ್
University	ಯುನಿವರ್ಸಿಟಿ
Acharysuta	ಆಚಾರ್ಯಸುತ
Cornish	ಕಾರ್ನಿಶ್
Colony	ಕಾಲೊನಿ
Museum	ಮ್ಯೂಸಿಯಂ
Zelig	ಜೆಲಿಗ್
Chengai	ಚೆಂಗೈ
Anna	ಅನ್ನಾ
Amar	ಅಮರ್
Jyoti	ಜ್ಯೋತಿ
Rani	ರಾಣಿ
Roopmati	ರೂಪಮತಿ
Gasunie	ಗಾಸುನೀ
Shobhita	ಶೋಭಿತಾ
Chikodi	ಚಿಕ್ಕೋಡಿ
Road	ರೋಡ್
An	ಆನ್
Evening	ಈವನಿಂಗ್
In	ಇನ್
Paris	ಪ್ಯಾರಿಸ್
Edger	ಎಡ್ಗರ್
allan	ಅಲನ್
Poe	ಪೋಯ್
Chetanaa	ಚೇತನ
Dulha	ದುಲ್ಹಾ
Bikta	ಬಿಕತಾ
Hai	ಹೈ
Mahum	ಮಹುಮ್
Adaa	ಅದಾ
Shraddha	ಶ್ರದ್ಧಾ
Jagatsinghpur	ಜಗತ್ ಸಿಂಗ್ ಪುರ್
Shikishima	ಶಿಕಿಶಿಮಾ
Punita	ಪುನೀತ
Be	ಬೆ
Aabroo	ಆವರೂ
Mahua	ಮಹುವಾ
Taisei	ಟೈಸೀ
Makhaya	ಮಖಾಯಾ
Ntini	ಎಂಟಿನಿ
India	ಇಂಡಿಯಾ
Life	ಲೈಫ್
Edda	ಎಡ್ಡಾ
Steve	ಸ್ಟೀವ್
Elworthy	ಎಲ್ವರ್ದಿ
Gurudwara	ಗುರುದ್ವಾರ
Satsang	ಸತ್ಸಂಗ
Darbar	ದರ್ಬಾರ್
Vaparaiso	ವಪರಾಯ್ಸೋ
Church	ಚರ್ಚ್
of	ಆಫ್
Christ	ಕ್ರಿಸ್ಟ್
Sevaraam	ಸೇವಾರಾಮ್
Saheb	ಸಾಹೆಬ್
Bahadur	ಬಹಾದೂರ್
Donal	ಡೋನಲ್
Smith	ಸ್ಮಿತ್
Deewar	ದೀವಾರ್
Namur	ನಮುರ್
Sakhi	ಸಖಿ
Banar	ಬನಾರ್
Rabi'ah	ರಬಿಯಾಹ್
Madeleine	ಮ್ಯಾಡೆಲೀನ್
Meriwether	ಮೆರಿವೆದರ್
One	ಒನ್
Liberty	ಲಿಬರ್ಟಿ
Place	ಪ್ಲೇಸ್
Yukon	ಯುಕೋಂ
Pakshi	ಪಕ್ಷಿ
Aandhi	ಆಂಧೀ
Toofan	ತೂಫಾನ್
Gunjana	ಗುಂಜನಾ
Sant	ಸಂತ್
Tukaram	ತುಕಾರಾಮ್
Fort	ಫೋರ್ಟ್
mandan	ಮ್ಯಾಂಡನ್
Bread	ಬ್ರೆಡ್
and	ಅಂಡ್
Puppet	ಪಪ್ಪೆಟ್
Museum	ಮ್ಯೂಸಿಯಂ
Gawaahi	ಗವಾಹಿ
Addis	ಅಡ್ಡಿಸ್
Ababa	ಅಬಾಬಾ
Panihari	ಪನಿಹಾರಿ
Honeymoon	ಹನಿಮೂನ್
Aag	ಆಗ್
Ka	ಕಾ
Dariya	ದರಿಯಾ
Fort	ಫೋರ್ಟ್
red	ರೆಡ್
bay	ಬೆ
Ulmer	ಉಲ್ಮೇರ್
Eara	ಈರಾ
Shatrujetaa	ಶತ್ರುಜಿತಾ
Pico	ಪಿಕೊ
de	ಡಿ
Orizaba	ಒರಿಜಾಬಾ
Senapati	ಸೇನಾಪತಿ
Jal	ಜಲ್
Tarang	ತರಂಗ್
Fort	ಫೋರ್ಟ್
recovery	ರೆಕವರಿ
Bombo	ಬಾಂಬೋ
Bommidi	ಬೊಮ್ಮಿಡಿ
Rustam	ರುಸ್ತಮ್
Clarke	ಕ್ಲಾರ್ಕ್
Kesler	ಕೆಸ್ಲರ್
Sharp	ಶಾರ್ಪ್
Abyad	ಅಬ್ಯಾದ್
Madirakshi	ಮದಿರಾಕ್ಷಿ
Cotton-eyed-joe	ಕಾಟನ್-ಐಡ್-ಜೋ
Portland	ಪೋರ್ಟ್ ಲ್ಯಾಂಡ್
Andrew	ಆಂಡ್ರ್ಯೂ
Hudson	ಹಡ್ಸನ್
Prix	ಪ್ರಿಕ್ಸ್
Femina	ಫೆಮಿನಾ
Mayon	ಮಾಯೋನ್
Anugamita	ಅನುಗಾಮಿತಾ
Rolando	ರೊಲ್ಯಾಂಡೊ
Allan	ಅಲಾನ್
Greenspan	ಗ್ರೀನ್‌ಸ್ಪಾನ್
Faryadi	ಫರ್ಯಾದಿ
Cawsand	ಕಾವ್‌ಸ್ಯಾಂಡ್
fort	ಫೋರ್ಟ್
Sahm	ಸಹಮ್
Amay	ಅಮಯ್
Berhampore	ಬೆರ್ಹಾಂಪೊರ್
Ashwin	ಅಶ್ವಿನ್
Girna	ಗಿರ್ನಾ
French	ಫ್ರೆಂಚ್
Babar	ಬಾಬರ್
Bhiwandi	ಭಿವಾಂಡಿ
Road	ರೋಡ್
Mountain	ಮೌಂಟೇನ್
biking	ಬೈಕಿಂಗ್
Paul	ಪೌಲ್
Strang	ಸ್ಟ್ರಾಂಗ್
Didjeridu	ಡಿಜೆರಿದು
Sevastopol	ಸೆವಸ್ಟೋಪೊಲ್
Vaaknis	ವಾಕ್ನಿಸ್
Ghuri	ಘೂರಿ
Shree	ಶ್ರೀ
Krishna	ಕೃಷ್ಣ
Darshan	ದರ್ಶನ್
Interactive	ಇಂಟರ್‌ಆಕ್ಟಿವ್
Achievement	ಅಚೀವ್‌ಮೆಂಟ್
Awards	ಅವಾರ್ಡ್ಸ್
Yitzhak	ಯಿಜಾಕ್
Robin	ರಾಬಿನ್
Mahashweta	ಮಹಾಶ್ವೇತಾ
Perkin	ಪೆರ್ಕಿನ್
Medal	ಮೆಡಲ್
Jerom	ಜೆರೊಮ್
Jagarau	ಜಗರಾವ್
Shivsagar	ಶಿವಸಾಗರ್
Doraha	ದೊರಾಹಾ
Humsafar	ಹಮ್‌ಸಫರ್
Andre	ಆಂಡ್ರೆ
Marlo	ಮಾರ್ಲೊ
Kamla	ಕಮಲಾ
Ki	ಕಿ
Maut	ಮೌತ್
The	ದ
assam	ಅಸ್ಸಾಮ್
tribune	ಟ್ರಿಬ್ಯೂನ್
Aruna	ಅರುಣಾ
General	ಜನರಲ್
George	ಜಾರ್ಜ್
Patton	ಪ್ಯಾಟಾನ್
Cornelius	ಕಾರ್ನೆಲಿಯಸ್
Unitech	ಯೂನಿಟೆಕ್
Aaradhana	ಆರಾಧನಾ
Virtuti	ವಿರ್‌ಟುಟಿ
Militari	ಮಿಲಿಟಾರಿ
Emmy	ಎಮ್ಮಿ
Abeeraa	ಅಬೀರಾ
Asma	ಅಸ್ಮಾ
Purani	ಪುರಾನಿ
Pehchan	ಪಹಚಾನ್
China	ಚೀನಾ
Sothern	ಸದರ್ನ್
Power	ಪವರ್
Grid	ಗ್ರಿಡ್
Ajaatshatru	ಅಜಾತ್‌ಶತ್ರು
Conley	ಕೋನ್ಲಿ
Singar	ಸಿಂಗಾರ್
Ishwar	ಈಶ್ವರ್
Ian	ಇಯಾನ್
Harvey	ಹಾರ್ವೆ
Khamosh	ಖಾಮೋಶ್
Shareekah	ಶರೀಕಾ
Dham	ಧಾಮ್
Piggott	ಪಿಗ್ಗಟ್
Sanjh	ಸಾಂಝ್
Aur	ಔರ್
Savera	ಸವೇರಾ
Umashankar	ಉಮಾಶಂಕರ್
Anandinee	ಆನಂದಿನೀ
Archishmat	ಅರ್ಚಿಷ್ಮತ್
Gareth	ಗರೆತ್
Batty	ಬಾಟಿ
Almirante	ಅಲ್ಮಿರಾಂಟೆ
Latorre	ಲಟ್ಟೋರಿ
Bhaarateey	ಭಾರತೀಯ
Crownhill	ಕ್ರೌನ್‌ಹಿಲ್
fort	ಫೋರ್ಟ್
Murshida	ಮುರ್ಶಿದಾ
Pyar	ಪ್ಯಾರ್
Ka	ಕಾ
Sapna	ಸಪನಾ
Barharwa	ಬರಹಾರ್ವಾ
Junction	ಜಂಕ್ಷನ್
Gorakhpur	ಘೋರಖ್‌ಪುರ್
City	ಸಿಟಿ
Madonna	ಮಡೋನ್ನಾ
Lisbon	ಲಿಸ್ಬನ್
Gurjas	ಗುರಜಸ್
Krishna	ಕೃಷ್ಣ
Sudaama	ಸುದಾಮಾ
Hewlett	ಹ್ಯುಲೆಟ್
-	-
Packard	ಪ್ಯಾಕರ್ಡ್
Log	ಲೋಗ್
Kya	ಕ್ಯಾ
Kahenge	ಕಹೆಂಗೆ
Summer	ಸುಮೇರ್
Sohal	ಸೋಹಲ್
Vinchurkar	ವಿಂಚುರ್‌ಕರ್
Sohan	ಸೋಹಣ್
Nandur	ನಂದೂರ್
Madhmeshwar	ಮಧ್ಮೆಶ್ವರ್
Dam	ಡ್ಯಾಮ್
Iyaad	ಇಯಾದ್
Augrabies	ಔರಾಗ್ಬೀಸ್
Falls	ಫಾಲ್ಸ್
Rikshawala	ರಿಕ್ಷಾವಾಲಾ
Apala	ಅಪಲಾ
Najibah	ನಜೀಬದ್
Humari	ಹಮಾರೀ
Jung	ಜಂಗ್
Mythili	ಮೈಥಿಲಿ
Shaankar	ಶಾಂಕರ್
Raghupati	ರಘುಪತಿ
University	ಯುನಿವರ್ಸಿಟಿ
of	ಆಫ್
Paisley	ಪೈಸ್ಲೇ
Nadiya	ನದಿಯಾ
Ke	ಕೆ
Paar	ಪಾರ್
Alam	ಆಲಮ್
Ara	ಅರಾ
Ki	ಕೀ
Beti	ಬೇಟಿ
Kala	ಕಾಲಾ
Ghoda	ಘೋಡಾ
Maghvan	ಮಾಘವನ್
Nobel	ನೋಬೆಲ್
Prize	ಪ್ರೈಜ್
in	ಇನ್
Literature	ಲಿಟರೇಚರ್
Atithee	ಅತಿಥಿ
Puranjay	ಪುರಂಜಯ
Arqam	ಅರ್ಕಾಮ್
Errin	ಎರಿನ್
Bhagwan	ಭಗವಾನ್
Parshuram	ಪರಶುರಾಮ್
Isabelle	ಇಸಾಬೆಲ್
Karsan	ಕರ್ಸನ್
Ghavri	ಗಾರ್ವಿ
Bunaken	ಬುನಾಕೇನ್
Muktsar	ಮುಕ್ತಸರ್
Aanisah	ಆನಿಸಾ
Gagan	ಗಗನ್
Khoda	ಖೋಡಾ
Balwinder	ಬಲ್ವಿಂದರ್
Sandhu	ಸಂಧು
Cheng	ಚೆಂಗ್
Lang	ಲಾಂಗ್
Callie	ಕ್ಯಾಲೀ
Madhya Pradesh	ಮಧ್ಯಪ್ರದೇಶ
Najidah	ನಜೀದಾ
Caspian	ಕ್ಯಾಸ್ಪಿಯನ್
Aaja	ಆಜ್
Re	ರೆ
O	ಒ
Sajna	ಸಜನಾ
Muhriz	ಮುಹರಿಝ್
Alabama	ಅಲಾಬಾಮಾ
Aachaaryasutaa	ಆಚಾರ್ಯಸುತಾ
Anirvaan	ಅನಿರ್ವಾಣ್
Macon	ಮ್ಯಾಕನ್
Madaniyah	ಮದನಿಯಾ
Raghukul	ರಘುಕುಲ
Fort	ಫೋರ್ಟ್
wallington	ವೆಲ್ಲಿಂಗ್‌ಟನ್
Celia	ಸೆಲಿಯಾ
Solan	ಸೊಲಾನ್
Satte	ಸತ್ತೆ
Pe	ಪೆ
Satta	ಸತ್ತಾ
Kailey	ಕೈಲೆ
Hedgewar	ಹೆಡ್ಗೆವಾರ್
Mandakranta	ಮಂದ್ರಕ್ರಾಂತ
Norwich	ನಾರ್ವಿಕ್
Mard-E-Maidan	ಮರ್ದ್-ಎ-ಮೈದಾನ್
Poornachandra	ಪೂರ್ಣಚಂದ್ರ
Ghutayf	ಗುತಾಯಫ್
Yalqoot	ಯಾಲಖೂತ್
Rajkot	ರಾಜ್ ಕೋಟ್
Clovis	ಕ್ಲೋವಿಸ್
Gariep	ಗೆರೀಪ್
Dam	ಡ್ಯಾಮ್
Artah	ಆರ್ತಾ
Kiswar	ಕಿಸ್ವರ್
Lena	ಲೇನಾ
River	ರಿವರ್
Sachdeva	ಸಚದೇವಾ
Public	ಪಬ್ಲಿಕ್
School,	ಸ್ಕೂಲ್,
Rohini	ರೋಹಿಣಿ
Intisar	ಇಂತಿಸಾರ್
Prasat	ಪ್ರಸಾತ್
Common	ಕಾಮನ್
Bete	ಬೀಟ್
Naya	ನಯಾ
Zamana	ಜಮಾನಾ
Lee	ಲೀ
Germon	ಜರ್ಮನ್
Vats	ವತ್ಸ್
Birla	ಬಿರ್ಲಾ
Group	ಗ್ರೂಪ್
Makhtoonah	ಮಖತೂನಾ
Shakuntala	ಶಕುಂತಲಾ
Florrie	ಫ್ಲೋರಿ
Knuth	ಕ್ನುತ್
Prize	ಪ್ರೈಜ್
Corliss	ಕಾರ್ಲಿಸ್
Ipca	ಇಪ್ಕಾ
Labs	ಲ್ಯಾಬ್ಸ್
Cantabrian	ಕಾಂಟಾಬ್ರಿಯನ್
Birmingham	ಬರ್ಮಿಂಗ್ ಹ್ಯಾಂ
Audaen	ಔದೀನ್
fort	ಫೋರ್ಟ್
Azamnagar	ಆಜಮ್‌ನಗರ್
Road	ರೋಡ್
Firdaus	ಫಿರದೌಸ್
Ernie	ಎರ್ನೀ
Dugdol	ದುಗಡೊಲ್
Sivni	ಸಿವ್ನಿ
Taneja	ತನೇಜಾ
Aryaman	ಆರ್ಯಮಾನ್
Tommy	ಟಾಮೀ
Riwa	ರಿವಾ
fort	ಫೋರ್ಟ್
Trilok	ತ್ರಿಲೋಕ್
Sundari	ಸುಂದರಿ
Najm	ನಜ್ಮ್
Shan-E-Hind	ಶಾನ್-ಎ-ಹಿಂದ್
Shamoodah	ಶಮೂದಾಹ್
Dausni	ದೌಸ್ನಿ
Divorce	ಡೈವರ್ಸ್
Doosri	ದೂಸರೀ
Sita	ಸೀತಾ
Hafs	ಹಫ್ಸ್
Vinati	ವಿನತಿ
Hermes	ಹರ್ಮೀಸ್
Aminul	ಅಮಿನುಲ್
Islam	ಇಸ್ಲಾಂ
Museum	ಮ್ಯೂಸಿಯಂ
of	ಆಫ್
London	ಲಂಡನ್
Prithvi	ಪೃಥ್ವಿ
Putra	ಪುತ್ರ
Alaka	ಅಲಕಾ
Sonakshi	ಸೋನಾಕ್ಷಿ
Budapest	ಬುಡಾಪೆಸ್ಟ್
Ferihegy	ಫೆರಿಹೆಗಿ
Prem	ಪ್ರೇಮ್
Yatra	ಯಾತ್ರಾ
Kharga	ಖರ್ಗಾ
Odina	ಓಡಿನ
Vattenfall	ವಾಟೆನ್‌ಫಾಲ್
Richard	ರಿಚರ್ಡ್
Reid	ರೀಡ್
Pyar	ಪ್ಯಾರ್
Hi	ಹೀ
Pyar	ಪ್ಯಾರ್
Barnstable	ಬಾರ್ನ್‌ಸ್ಟೇಬಲ್
Ankit	ಅಂಕಿತ್
Ek	ಏಕ್
Naya	ನಹಾ
Itihaas	ಇತಿಹಾಸ್
Rajadhyaksha	ರಾಜಾಧ್ಯಕ್ಷ
Yaman	ಯಾಮನ್
Kanwarlal	ಕನ್ವರಲಾಲ್
Maniram	ಮಣಿರಾಮ್
The	ದ
Harbourside	ಹಾರ್ಬರ್‌ಸೈಡ್
Jinta	ಜಿಂಟಾ
Nafrat	ನಫರತ್
Amaresh	ಅಮರೇಶ್
Junyo	ಜುನ್ಯು
Major	ಮೇಜರ್
Dory	ಡೋರಿ
Bank	ಬ್ಯಾಂಕ್
of	ಆಫ್
America	ಅಮೆರಿಕ
Aadarsh	ಆದರ್ಶ್
Bahiyy	ಬಾಹಿಯಾ
al	ಅಲ್
din	ದೀನ್
Acharynandana	ಆಚಾರ್ಯನಂದನ
Ashu	ಅಶು
Razia	ರಜಿಯಾ
Sultan	ಸುಲ್ತಾನ್
Rudy	ರುಡಿ
Michael	ಮೈಕೇಲ್
Di	ಡಿ
Venuto	ವೆನುಟೊ
Poonam	ಪೂನಂ
Ki	ಕೀ
Raat	ರಾತ್
Apmaan	ಅಪಮಾನ್
Bhago	ಭಾಗೋ
Bhoot	ಭೂತ್
Aaya	ಆಯಾ
Nartana	ನತ್ರನಾ
Vajramani	ವಜ್ರಮಣಿ
Habib	ಹಬೀಬ್
China	ಚೀನಾ
Telecommunications	ಟೆಲಿಕಮ್ಯೂನಿಕೇಶನ್ಸ್
Ozaafar	ಓಜಾಫರ್
Egyptian	ಇಜಿಪ್ಟಿಯನ್
Museum	ಮ್ಯೂಸಿಯಂ
Midhvaan	ಮಿಧವಾನ್
Mere	ಮೇರೆ
Raja	ರಾಜಾ
Azeem	ಅಜೀಂ
Hafeez	ಹಫೀಜ್
Chamara	ಚಮರ
Kapugedera	ಕಪುಗೆದೆರಾ
Mudra	ಮುದ್ರಾ
Communications	ಕಮ್ಯುನಿಕೇಶನ್ಸ್
Sunil	ಸುನಿಲ್
Gavaskar	ಗಾವಸ್ಕರ್
The	ದ
times	ಟೈಮ್ಸ್
of	ಆಫ್
india	ಇಂಡಿಯಾ
Bahadur	ಬಹಾದುರ್
Tandilat	ತಂದಿಲತ್
Kalavati	ಕಲಾವತಿ
Mulshi	ಮುಲ್ಶೀ
Dam	ಡ್ಯಾಮ್
Cowan	ಕೋವನ್
University	ಯುನಿವರ್ಸಿಟಿ
Abhijit	ಅಭಿಜಿತ್
Kale	ಕಾಳೆ
Annis	ಅನ್ನಿಸ್
Peter	ಪೀಟರ್
and	ಅಂಡ್
paul	ಪಾಲ್
fortress	ಫೋರ್ಟ್‌ರೆಸ್
Trishagni	ತ್ರಿಶಾಗ್ನಿ
Intizar	ಇಂತಿಜಾರ್
Arkan	ಅರ್ಕಾನ್
Vachel	ವಚೆಲ್
Pooran	ಪೂರಣ್
Uinta	ಯೂನಿಟಾ
Steffi	ಸ್ಟೆಫಿ
Manoratha	ಮನೋರಥ
Jayant	ಜಯಂತ್
Him	ಹಿಮ್
Achindra	ಅಚಿಂದ್ರ
Sansar	ಸನ್ಸಾರ್
Wajahat	ವಜಾಹತ್
Irshad	ಇರ್ಷಾದ್
Carborundum	ಕಾರ್ಬೋರಂಡಮ್
Filia	ಫಿಲಿಯಾ
Guadeloupe	ಗುವಾಡೆಲೌಪಿ
Rishiyaketu	ಋಷ್ಯಕೇತು
Thames	ಥೇಮ್ಸ್
Lahore	ಲಾಹೋರ್
Boston	ಬೋಸ್ಟನ್
jive	ಜಿವಿ
Sasun	ಸಸನ್
Drugs	ಡ್ರಗ್ಸ್
and	ಅಂಡ್
Chemicals	ಕೆಮಿಕಲ್ಸ್
Grinham	ಗ್ರಿನ್‌ಹ್ಯಾಮ್
Sardana	ಸರದಾನಾ
Alarice	ಅಲರಿಸ್
Thurnwald	ತುರ್ನ್‌ವಾಲ್ಡ್
Abhilasahaa	ಅಭಿಲಾಷಾ
Sandhya	ಸಂಧ್ಯಾ
Chhaya	ಛಾಯಾ
Skyscraper	ಸ್ಕೈಸ್ಕ್ರಾಪರ್
Museum	ಮ್ಯೂಸಿಯಂ
Devashish	ದೇವಶೀಶ್
Aap	ಆಪ್
To	ತೊ
Aise	ಐಸೆ
Na	ನಾ
The	ಥೆ
Zeenat	ಜೀನತ್
Lamb	ಲಾಂಬ್
Aravankadu	ಅರವನ್‌ಕಾಡು
Dan	ಡ್ಯಾನ್
Quayle	ಕ್ವಾಯ್ಲೇ
Sheila	ಶೀಲಾ
Akash	ಆಕಾಶ್
Grizelda	ಗ್ರಿಜೆಲ್ಡಾ
Dexia	ಡೆಕ್ಸ್ಯಾ
Group	ಗ್ರೂಪ್
Uttara	ಉತ್ತರ
Choti	ಚೋಟಿ
Khatu	ಖಟು
Memorial	ಮೆಮೋರಿಯಲ್
Cup	ಕಪ್
Aajaad	ಆಜಾದ್
Viraag	ವಿರಾಗ್
Maleehah	ಮಾಲಿಹಾ
Sunetra	ಸುನೇತ್ರ
Stolt-Nielsen	ಸ್ಟಾಲ್ಟ್-ನೀಲ್ಸನ್
Zurna	ಜುರ್ನಾ
Bikram	ಬಿಕ್ರಂ
Aandhiyan	ಆಂಧಿಯಾಂ
Charlene	ಚಾರ್ಲಿನ್
Barsat	ಬರಸಾತ್
Ki	ಕೀ
Raat	ರಾತ್
Chatpati	ಚಟಪಟೀ
Sawini	ಸಾವಿನಿ
Gokul	ಗೋಕುಲ್
Varyag	ವಾರ್ಯಗ್
Saat	ಸಾತ್
Bijliyan	ಬಿಜಲಿಯಾ
Bajrang	ಬಜರಂಗ್
Prem	ಪ್ರೇಮ್
Chetar	ಚೆತಾರ್
Mohinder	ಮೊಹಿಂದರ್
Amarnath	ಸಿಂಗ್
Shajee	ಶಾಜೀ
Niles	ನೈಲ್ಸ್
Adelie	ಅಡೆಲೀ
Wilkinson	ವಿಲ್ಕಿನ್ಸನ್
Cyber	ಸೈಬರ್
Museum	ಮ್ಯೂಜಿಯಂ
Rajpal	ರಾಜ್‌ಪಾಲ್
Kharad	ಖರಡ್
Mexican	ಮೆಕ್ಸಿಕನ್
Order	ಆರ್ಡರ್
of	ಆಫ್
the	ದ
Aztec	ಆಝ್ಟೆಕ್
Eagle	ಈಗಲ್
Bishop	ಬಿಶಪ್
Upasana	ಉಪಾಸನಾ
Ananga	ಅನಂಗ
Beena	ಬೀನಾ
Panna	ಪನ್ನಾ
Dai	ದಾಯಿ
Nuncio	ನುನ್ಸಿಯೊ
Chekitan	ಚಕೇತನ್
NASA	ನಾಸಾ
Centennial	ಸೆಂಟೇನಿಯಲ್
Challenges	ಚಾಲೆಂಜೆಸ್
Macmillan	ಮ್ಯಾಕ್‌ಮಿಲನ್
Andie	ಆಂಡೀ
July	ಜುಲೈ
Raghunaath	ರಘುನಾಥ
Ayachit	ಆಯಾಚಿತ್
Isanne	ಇಸೇನ್
Fatehpur	ಫತೇಪುರ್
Sekhawati	ಶೆಖಾವತಿ
Fort	ಫೋರ್ಟ್
randall	ರಾಂಡೆಲ್
Christy	ಕ್ರಿಸ್ಟಿ
Magan	ಮಗನ್
Conner	ಕಾನರ್
Sumita	ಸುಮಿತಾ
Bruce	ಬ್ರೂಸ್
French	ಫ್ರೆಂಚ್
Connor	ಕಾನರ್
Utpala	ಉತ್ಪಲ
Dohrighat	ದೋಹ್ರಿಘಾಟ್
Lathrop	ಲಾಥರೊಪ್
VistaPrint	ವಿಸ್ಟಾಪ್ರಿಂಟ್
Limited	ಲಿಮಿಟೆಡ್
Pugree	ಪಗಡೀ
Apna	ಅಪ್ನಾ
Desh	ದೇಶ್
Tahir	ತಾಹಿರ್
Khan	ಖಾನ್
Aanand	ಆನಂದ್
Bhongir	ಭೋಂಗಿರ್
Raviprabha	ರವಿಪ್ರಭಾ
Oriental	ಓರಿಯಂಟಲ್
Hotels	ಹೋಟೆಲ್ಸ್
Pati	ಪತಿ
Patni	ಪತ್ನಿ
Sadoof	ಸದೂಫ್
Cerebus	ಸೆರೀಬಸ್
Attila	ಅಟ್ಟಿಲಾ
Jozsef	ಜೋಸೆಫ್
Prize	ಪ್ರೈಜ್
Lucy	ಲೂಸಿ
Dustin	ಡಸ್ಟಿನ್
Middle	ಮಿಡಲ್
Fail	ಫೈಲ್
Celtic	ಸೆಲ್ಟಿಕ್
Conlan	ಕಾನ್ಲಾನ್
Nartaki	ನರ್ತಕಿ
Adolph	ಅಡಾಲ್ಫ್
University	ಯುನಿವರ್ಸಿಟಿ
of	ಆಫ್
Canterbury	ಕ್ಯಾಂಟರ್‌ಬರಿ
Fort	ಫೋರ್ಟ್
santo	ಸ್ಯಾಂಟೊ
domingo	ಡೊಮಿಂಗೊ
Lance	ಲ್ಯಾನ್ಸ್
Gibbs	ಗಿಬ್ಸ್
Steve	ಸ್ಟೀವ್
Rhodes	ರೋಡ್ಸ್
Willard	ವಿಲ್ಲಾರ್ಡ್
Karnataka	ಕರ್ನಾಟಕ
Bhuranyu	ಭೂರಣ್ಯು
Torrance	ಟೋರೆನ್ಸ್
Saint	ಸೆಂಟ್
Stephen's	ಸ್ಟೀಫನ್ಸ್
School,	ಸ್ಕೂಲ್,
Chandigarh	ಚಂಡೀಗಢ್
The	ದಿ
tyne	ಟೈನಿ
turrets	ಟುರೆಟ್ಸ್
Jayeshvar	ಜಯೇಶ್ವರ್
Endesa	ಎಂಡೆಸಾ
Barzah	ಬಾರ್ಜಾ
Yaachanaa	ಯಾಚನಾ
Chalu	ಚಾಲೂ
Mera	ಮೇರಾ
Naam	ನಾಮ್
Koyna	ಕೊಯ್ನಾ
Amar	ಅಮರ್
Saigal	ಸೈಗಲ್
Order	ಆರ್ಡರ್
of	ಆಫ್
Aviz	ಅವಿಜ್
Bhatpur	ಭಟ್‌ಪುರ್
Cruybeke	ಕ್ರ್ಯುಬೆಕೆ
Hanin	ಹನೀನ್
Gunahon	ಗುನಾಹೋ
Ka	ಕಾ
Faisla	ಫೈಸಲಾ
George	ಜಾರ್ಜ್
Gallop	ಗ್ಯಾಲೋಪ್
Saad	ಸಾದ್
Glad	ಗ್ಲಾಡ್
Tidings	ಟೈಡಿಂಗ್ಸ್
Lauwershoek	ಲಾವರ್‌ಶೋಕ್
Awaaz	ಆವಾಜ್
Rajgad	ರಾಜ್‌ಗಢ್
fort	ಫೋರ್ಟ್
Fort	ಫೋರ್ಟ್
hunt	ಹಂಟ್
Jamison	ಜಮಿಸನ್
Fighter	ಫೈಟರ್
Sheila	ಶೀಲಾ
Aparaajit	ಅಪರಾಜಿತ್
Central	ಸೆಂಟ್ರಲ್
Japan	ಜಪಾನ್
Railway	ರೈಲ್ವೇ
Abrash	ಅಬ್ರಾಶ್
Baariq	ಬಾರಿಖ್
Cleo	ಕ್ಲಿಯೋ
Muftee	ಮುಫ್ತೀ
Triyama	ತ್ರಿಯಂಬಾ
Pardesi	ಪರದೇಸೀ
Saiyaan	ಸೈಯ್ಯಾನ್
Ek	ಏಕ್
Bechara	ಬೆಚಾರಾ
David	ಡೇವಿಡ್
Terbrugge	ಟರ್ಬ್ರಗ್
Astatine	ಆಸ್ಟಾಟಿನ್
Shin	ಶಿನ್
Kong	ಕಾಂಗ್
Life	ಲೈಫ್
Tower	ಟವರ್
Saint	ಸೆಂಟ್
Joseph's	ಜೋಸೆಫ್ಸ್
Boys'	ಬಾಯ್ಸ್
High	ಹೈ
School,	ಸ್ಕೂಲ್,
Bangalore	ಬೆಂಗಳೂರು
Pulu	ಪುಲು
Keeling	ಕೀಲಿಂಗ್
South	ಸೌತ್
Seminole	ಸೆಮಿನೋಲ್
Baptist	ಬ್ಯಾಪ್ಟಿಸ್ಟ್
Gloria	ಗ್ಲೋರಿಯಾ
Hills	ಹಿಲ್ಸ್
Lumshnong	ಲಂಶ್ನಾಂಗ್
village	ವಿಲೇಜ್
Dorpveld	ಡಾರ್ಪ್‌ವೆಲ್ಡ್
Depinder	ದಿಪಿಂದರ್
Mevan	ಮೇವನ್
Pieris	ಪೀರಿಸ್
Tyger	ಟೈಗರ್
Vishalakshi	ವಿಶಾಲಾಕ್ಷಿ
Dharmendra	ಧರ್ಮೇಂದ್ರ
Sileas	ಸಿಲಿಯಸ್
Lago	ಲಾಗೊ
de	ಡಿ
Camecuaro	ಕ್ಯಾಮಿಕ್ಯುವಾರೋ
Khanduja	ಖಂಡುಜಾ
Manal	ಮನಲ್
Jorjanna	ಜೋರ್ಜನ್ನಾ
Out	ಔಟ್
crossing	ಕ್ರಾಸಿಂಗ್
Chaneti	ಚನೆಟೀ
Lyris	ಲಿರಿಸ್
Novorossysk	ನೊವೊರೋಸ್ಕ್
Vicki	ವಿಕಿ
Argonia	ಅರ್ಗೋನಿಯಾ
Friends	ಫ್ರೆಂಡ್ಸ್
Eads	ಈಡ್ಸ್
Purana	ಪುರಾನಾ
quila	ಕಿಲಾ
Niket	ನಿಕೆತ್
Adgaon	ಅದಗಾಂವ್
Buzurg	ಬುಜುರ್ಗ್
Ramnaresh	ರಾಮನರೇಶ್
Sarwan	ಶರವಣ್
Vangie	ವಂಗೀ
Bajrangbali	ಬಜರಂಗಬಲಿ
Palkon	ಪಲಕೋ
Ki	ಕಿ
Chhaon	ಛಾವ್
Mein	ಮೇ
Daamin	ದಾಮನ್
Boncelles	ಬೋನ್ಸೆಲ್ಲಿಸ್
fort	ಫೋರ್ಟ್
Bayana	ಬಯಾನಾ
Junction	ಜಂಕ್ಷನ್
Baddhni	ಬದ್ಧನಿ
Kingston	ಕಿಂಗ್‌ಸ್ಟನ್
University	ಯುನಿವರ್ಸಿಟಿ
of	ಆಫ್
Colorado	ಕೊಲರೆಡೊ
Dionysus	ಡಿಯೊಸಸ್
Hickory	ಹಿಿಕೋರಿ
Street	ಸ್ಟ್ರೀಟ್
Presbyterian	ಪ್ರೆಸ್ಬಿಟೇರಿಯನ್
Fort	ಫೋರ್ಟ್
duquesne	ಡುಕ್ವೆನ್ಸ್
Barry	ಬ್ಯಾರಿ
Manilow	ಮೆನಿಲೋ
Subarna	ಸುಬರ್ನಾ
Mahal	ಮಹಲ್
Mahak	ಮಹಕ್
Brazzaville	ಬ್ರಾಝಾವಿಲ್ಲೆ
Ula	ಉಲಾ
Rodeo	ರೋಡಿಯೊ
Jai	ಜೈ
Bangladesh	ಬಾಂಗ್ಲಾದೇಶ್
Hamid	ಹಮೀದ್
Duty	ಡ್ಯೂಟಿ
Dhaman	ಧಮನ್
Suez	ಸುಯೆಜ್
Canal	ಕೆನೆಲ್
Dameer	ದಮೀರ್
Grahasthi	ಗೃಹಸ್ಥಿತಿ
Cittern	ಸಿಟನ್
Pable	ಪಬ್ಲೆ
Kandhari	ಕಂಧಾರಿ
First	ಫಸ್ಟ್
Canadian	ಕೆನಿಡಿಯನ್
Place	ಪ್ಲೇಸ್
Cape	ಕೇಪ್
Flattery	ಫ್ಲಾಟರಿ
Chand	ಚಂದ್
Fionn	ಫಿಯೋನ್
Dhillon	ಢಿಲ್ಲೋ
Purna	ಪೂರ್ಣ
Dhoraji	ಧೋರಾಜಿ
Durgaaprasaad	ದುರ್ಗಾಪ್ರಸಾದ್
Kootenay	ಕೂಟೆನೆ
Fort	ಫೋರ್ಟ್
saint	ಸೆಂಟ್
john	ಜಾನ್
Amlakhurd	ಅಮ್ಲಾಖುರ್ದ್
Shaheed	ಶಹೀದ್
Bhagat	ಭಗತ್
Singh	ಸಿಂಗ್
Bukit	ಬುಕಿತ್
Barisan	ಬರಿಸನ್
Selatan	ಸೆಲತಾನ್
Main	ಮೈ
Tera	ತೇರಾ
Dushman	ದುಶ್ಮನ್
Saarangapaani	ಸಾರಂಗಪಾಣಿ
Akarshan	ಆಕರ್ಷಣ್
Betavad	ಬೆತಾವಡ್
Bakarah	ಬಕರಾ
Chandel	ಚಂದೇಲ್
Char	ಚಾರ್
Diwari	ದಿವಾರೀ
Shaque	ಶಕ್
Umberto	ಅಂಬರ್ಟೋ
Conakry	ಕೊನಾಕ್ರಿ
Karik	ಕೇರಿಕ್
Rowing	ರೋಯಿಂಗ್
Sumatra	ಸುಮಾತ್ರಾ
Coldstream	ಕೋಲ್ಡ್‌ಸ್ಟ್ರೀಮ್
Museum	ಮ್ಯೂಸಿಯಂ
Dasharh	ದಶರಾ
Gaston	ಗ್ಯಾಸ್ಟನ್
Gorana	ಗೋರಾನಾ
Rameshwaram	ರಾಮೇಶ್ವರಂ
Adolfo	ಆಡಾಲ್ಫೋ
Chakra	ಚಕ್ರ
Zinc	ಝಿಂಕ್
Rohan	ರೋಹನ್
Dayanand	ದಯಾನಂದ
Speranza	ಸ್ಪೆರಾಂಜ
Muneer	ಮುನೀರ್
Ramkumar	ರಾಮಕುಮಾರ್
Kaun	ಕೌನ್
Saccha	ಸಚ್ಚಾ
Kaun	ಕೌನ್
Jhootha	ಝೂಠಾ
Badnaam	ಬದನಾಮ್
Basti	ಬಸ್ತೀ
Saajan	ಸಾಜನ್
Ka	ಕಾ
Ghar	ಘರ್
Dakor	ಡಾಕೊರ್
Chuck	ಚಕಲುಕಾ
21	21
Century	ಸೆಂಚುರಿ
Tower	ಟವರ್
Fort	ಫೋರ್ಟ್
bliss	ಬ್ಲಿಸ್
Dalpatpur	ದಲಪತ್‌ಪುರ್
John	ಜಾನ್
Lanen	ಲೇನೆನ್
Tino	ಟಿನೋ
Best	ಬೆಸ್ಟ್
Ghumaysa	ಗುಮಾಯಸ
Zakhmi	ಜಖ್ಮೀ
Zameen	ಜಮೀನ್
Jaegar	ಜೆಗರ್
Sristi	ಸೃಷ್ಟಿ
Carmel	ಕಾರ್ಮೆಲ್
Convent	ಕಾನ್ವೆಂಟ್
School,	ಸ್ಕೂಲ್,
Chanakya	ಚಾಣಕ್ಯಾ
Puri	ಪುರಿ
Bhapa	ಭಾಪಾ
Chhota	ಛೋಟಾ
Baap	ಬಾಪ್
Fort	ಫೋರ್ಟ್
ronduit	ರಾಂಡ್ಯೂಟ್
Sati	ಸತಿ
Seeta	ಸೀತಾ
Prabhsimran	ಪ್ರಭಸಿಮ್ರನ್
Gohana	ಗೋಹನಾ
Harbhajan	ಹರ್ಭಜನ್
Singh	ಸಿಂಗ್
Athula	ಅತುಲ
Samarasekera	ಸಮರಶೇಖರ
Vinnie	ವಿನೀ
Lalithamana	ಲಲಿತಮನ
Fernando	ಫರ್ನಾಂಡೊ
Jyotishpur	ಜ್ಯೋತಿಷ್ಪುರ
Oliver	ಓಲಿವರ್
North	ನಾರ್ಥ್
Declan	ಡೆಕ್ಲೇನ್
Ura	ಉರಾ
Geoff	ಜಿಯೋಫ್
Dymock	ಡೈಮಾಕ್
Burhar	ಬುರಹಾರ್
Sanjhi	ಸಾಂಝಿ
Filler	ಫಿಲ್ಲರ್
Sati	ಸತಿ
Ahilya	ಅಹಿಲ್ಯಾ
Takhat	ತಖ್ತ್
Shri	ಶ್ರೀ
Akal	ಅಕಾಲ್
Takhat	ತಖ್ತ್
Sahib,	ಸಾಹಿಬ್,
Amritsar	ಅಮೃತಸರ
(Punjab)	(ಪಂಜಾಬ್)
Nayan	ನಯನ್
Mongia	ಮೋಗಿಂಯಾ
Patrick	ಪ್ಯಾಟ್ರಿಕ್
French	ಫ್ರೆಂಚ್
Akira	ಅಕಿರಾ
Guriya	ಗುರಿಯಾ
Albert	ಅಲ್ಬರ್ಟ್
Providence	ಪ್ರಾವಿಡೆನ್ಸ್
Fionnula	ಫಿಯೋನ್ಯೂಲಾ
Darla	ದಾರ್ಲಾ
Shree	ಶ್ರೀ
Lamba	ಲಾಂಬಾ
Vatika	ವಾಟಿಕಾ
Duilio	ಡ್ಯುಲಿಯೊ
Aag	ಆಗ್
Ka	ಕಾ
Toofan	ತೂಫಾನ್
Tiruvattar	ತಿರುವತ್ತಾರ್
Asansol	ಅಸನ್ಸೋಲ್
Junction	ಜಂಕ್ಷನ್
Medal	ಮೆಡಲ್
of	ಆಫ್
the	ದ
Order	ಆರ್ಡರ್
of	ಆಫ್
Merit	ಮೆರಿಟ್
for	ಫಾರ್
the	ದ
Fatherland	ಫಾದರ್‌ಲ್ಯಾಂಡ್
Toulouse-Blagnac	ಟೂಲೌಸ್-ಬ್ಲಾಗ್ನಾಕ್
Fauve	ಫಾವ್
Nadirah	ನದಿರಾ
Ladki	ಲಡಕಿ
Jalilah	ಜಲೀಲಾ
Rajni	ರಜನಿ
raja	ರಾಜ
Godfrey	ಗಾಡ್‌ಫ್ರೇ
Adrian	ಅಡ್ರಿಯಾನ್
Kuiper	ಕೀಪರ್
Jiten_dr	ಜಿತೇಂದ್ರ್
Bank	ಬ್ಯಾಂಕ್
of	ಆಫ್
Punjab	ಪಂಜಾಬ್
Pyar	ಪ್ಯಾರ್
Ka	ಕಾ
Sindoor	ಸಿಂದೂರ್
Dashavtar	ದಶಾವತಾರ್
Cinnamon	ಸಿನಮೊನ್
Buran	ಬುರಾನ್
Ammiraglio	ಅಮಿರಾಗ್ಲಿಯೊ
di	ಡಿ
Saint	ಸೈಂಟ್
Bon	ಬೊನ್
Mohammad	ಮೊಹಮ್ಮದ್ ಇಕ್ಬಾಲ್
SunOpta	ಸನ್‌ಓಪ್ಟಾ
Fort	ಫೋರ್ಟ್
ligonier	ಲಿಗೊನಿರ್
Maqsood	ಮಕ್ಸೂದ್
Rana	ರಾಣಾ
Phil	ಫಿಲ್
Carlson	ಕಾರ್ಲಸನ್
Sibley	ಸಿಬ್ಲೆ
Seaborgium	ಸೀಬೋರ್ಗಿಯಂ
Ramcoind	ರಾಮ್ಕೊಇಂಡ್
Flo	ಫ್ಲೊ
Tatini	ತತಿನಿ
Booker	ಬೂಕರ್
Prize	ಪ್ರೈಜ್
Buddha	ಬುಡ್ಢಾ
Mil	ಮಿಲ್
Gaya	ಗಯಾ
Emanuele	ಇಮ್ಯಾನ್ಯುಯಲ್
Filiberto	ಫಿಲಿಬೆರ್ಟೋ
Nadeem	ನದೀಮ್
Satyamurti	ಸತ್ಯಮೂರ್ತಿ
Mariska	ಮ್ಯಾರಿಸ್ಕಾ
Stuart	ಸ್ಟುವರ್ಟ್
Matsikenyeri	ಮಾಟ್ಸಿಕೆನ್ಯರಿ
Bhimavaram	ಭೀಮಾವರಂ
Junction	ಜಂಕ್ಷನ್
Shoshone	ಶೋಶೋನೆ
Sanghera	ಸಂಘೆರಾ
Tonganoxie	ಟೋಂಗನೋಕ್ಸಿ
Christian	ಕ್ರಿಶ್ಚಿಯನ್
Ali	ಅಲಿ
Dasuya	ದಸುಯಾ
Bard	ಬರ್ದ್
Sergio	ಸೆರ್ಗಿಯೋ
Ala	ಅಲಾ
Zea	ಜಿಯಾ
Amaanaath	ಅಮಾನಾಥ್
Bansipur	ಬನ್ಸಿಪುರ್
Majarooh	ಮಜರೂಹ್
Sultan	ಸುಲ್ತಾನ್
Amitaa	ಅಮಿತಾ
Whittaker	ವ್ಹಿಟ್ಟಾಕರ್
Devta	ದೇವತಾ
Veenapani	ವೀಣಾಪಾಣಿ
Josephat	ಜೊಸೆಫಟ್
Ababu	ಅಬಬು
Cassandra	ಕೆಸಾಂಡ್ರಾ
Bongaigaon	ಬೊಂಗೈಗಾಂವ್
Mutayyib	ಮುತಾಯ್ಯಿಬ್
Queen	ಕ್ವೀನ್
Cleopatra	ಕ್ಲಿಯೋಪಾತ್ರಾ
Saifun	ಸೈಫುನ್
Semiconductors	ಸೆಮಿಕಂಡಕ್ಟರ್ಸ್
Puneet	ಪುನೀತ್
Garmin	ಗಾರ್ಮಿನ್
Rangana	ರಂಗನಾ
Devang	ದೇವಾಂಗ್
Gandhi	ಗಾಂಧಿ
Wireless	ವೈರ್‌ಲೆಸ್
Museum	ಮ್ಯೂಸಿಯಂ
Ronat	ರೋನತ್
Sindoor	ಸಿಂದೂರ್
Ka	ಕಾ
Daan	ದಾನ್
Omana	ಓಮನ
Goraul	ಗೋರಾಲ್
Billo	ಬಿಲ್ಲೋ
Badshah	ಬಾದಶಾಹ್
Sangari	ಸಂಗಾರಿ
Jwala	ಜ್ವಾಲಾ
Daku	ಡಾಕೂ
Bahut	ಬಹುತ್
Din	ದಿನ್
Hue	ಹುಯೆ
Dard	ದರ್ದ್
Kaushal	ಕೌಶಲ್
Lokuarachchi	ಲೋಕರಚ್ಚಿ
Vanaja	ವನಜಾ
Euridice	ಯ್ಯುರಿಡೈಸ್
Major	ಮೇಜರ್
League	ಲೀಗ್
Lacrosse	ಲಾಕ್ರೊಸ್
Offensive	ಅಫೆನ್ಸಿವ್
player	ಪ್ಲೇಯರ್
of	ಆಫ್
the	ದ
Year	ಈಯರ್
Award	ಅವಾರ್ಡ್
Gavotte	ಗವೋಟ್ಟೆ
Sheesha	ಶೀಶಾ
Nilagriv	ನೀಲಗ್ರೀವ್
Chakravarty	ಚಕ್ರವರ್ತಿ
Rajagopalachari	ರಾಜಗೋಪಾಲಚಾರಿ
Amanda	ಅಮಂಡಾ
Rasili	ರಸೀಲೀ
Patthar	ಪತ್ಧರ್
Ki	ಕಿ
Lakeer	ಲಕೀರ್
Hasantha	ಹಸಂತಾ
Fernando	ಫರ್ನಾಂಡೊ
Indrapriya	ಇಂದ್ರಪ್ರಿಯ
Aruppukottai	ಅರುಪ್ಪುಕೋಟೈ
Paul	ಪೌಲ್
Newman	ನ್ಯೂಮ್ಯಾನ್
Aspasia	ಆಸ್ಪೇಶಿಯಾ
Ninon	ನಿನಾನ್
Kamakshi	ಕಾಮಾಕ್ಷಿ
Amman	ಅಮ್ಮನ್
Cassia	ಕೇಸಿಯಾ
Sajidah	ಸಾಜಿದಾ
Pearly	ಪರ್ಲಿ
Petronas	ಪೆಟ್ರೋನಾಸ್
Tower	ಟವರ್
2	2
Nashtar	ನಶ್ತರ್
Vikraant	ವಿಕ್ರಾಂತ್
Parakh	ಪರಖ್
Anantram	ಅನಂತ್‌ರಾಮ್
Royal	ರಾಯಲ್
Ahold	ಅಹೋಲ್ಡ್
Aakarshan	ಆಕರ್ಷಣ್
Viklav	ವಿಕ್ಲವ್
Begam	ಬೇಗಮ್
Akhtar	ಅಖ್ತರ್
Shobna	ಶೋಬನಾ
Ela	ಇಳಾ
Mathmesh	ಮಥಮೇಶ್
Commencement	ಕಮೆನ್ಸ್‌ಮೆಂಟ್
Bay	ಬೇ
Atiya	ಅತಿಯಾ
Sadhu	ಸಾಧೂ
Aur	ಔರ್
Shaitan	ಶೈತಾನ್
Bunker	ಬಂಕರ್
Hill	ಹಿಲ್
Muhtadi	ಮುಹತಾದಿ
Bhumika	ಭೂಮಿಕಾ
Oliver	ಓಲಿವರ್
Stone	ಸ್ಟೋನ್
Bata	ಬಾಟಾ
drums	ಡ್ರಮ್ಸ್
Stu	ಸ್ಟು
Roberts	ರಾಬರ್ಟ್ಸ್
Guenevere	ಗುಯೆನವೆರ್
Kallima	ಕಾಲಿಮಾ
Iraq	ಇರಾಕ್
Jaisalmer	ಜೈಸಲ್ಮೇರ್
fort	ಫೋರ್ಟ್
Madhu	ಮಧು
Bansari	ಬನ್ಸಾರಿ
Baalee	ಬಾಲೀ
Ranjanee	ರಂಜನೀ
Jai	ಜೈ
Mahalaxmi	ಮಹಾಲಕ್ಷ್ಮಿ
Actions	ಆಕ್ಷನ್ಸ್
Semiconductor	ಸೆಮಿಕಂಡಕ್ಟರ್
Omkar	ಓಂಕಾರ್
Mahabahu	ಮಹಾಬಾಹು
Balagopal	ಬಾಲಗೋಪಾಲ್
Masrur	ಮಸ್ರೂರ್
Mellette	ಮೆಲೆಟ್
Tahseen	ತಹಸಿನ್
Nadiyah	ನದಿಯಾ
Nadalia	ನಡಾಲಿಯಾ
American	ಅಮೇರಿಕನ್
Legion	ಲಿಜನ್
Mukut	ಮುಕುಟ್
Jharna	ಝರನಾ
Sunflag	ಸನ್‌ಫ್ಲ್ಯಾಗ್
Iron	ಐರನ್
Junayd	ಜುನಾಯದ್
Mukul	ಮುಕುಲ್
Janan	ಜನನ್
Tarala	ತರಲಾ
Khalidah	ಖಲೀದಾ
Fort	ಫೋರ್ಟ್
cartwright	ಕಾರ್ಟ್‌ವ್ರಿಟ್
Dhwani	ಧ್ವಾನೀ
Fort	ಫೋರ್ಟ್
scott	ಸ್ಕಾಟ್
Paapi	ಪಾಪಿ
Pet	ಪೇಟ್
Ka	ಕಾ
Sawal	ಸವಾಲ್
Hai	ಹೈ
Vedi	ವೇದಿ
Baghauli	ಬಾಗೌಲಿ
Darren	ಡರೆನ್
Gough	ಗೌ
Pyar	ಪ್ಯಾರ್
Karke	ಕರಕೆ
Dekho	ದೇಖೋ
Sen	ಸೆನ್
Crossroads	ಕ್ರಾಸ್‌ರೋಡ್ಸ್
Christian	ಕ್ರಿಶ್ಚಿಯನ್
Center	ಸೆಂಟರ್
Lanza	ಲಂಜಾ
Dayle	ಡೇಯ್ಲ್
Hadlee	ಹ್ಯಾಡ್ಲೀ
Fort	ಫೋರ್ಟ್
efford	ಎಫರ್ಡ್
Araria	ಅರಾರಿಯಾ
University	ಯುನಿವರ್ಸಿಟಿ
of	ಆಫ್
Sunderland	ಸುಂದರ್ಲೇಂಡ್
Dalal	ದಲಾಲ್
Dhvani	ಧ್ವಾನಿ
Pulakit	ಪುಳಕಿತ್
Sihlsee	ಸಿಲ್‌ಸೀ
Claude	ಕ್ಲಾಡ್
Henderson	ಹೆಂಡರ್ಸನ್
Mrage^dr	ಮೃಗೇಂದ್ರ
Pocket	ಪಾಕೆಟ್
Maar	ಮಾರ್
Saroja	ಸರೋಜ
Parolkar	ಪರೋಲ್ಕರ್
Vaaditaa	ವಾದಿತ
Vaadkar	ವಾಡ್ಕರ್
Shane	ಶೇನ್
Watson	ವ್ಯಾಟ್ಸನ್
Gumrah	ಗುಮರಾಹ್
Medals	ಮೆಡಲ್
of	ಆಫ್
Honor	ಆನರ್
Mahatma	ಮಹಾತ್ಮಾ
Kabir	ಕಬೀರ್
Shan	ಶಾನ್
Creek	ಕ್ರೀಕ್
Community	ಕಮ್ಯೂನಿಟಿ
Bible	ಬೈಬಲ್
Mohita	ಮೊಹಿತಾ
Taruni	ತರುಣಿ
Main	ಮೈ
Bhi	ಭೀ
Ladki	ಲಡಕೀ
Hoon	ಹೂ
Corgi	ಕಾರ್ಗಿ
International	ಇಂಟರ್ನ್ಯಾಷನಲ್
Limited	ಲಿಮಿಟೆಡ್
Vietnam	ವಿಯೆಟ್ನಾಂ
Supriy	ಸುಪ್ರಿಯ
Ryanair	ರಾಯನೇರ್
Holdings	ಹೋಲ್ಡಿಂಗ್ಸ್
Xander	ಜಂಡರ್
Rishta	ರಿಶ್ತಾ
Hum	ಹಮ್
Nahin	ನಹೀ
Jhukenge	ಝುಕೇಂಗೆ
Erv	ಎರ್ವ್
Liyaakat	ಲಿಯಾಕತ್
Holly	ಹಾಲಿ
Hunter	ಹಂಟರ್
Matkari	ಮಾಟ್ಕಾರಿ
Nasser	ನಾಸಿರ್
Hussain	ಹುಸೇನ್
Massena	ಮಸೆನ್ನಾ
Abhimaan	ಅಭಿಮಾನ್
Dindigul	ದಿಂಡಿಗಲ್
Mannar	ಮನ್ನಾರ್
Thirumalai	ತಿರುಮಲೈ
Baaghi	ಬಾಗೀ
Gandharva	ಗಂಧರ್ವಾ
Teertha	ತೀರ್ಥಾ
Sao	ಸಾ
Joaquim	ಜೊಕ್ಯುಮ್
Constellation	ಕಾನ್‌ಸ್ಟೆಲೇಶನ್
Boinda	ಬೊಯಿಂದಾ
Do	ದೋ
Bigha	ಬೀಘಾ
Zameen	ಜಮೀನ್
Angada	ಅಂಗದ
Gurneet	ಗುರುನೀತ್
Ram	ರಾಮ್
Ki	ಕಿ
Ganga	ಗಂಗಾ
Khoon	ಖೂನ್
Bhari	ಭರೀ
Maang	ಮಾಂಗ್
Thakare	ಥಾಕರೆ
Maria	ಮಾರಿಯಾ
Shriver	ಶ್ರಿವರ್
Payal	ಪಾಯಲ್
Elmo	ಎಲ್ಮೋ
Gautamee	ಗೌತಮಿ
Kashifah	ಕಶಿಫಾ
Azaraq	ಅಜರಕ್
Bhudhar	ಭೂಧರ್
William	ವಿಲಿಯಮ್
Shakespeare	ಶೇಕ್ಸ್‌ಪಿಯರ್
Hadee	ಹದೀ
Pethkar	ಪೇಠ್ಕರ್
Ogan	ಓಗಾನ್
Kusumaadhiraaj	ಕುಸುಮಾಧಿರಾಜ
Warren	ವಾರೆನ್
Stott	ಸ್ಕಾಟ್
Salamat	ಸಲಾಮತ್
Agam	ಆಗಮ್
Bill	ಬಿಲ್
Lawry	ಲಾರಿ
Tres	ಟ್ರೆಸ್
Garrafon	ಗರಾಫೊನ್
Bhagalpur	ಭಗಲ್ಪುರ್
Murray-Darling	ಮರ್ರೇ-ಡಾರ್ಲಿಂಗ್
Bhargavi	ಭಾರ್ಗವಿ
Upper	ಅಪ್ಪರ್
fort	ಫೋರ್ಟ್
garry	ಗ್ಯಾರಿ
Rhett	ರೇಟ್
Lexi	ಲೆಕ್ಸಿ
Alfonso	ಅಲ್ಫೋನ್ಸೋ
Fell	ಫೆಲ್
Harare	ಹರಾರೆ
Aventis	ಅವೆಂಟಿಸ್
Lynette	ಲಿನೆಟ್
Muheet	ಮುಹೀತ್
Keith	ಕೀತ್
Semple	ಸೆಂಪಲ್
Asghar	ಅಸ್ಗರ್
Pramada	ಪ್ರಮದಾ
Dakhla	ಡಖ್ಲಾ
Gurmura	ಗುರ್ಮುರಾ
Mokokchung	ಮೊಕೊಕ್ಚುಂಗ್
Vaishnodevi	ವೈಷ್ಣೋದೇವಿ
Costa	ಕೋಸ್ಟಾ
Rica	ರಿಕಾ
French	ಫ್ರೆಂಚ್
and	ಅಂಡ್
Indian	ಇಂಡಿಯನ್
War	ವಾರ್
Shintre	ಶಿಂತ್ರೆ
Trilochan	ತ್ರಿಲೋಕಚನ್
Mahasati	ಮಹಾಸತಿ
Tulsi	ತುಲಸಿ
Bhadraksha	ಭದ್ರಾಕ್ಷ
Laksha	ಲಕ್ಷಾ
New	ನ್ಯೂ
Jersey	ಜೆರ್ಸಿ
Clayton	ಕ್ಲೇಟನ್
Lambert	ಲಾಂಬರ್ಟ್
Bahu	ಬಹು
Begum	ಬೇಗಮ್
Neci	ನೇಕಿ
Arun	ಅರುಣ್
One	ಒನ್
Chase	ಚೇಸ್
Manhattan	ಮ್ಯಾನ್‌ಹಾಟನ್
Plaza	ಪ್ಲಾಜಾ
Aadityakeshav	ಆದಿತ್ಯಕೇಶವ್
Sugar	ಶುಗರ್
Bowie	ಬೋವಿ
Qaseem	ಖಾಸಿಂ
Qailah	ಕಿಲಾ
Louise	ಲ್ಯೂಯೀಸಿ
Baankebihari	ಬಾಂಕೆಬಿಹಾರಿ
Mashrafe	ಮಶ್ರೇಪ್
Mortaza	ಮೊರ್ಟಾಜಾ
Khandkar	ಖಂಡಕರ್
Whitfield	ವೈಟ್‌ಫೀಲ್ಟ್
Awaargi	ಆವಾರಗೀ
Mansoor	ಮನ್ಸೂರ್
Al	ಆಲ್
Hallaj	ಹಲ್ಲಜ್
Najmeddin	ನಜ್ಮೆದ್ದೀನ್
Kubra	ಕುಬ್ರಾ
Maqbul	ಮಖಬುಲ್
Marcantonio	ಮಾರ್ಕೆಂಟೋನಿಯೊ
Colonna	ಕೊಲೋನಾ
Jen	ಜೆನ್
Wilmarsdonck	ವಿಲ್ಮಾರ್ಸ್‌ಡಾಂಕ್
Sankalpa	ಸಂಕಲ್ಪಾ
Anthony	ಅಂಥೋನಿ
Abdul	ಅಬ್ದುಲ್
aleem	ಅಲೀಂ
Dammika	ಡಮ್ಮಿಕ
Prasad	ಪ್ರಸಾದ್
Pawan	ಪವನ್
Museum	ಮ್ಯೂಸಿಯಂ
of	ಆಫ್
African	ಆಫ್ರಿಕನ್
Art	ಆರ್ಟ್
Malayala	ಮಲಯಾಳ
manorama	ಮನೋರಮಾ
Dharmanand	ಧರ್ಮಾನಂದ್
Grawemeyer	ಗ್ರಾವೆಮೆಯರ್
Award	ಅವಾರ್ಡ್
Lev	ಲೆವ್
Lew	ಲೆವ್
Jaan	ಜಾನ್
Hatheli	ಹಥೇಲೀ
Pe	ಪೆ
Leu	ಲೇವ್
Ceri	ಸೆರಿ
China	ಚೀನಾ
Life	ಲೈಫ್
Insurance	ಇನ್ಷೂರೆನ್ಸ್
Raat	ರಾತ್
Ki	ಕೆ
Baat	ಬಾತ್
Hinduism	ಹಿಂದೂಯಿಸಂ
Nishad	ನಿಶಾದ್
Kala	ಕಾಲಾ
Pani	ಪಾನಿ
Umesh	ಉಮೇಶ್
Ab	ಅಬ್
Aayega	ಆಯೆಗಾ
Mazaa	ಮಝಾ
Cedi	ಸೆಡಿ
North	ನಾರ್ತ್
Sea	ಸೀ
Canal	ಕೆನೆಲ್
Saaz	ಸಾಜ್
Mummy	ಮಮ್ಮಿ
Daddy	ಡಾಡಿ
Jeanette	ಜೀನತ್
Galop	ಗ್ಯಾಲೊಪ್
Rahul	ರಾಹುಲ್
Dravid	ದ್ರಾವಿಡ್
Beri	ಬೆರಿ
Vaatve	ವಾಟವೆ
Beti	ಬೇಟಿ
Fort	ಫೋರ್ಟ್
frederick	ಫ್ರೆಡ್ರಿಕ್
Gerald	ಗೆರಾಲ್ಡ್
Peckover	ಪೆಕೋವರ್
Shwadhinota	ಶ್ವಾಡಿನೊಟಾ
Dibosh	ಡಿಬೋಶ್
Puroskar	ಪುರೊಸ್ಕಾರ್
Jayasinh	ಜಯಸಿಂಹ
Gurudwara	ಗುರುದ್ವಾರ
Bibhor	ಬಿಭೋರ್
Sahib	ಸಾಹಿಬ್
Saluja	ಸಲೂಜಾ
Bedi	ಬೇಡಿ
Gargekar	ಗಾರ್ಗೆಕರ್
Vishraant	ವಿಶ್ರಾಂತ್
Charles	ಚಾರ್ಲೆಸ್
Stark	ಸ್ಟಾರ್ಕ್
Draper	ಡ್ರಾಪರ್
Prize	ಪ್ರೈಜ್
Sahab	ಸಹಾಬ್
Titan	ಟೈಟನ್
Industries	ಇಂಡಸ್ಟ್ರೀಸ್
Dhanishta	ಧನಿಷ್ಠ
Jayanti	ಜಯಂತಿ
Ray	ರೇ
Charles	ಚಾರ್ಲ್ಸ್
Pratapgad	ಪ್ರತಾಪ್‌ಗಢ್
Sahim	ಸಹೀಮ್
Sahil	ಸಾಹಿಲ್
Aag	ಆಗ್
Ke	ಕಿ
Sholay	ಶೋಲೋ
Mangal	ಮಂಗಲ್
Pandey	ಪಾಂಡೆ
Neelanjan	ನೀಲಾಂಜನ್
Mawlana	ಮಾವ್ಲಾನಾ
Faizani	ಫೈಜಾನಿ
Pak	ಪಾಕ್
Daman	ದಾಮನ್
Graham	ಗ್ರಹಾಂ
Ford	ಫೋರ್ಡ್
David	ಡೇವಿಡ್
Smith	ಸ್ಮಿತ್
Nasamajh	ನಾಸಮಝಾ
Jeff	ಜೆಫ್
Midday	ಮಿಡ್‌ಡೇ
Multi	ಮಲ್ಟಿ
Davis	ಡೇವಿಸ್
Kossuth	ಕೋಸುತ್
Prize	ಪ್ರೈಜ್
Japan	ಜಪಾನ್
Post	ಪೋಸ್ಟ್
Gunah	ಗುನಾಹ್
Swiss	ಸ್ವಿಸ್
Reinsurance	ರಿಇನ್ಷೂರೆನ್ಸ್
Khushee	ಖುಷೀ
Chianki	ಛಿಯಾಂಕಿ
Trudy	ಟ್ರುಡಿ
Aviva	ಅವಿವಾ
Fort	ಫೋರ್ಟ್
san	ಸ್ಯಾನ್
felipe	ಫೆಲಿಪ್
Tilottama	ತಿಲೋತ್ತಮ
Wadech	ವಡೈಚ್
Dantewada	ಡಾಂಟೆವಾಡ
Aachaarynandana	ಆಚಾರ್ಯನಂದನಾ
Fields	ಫೀಲ್ಡ್ಸ್
Medal	ಮೆಡಲ್
Kahani	ಕಹಾನಿ
Kismat	ಕಿಸ್ಮತ್
Ki	ಕಿ
Visisht	ವಿಶಿಷ್ಟ್
Seva	ಸೇವಾ
Medal	ಮೆಡಲ್
Roy	ರಾಯ್
Honorary	ಹಾನರರಿ
Citizen	ಸಿಟಿಜನ್
of	ಆಫ್
the	ದ
United	ಯುನೈಟೆಡ್
States	ಸ್ಟೇಟ್ಸ್
Kiev	ಕೀವ್
Zahid	ಝಹೀದ್
Razzak	ರಜಾಕ್
Allahabad	ಅಲ್ಲಾಹಾಬಾದ್
Bank	ಬ್ಯಾಂಕ್
Sevilla	ಸೆವಿಲ್ಲಾ
Southern	ಸದರ್ನ್
Petrochem	ಪೆಟ್ರೋಕೆಮ್
Salado	ಸಲಾಡೊ
Bryant	ಬ್ರ್ಯಾಂಟ್
Aarohan	ಆರೋಹಣ್
Mutazah	ಮುತಾಝಾ
Viplav	ವಿಪ್ಲವ
Arnold	ಆರ್ನಾಲ್ಡ್
Schwarzenegger	ಶ್ವಾಜನೆಗರ್
Rawdah	ರಾವದಾ
Cantara	ಕೆಂಟಾರಾ
Orbotech	ಆರ್ಬೋಟೆಕ್
Huzayl	ಹುಜಯಾಲ್
Vaad	ವಾಡ್
Atish	ಆತಿಷ್
Nazaria	ನಜರಿಯಾ
Erode	ಈರೋಡ್
Junction	ಜಂಕ್ಷನ್
Silsila	ಸಿಲ್‌ಸಿಲಾ
Mrinmayi	ಮೃಣ್ಮಯಿ
Sukhdev	ಸುಖದೇವ್
La	ಲಾ
Fayette	ಫಯಿಟಿ
Veerendra	ವೀರೇಂದ್ರ
Dominican	ಡೊಮಿನಿಕನ್
Republic	ರಿಪಬ್ಲಿಕ್
Angoori	ಅಂಗೂರಿ
Maan	ಮಾನ್
Meg	ಮೇಗ್
Dil	ದಿಲ್
Hi	ಹೀ
Dil	ದಿಲ್
Mein	ಮೇ
Samit	ಸಮಿತ್
Order	ಆರ್ಡರ್
of	ಆಫ್
the	ದ
Cross	ಕ್ರಾಸ್
of	ಆಫ್
the	ದ
Eagle	ಈಗಲ್
Pahunche	ಪಹುಂಚೆ
Hue	ಹುಯೆ
Log	ಲೋಗ್
Schock	ಸ್ಕೋಕ್
Prize	ಪ್ರೈಜ್
in	ಇನ್
Musical	ಮ್ಯೂಜಿಕಲ್
Arts	ಆರ್ಟ್ಸ್
Anmol	ಅನ್ಮೋಲ್
Ratan	ರತನ್
Bitterroot	ಬಿಟ್ಟರ್‌ರೂಟ್
Calvary	ಕ್ಯಾಲ್ವರಿ
Baptist	ಬ್ಯಾಪ್ಟಿಸ್ಟ್
Surat	ಸೂರತ್
Aakhri	ಆಖಿರಿ
Mujra	ಮುಜರಾ
Suraj	ಸೂರಜ್
Deo	ಡಿಯೊ
Manzar	ಮಂಜರ್
Pratosh	ಪ್ರತೋಶ್
Bhopal	ಭೋಪಾಲ್
Junction	ಜಂಕ್ಷನ್
Fernado	ಫೆರ್ನೆಡೊ
de	ಡಿ
Noronha	ನೊರೊನ್ಹಾ
Marine	ಮೆರಿನ್
Othello	ಒಥೆಲೋ
Rossa	ರೊಸಾ
Aadhi	ಆದಿ
Roti	ರೋಟಿ
Varadraja	ವರದರಾಜ
Perumal	ಪೆರುಮಾಳ್
Vajra	ವಜ್ರ
Suzy-q	ಸೂಜೀ-ಕ್ಯೂ
Adwakee	ಅದ್ವಾಕೀ
Seeta	ಸೀತಾ
Swayamvar	ಸ್ವಯಂವರ್
Trevor	ಟ್ರೆವರ್
Franklin	ಫ್ರಾಂಕ್ಲಿನ್
Inline	ಇನ್‌ಲೈನ್
skating	ಸ್ಕೇಟಿಂಗ್
Surinder	ಸುರಿಂದರ್
Bhima	ಭೀಮಾ
Wilson	ವಿಲ್ಸನ್
Castle	ಕ್ಯಾಸ್ಟಲ್
Xenos	ಜೆನೋಸ್
Vernados	ವೆರ್ನದಾಸ್
Bob	ಬಾಬ್
Massie	ಮಾಸಿ
Acropolis	ಆರ್ಕೋಪೊಲೀಸ್
Museum	ಮ್ಯೂಸಿಯಂ
Modinha	ಮೊದಿನ್ಹಾ
Thanjavur	ತಂಜಾವೂರ್
Halers	ಹೆಲೆರ್ಸ್
Avataar	ಅವತಾರ್
Bouvet	ಬೋವೆಟ್
Aadinaaraayan	ಆದಿನಾರಾಯಣ
Right	ರೈಟ್
Livelihood	ಲೈವ್‌ಲಿಹುಡ್
Award	ಅವಾರ್ಡ್
Thatte	ಥತ್ತೆ
Fort	ಫೋರ್ಟ್
bij	ಬಿಜ್
rhijnauwen	ರಿಜ್‌ನೌವೆನ್
Subhash	ಸುಭಾಷ್
Mukhopadhyay	ಮುಖೋಪಾಧ್ಯಾಯ್
Alboran	ಅಲ್ಬೊರಾನ್
Kaltham	ಕಲ್ತಾಮ್
Belwalkar	ಬೆಲ್ವಾಲ್ಕರ್
Kathie	ಕೇಥೀ
Delran	ಡೆಲ್‌ರನ್
First	ಫಸ್ಟ್
United	ಯುನೈಟೆಡ್
Methodist	ಮೇಥೋಡಿಸ್ಟ್
Lower	ಲೋವರ್
Saxony	ಸ್ಯಾಕ್ಸೋನಿ
Wadden	ವಾಡನ್
Sea	ಸೀ
Mushtaq	ಮುಷ್ತಾಕ್
Ahmed	ಅಹ್ಮದ್
Sean	ಸೀನ್
Davies	ಡೇವಿಯಸ್
Gurudwara	ಗುರುದ್ವಾರ
Chamkaur	ಚಾಮ್ಕೌರ್
Sahib	ಸಾಹಿಬ್
Vevay	ವೆವೆ
Ubadah	ಉಬದಾ
Purus	ಪುರುಸ್
Frank	ಫ್ರಾಂಕ್
Sinatra	ಸಿನಾತ್ರಾ
Tango	ಟ್ಯಾಂಗೊ
Bombay	ಬಾಂಬೆ
samachar	ಸಮಾಚಾರ್
Mulgaonkar	ಮುಳಗಾವಕರ್
Savita	ಸವಿತಾ
Chemical	ಕೆಮಿಕಲ್ಸ್
Himax	ಹಿಮಾಕ್ಸ್
Technologies	ಟೆಕ್ನಾಲಜೀಸ್
Fakhtah	ಫಕಾತಾಹ್
Dainik	ದೈನಿಕ್
janasadharan	ಜನಸಾಧಾರಣ್
Mill	ಮಿಲ್
Mazdoor	ಮಜದೂರ್
Ashraf	ಅಶ್ರಾಫ್
Jahangir	ಜಹಾಂಗಿರ್
Samnani	ಸಮ್ನಾನಿ
Atul	ಅತುಲ್
Balaji	ಬಾಲಾಜಿ
Telefilm	ಟೆಲಿಫಿಲ್ಮ್
Sanath	ಸನತ್
Jayasuriya	ಜಯಸೂರ್ಯ
Atal	ಅಟಲ್
Dingankar	ದಿಂಗಂನ್ಕರ್
Duduk	ಡುಡುಕ್
Glenn	ಗ್ಲೆನ್
Turner	ಟರ್ನರ್
Retalix	ರಿಟಾಲಿಕ್ಸ್
Mahamaya	ಮಹಾಮಾಯಾ
Khatoon	ಖತೂನ್
Roland	ರೋಲಂಡ್
Holder	ಹೋಲ್ಡರ್
Sagar	ಸಾಗರ್
Ka	ಕಾ
Sher	ಶೇರ್
Abdul	ಅಬ್ದುಲ್
munim	ಮುನೀಂ
Sadaf	ಸದಫ್
Barsuan	ಬರ್ಸುಯಾನ್
Titus	ಟಿಟೂಸ್
Kurt	ಕರ್ಟ್
Wilkinson	ವಿಲ್ಕಿನ್ಸನ್
Fort	ಫೋರ್ಟ್
benghisa	ಬೆಂಗಿಶಾ
Order	ಆರ್ಡರ್
of	ಆಫ್
Suvorov	ಸುವೊರೊವ್
Caliana	ಕೇಲಿಯಾನಾ
Sadhna	ಸಾಧನಾ
Alfred	ಅಲ್ಫ್ರೆಡ್
Luseno	ಲುಸೆನೊ
Birju	ಬಿರ್ಜೂ
Ustad	ಉಸ್ತಾದ್
Man	ಮನ್
Ka	ಕಾ
Aangan	ಆಂಗನ್
Deenabandhu	ದೀನಬಂಧು
Believers	ಬೆಲಿವೆರಿಸ್
Faruq	ಫಾರುಖ್
Angoor	ಅಂಗೂರ್
Kannanur	ಕಣ್ಣನೂರ್
Barsha	ಬರ್ಷಾ
Gandhapalin	ಗಂಧಪಾಲಿನ್
Calais	ಕಾಲೇಸ್
Glenyon	ಗ್ಲೆನ್‌ಯೋನ್
Chhoti	ಛೋಟೀ
Si	ಸೀ
Mulaqat	ಮುಲಾಕಾತ್
Abhinandan	ಅಭಿನಂದನ್
Shokh	ಶೋಖ್
Dilruba	ದಿಲರುಬಾ
Saarthak	ಸಾರ್ಥಕ್
Jermaine	ಜರ್ಮೈನ್
Lawson	ಲಾಸನ್
Radetzky	ರಾಡೆಟ್‌ಜೈಕ್
Mamaji	ಮಾಮಾಜಿ
Kartar	ಕರ್ತಾರ್
Naarlekar	ನಾರ್ಲೆಕರ್
Ihsan	ಇಹ್ಸಾನ್
Beraham	ಬೆರಹಮ್
Sicily	ಸಿಸಿಲಿ
Preussen	ಪ್ರಿಯುಸೆನ್
Saz	ಸಾಜ್
Discus	ಡಿಸ್ಕಸ್
Anjalee	ಅಂಜಲೀ
Lowell	ಲಾವೆಲ್
Zwyndrecht	ಝ್ವಿಂಡ್ರೆಚ್
Saza	ಸಾಜಾ
E	ಎ
Maut	ಮೌತ್
Amita	ಅಮಿತ
Pyar	ಪ್ಯಾರ್
Ka	ಕಾ
Toofan	ತೂಫಾನ್
Allemande	ಅಲಿಮಂಡೆ
Deekshaapati	ದೀಕ್ಷಾಪತಿ
Dave	ದವೇ
Gilbert	ಗಿಲ್ಬರ್ಟ್
Frissiras	ಫ್ರಿಸಿರಸ್
Museum	ಮ್ಯೂಸಿಯಂ
University	ಯುನಿವರ್ಸಿಟಿ
of	ಆಫ್
Leeds	ಲೀಡ್ಸ್
Zulfaqar	ಜುಲ್ಫಕರ್
Vishvaroop	ವಿಶ್ವರೂಪ್
Faysal	ಫೈಜಲ್
Providence	ಪ್ರಾವಿಡೆನ್ಸ್
Baptist	ಬ್ಯಾಪ್ಟಿಸ್ಟ್
Sayar	ಸಯರ್
Fort	ಫೋರ್ಟ್
de	ಡಿ
gagel	ಗ್ಯಾಗೆಲ್
Martin	ಮಾರ್ಟಿನ್
Crowe	ಕ್ರೋವ್
Soolagiri	ಸೋಲಾಗಿರಿ
chinnar	ಚಿನ್ನಾರ್
Reservoir	ರಿಜರ್ವಾಯರ್
Gavan	ಗವಾನ್
Manikuntala	ಮಣಿಕುಂತಲಾ
Miss	ಮಿಸ್
India	ಇಂಡಿಯಾ
Khursheed	ಖುರ್ಷೀದ್
Telstra	ಟೆಲ್‌ಸ್ಟ್ರಾ
Janta	ಜನತಾ
Hawaldaar	ಹವಲದಾರ್
Marisela	ಮ್ಯಾರಿಸೆಲಾ
Nikunja	ನಿಕುಂಜಾ
Krishnakali	ಕೃಷ್ಣಕಲಿ
Jyot	ಜ್ಯೋತ್
Jale	ಜಲೆ
Akolner	ಅಕೋಲ್ನೇರ್
Gehra	ಗೆಹರಾ
Daag	ದಾಗ್
Ramswaroop	ರಾಮಸ್ವರೂಪ
Tendulkar	ತೆಂಡುಲ್ಕರ್
Wafiyah	ವಾಫಿಯಾ
Camila	ಕ್ಯಾಮಿಲಾ
Chandrabhaan	ಚಂದ್ರಭಾನ್
Majd	ಮರ್ದ್
Salwaan	ಸಲ್ವಾನಾ
Onega	ಒನೇಗಾ
Charles	ಚಾರ್ಲ್ಸ್
De	ಡಿ
Gaulle	ಗೌಲೆ
Mehendale	ಮೆಹೆಂದಲೆ
Jabin	ಜಬಿನ್
Badi	ಬಡೀ
Didi	ದೀದಿ
Abdul	ಅಬ್ದುಲ್
wahaab	ವಹಾಬ್
El	ಎಲ್
Horria	ಹೋರಿಯಾ
Baltic	ಬಾಲ್ಟಿಕ್
Manjeer	ಮಂಜೀರ್
Signal	ಸಿಗ್ನಲ್
hill	ಹಿಲ್
Bassi	ಬಸ್ಸಿ
Lotta	ಲೊಟ್ಟಾ
Irfan	ಇರ್ಫಾನ್
Bhatti	ಭಟ್ಟಿ
Bijnaur	ಬಿಜ್ನೋರ್
Lal	ಲಾಲ್
Kothi	ಕೋಠಿ
Lotte	ಲೊಟ್ಟೆ
Sagar	ಸಾಗರ್
Pranjivan	ಪ್ರಾಣಜೀವನ್
Bazid	ಬಾಜಿದ್
Khan	ಖಾನ್
Zia	ಜಿಯಾ
Whitesand	ವೈಟ್‌ಸ್ಯಾಂಡ್
bay	ಬೇ
battery	ಬ್ಯಾಟರಿ
Dabeer	ಢಬೀರ್
Deccan	ಡೆಕ್ಕನ್
chronicle	ಕ್ರಾನಿಕಲ್
Plainfield	ಪ್ಲೈನ್‌ಫೀಲ್ಡ್
Bible	ಬೈಬಲ್
Iridium	ಇರಿಡಿಯಂ
Tino	ಟಿನೊ
Landmark	ಲ್ಯಾಂಡ್‌ಮಾರ್ಕ್
United	ಯುನೈಟೆಡ್
Methodist	ಮೆಥಡಿಸ್ಟ್
Allene	ಅಲೀನ್
Fahd	ಫಾಹ್ದ್
Bacheli	ಬಚೇಲಿ
Sanyam	ಸಂನ್ಯಮ್
Fred	ಪ್ರೆಡ್
Titmus	ಟಿಟ್ಮಸ್
Glennis	ಗ್ಲೆನ್ನೀಸ್
Alexander	ಅಲೆಕ್ಸಾಂಡರ್
the	ದಿ
Great	ಗ್ರೇಟ್
Cassara	ಕ್ಯಾಸರಾ
Ken	ಕೆನ್
Shuttleworth	ಶಟಲ್‌ವರ್ತ್
Finlay	ಫಿನ್ಲೆ
Premanand	ಪ್ರೇಮಾನಂದ
Sidi	ಸಿದಿ
Ahmed	ಅಹಮದ್
al-Tidjani	ಅಲ್-ತಿಡ್ಜಾನಿ
Firozpur	ಫಿರೋಜ್‌ಪುರ್
Cantonment	ಕಂಟೋನ್ಮೆಂಟ್
Aanandamayee	ಆನಂದಮಯೀ
Virgil	ವರ್ಜಿಲ್
Pieter	ಪೀಟರ್
Strydom	ಸ್ಟ್ರಿಡಂ
Afasaanaa	ಅಫಸಾನಾ
Brookings	ಬ್ರೂಕಿಂಗ್ಸ್
Sompaal	ಸೋಮ್‌ಪಾಲ್
Melissan	ಮೆಲಿಸ್ಸನ್
Yellow	ಯೆಲ್ಲೋ
Sea	ಸೀ
Calvert	ಕ್ಯಾಲ್ವರ್ಟ್
Kifayat	ಕಿಫಾಯತ್
Sipahsalar	ಸಿಪಾಹಸಲಾರ್
Bretagne	ಬ್ರೆಟಾಗ್ನೆ
Sindoor	ಸಿಂದೂರ್
Aur	ಔರ್
Bandook	ಬಂದೂಕ್
Pooja	ಪೂಜಾ
Ke	ಕೆ
Phool	ಪೂಲ್
Copper	ಕಾಬರ್
Eurohypo	ಯೂರೋಹೈಪೋ
Rupye	ರುಪಯೆ
Ki	ಕಿ
Kahani	ಕಹಾನಿ
Roy	ರಾಯ್
Fredericks	ಫ್ರೆಡರಿಕ್ಸ್
Vishveshvar	ವಿಶ್ವೇಶ್ವರ್
Dabhaura	ದಾಭೌರಾ
Kulthum	ಕುಲ್ತುಮ್
Sameer	ಸಮೀರ್
Marakat	ಮರಕತ್
Kylemore	ಕೈಲ್‌ಮೂರ್
Kabirah	ಕಬೀರಾ
Wilda	ವಿಲ್ಡಾ
Elizabeth	ಎಲಿಜಬೆತ್
Doll	ಡಾಲ್
Radon	ರಾಡಾನ್
Aislinn	ಐಸ್ಲಿನ್
Mujrim	ಮುಜರಿಮ್
Kaun	ಕೌನ್
Khooni	ಖೂನೀ
Kaun	ಕೌನ್
Ganaraj	ಗಣರಾಜ
Rashid	ರಶೀದ್
Patel	ಪಟೇಲ್
Jalil	ಜಲಿಲ್
Ajitesh	ಅಜಿತೇಶ್
Mathilda	ಮಥಿಲ್ಡಾ
Awara	ಆವಾರಾ
Shehzadi	ಶೆಹಝಾದೀ
Suez	ಸುಯೆಜ್
Ashadh	ಆಶಾಧ್
Ka	ಕಾ
Ek	ಏಕ್
Din	ದಿನ್
Aadhi	ಆದಿ
Raat	ರಾತ್
Ke	ಕೆ
Baad	ಬಾದ್
Changez	ಚಂಗೇಜ್
Khan	ಖಾನ್
Narhari	ನರ್ಹರಿ
Arijit	ಅರಿಜಿತ್
Faruk	ಫಾರುಕ್
Ahmed	ಅಹ್ಮದ್
Hilal	ಹಿಲಾಲ್
Hatimtai	ಹಾತಿಮತಾಯಿ
Ushashi	ಉಶಶಿ
Bambai	ಬಂಬಾಯ್
Ka	ಕೆ
Maharaja	ಮಹರಾಜ್
Khalil	ಖಲೀಲ್
John	ಜಾನ್
Parker	ಪಾರ್ಕರ್
Carl	ಕಾರ್ಲ್
Marx	ಮಾರ್ಕ್ಸ್
Kwacha	ಕ್ವಾಚ
Coimbatore	ಕೊಯಂಬತ್ತೂರು
Jazlynn	ಜಜ್ಲಿನ್
Gurudwara	ಗುರುದ್ವಾರ
Nankana	ನನ್‌ಕಾನಾ
Sahib	ಸಾಹಿಬ್
Arcadis	ಅರ್ಕಾಡಿಸ್
Dibang	ದಿಬಾಂಗ್
Valley	ವ್ಯಾಲಿ
Mrityunjai	ಮೃತ್ಯುಂಜಯಿ
Arabela	ಅರಾಬೆಲಾ
Darakhshaan	ದಾರಕ್ಷಾನ್
Godaa	ಗೋದಾ
Dharashivkar	ಧಾರಾಶಿವಕರ್
Xerox	ಜೆರಾಕ್ಸ್
ModiCorp	ಮೋದಿಕಾರ್ಪ್
Geeti	ಗೀತಿ
Odin	ಒಡಿನ್
Charlie	ಚಾರ್ಲೀ
Lock	ಲಾಕ್
Geeta	ಗೀತಾ
Dooley	ಡೂಲೇ
Alester	ಆಲಿಸ್ಟರ್
Maregwede	ಮಾರ್ಗ್ವೆಡೆ
Paree	ಪಾರೀ
Wardha	ವಾರ್ಧಾ
Sanskrit	ಸಂಸ್ಕೃತ್
Bae	ಬೇ
Systems	ಸಿಸ್ಟಮ್ಸ್
Mar	ಮರ್
Mitenge	ಮಿಟೇಂಗೆ
Akhri	ಆಖರೀ
Muqabla	ಮುಕಾಬಲಾ
Basrai	ಬಸರಾಯ್
Khahera	ಖಾಹೇರಾ
Abdul	ಅಬ್ದುಲ್
muaid	ಮುಯೆದ್
Geoff	ಜೆಫ್
Cook	ಕುಕ್
Dornakal	ದೊರನಾಕಲ್
Junction	ಜಂಕ್ಷನ್
Karale	ಕರಾಲೆ
Aabshar	ಆಬಶರ್
Swaroopaa	ಸ್ವರೂಪಾ
Auraiya	ಔರೈಯ್ಯಾ
Kannauj	ಕನೋಜ್
Fort	ಫೋರ್ಟ್
bij	ಬಿಜ್
vuren	ವುರೆನ್
Kinnaur	ಕಿನ್ನಾರ್
Muhar	ಮುಹಾರ್
Etmadpur	ಇಟಮಾಪುರ್
North	ನಾರ್ಥ
York	ಯಾರ್ಕ್
Moors	ಮೂರ್ಸ್
Noorie	ನೂರಿ
Girdhar	ಗಿರಧರ್
Gopal	ಗೋಪಾಲ್
Ki	ಕಿ
Mira	ಮೀರಾ
Sysco	ಸಿಸ್ಕೋ
Ghayoor	ಗಯೂರ್
Bharosa	ಭರೋಸಾ
Nasha	ನಶಾ
Lal	ಲಾಲ್
Bujhakkad	ಬುಝಕ್ಕಡ್
Sarah	ಸರಾ
Saran	ಸರಂ
Murtadaa	ಮುರ್ತದಾ
Prince	ಪ್ರಿನ್ಸ್
Piyali	ಪಿಯಾಲಿ
Treva	ಟ್ರೆವಾ
Tiana	ಟಿಯಾನಾ
Julia	ಜೂಲಿಯಾ
Roberts	ರಾಬರ್ಟ್ಸ್
Dionysius	ಡಿಯೊಸಿಸ್
Nico	ನಿಕೊ
Shafee	ಶಫೀ
Rahgeer	ರಾಹಗಿರ್
Mgahinga	ಮಗಾಹಿಂಗಾ
Gorilla	ಗೊರಿಲ್ಲಾ
Augustin	ಆಗಸ್ಟಿನ್
Norwegian	ನಾರ್ವೇಜಿಯನ್
Pyar	ಪ್ಯಾರ್
Ka	ಕಾ
Pahla	ಪಹಲಾ
Sawan	ಸಾವನ್
Agra	ಆಗ್ರಾ
Sonika	ಸೋನಿಕಾ
Constance	ಕಾನ್ಸ್ಟಾನ್ಸ್
Rahat	ರಾಹತ್
Datia	ದಾತಿಯಾ
fort	ಫೋರ್ಟ್
Madhumaan	ಮಧುಮನ್
Main	ಮೈ
Awara	ಆವಾರಾ
Hoon	ಹೂ
Langley	ಲ್ಯಾಂಗ್ಲೆ
Garrick	ಗೈರಿಕ್
Dapeng	ದಾಪೆಂಗ್
International	ಇಂಟರ್‌ನ್ಯಾಷನಲ್
Plaza	ಪ್ಲಾಜಾ
Achaarynandana	ಆಚಾರ್ಯನಂದನ
Taiwan	ತೈವಾನ್
Strait	ಸ್ಟ್ರೈಟ್
Warnix	ವಾರ್ನಿಕ್ಸ್
Naya	ನಯಾ
Zamana	ಜಮಾನಾ
Nai	ನಯೀ
Kranti	ಕ್ರಾಂತಿ
Aretha	ಅರಿಥಾ
Franklin	ಫ್ರಾಂಕ್ಲಿನ್
Merck	ಮರ್ಕ್
Pharma	ಫಾರ್ಮಾ
Kotla	ಕೊಟಲಾ
Paanch	ಪಾಂಚ್
Dushman	ದುಶ್ಮನ್
Kelvin	ಕೆಲ್ವಿನ್
Selinaa	ಸೆಲಿನಾ
Hurayth	ಹುರೇತ್
Abdul	ಅಬ್ದುಲ್
adl	ಅದಲ್
Transverse	ಟ್ರಾನ್ಸ್‌ವರ್ಸ್
Dalmera	ದಲ್ಮೇರಾ
Peace	ಪೀಸ್
Emmet	ಎಮ್ಮೆಟ್
Arctic	ಆರ್ಕ್ಟಿಕ್
ocean	ಓಶಿಯನ್
Socha	ಸೋಚಾ
Na	ನ
Tha	ಥಾ
Savan	ಸಾವನ್
Bin	ಬಿನ್
Maa	ಮಾ
Ke	ಕೆ
Bhachchey	ಬಚ್ಚೆ
Banke	ಬಾಂಕಿ
Sanwaria	ಸಾನ್ವರಿಯಾ
Pyara	ಪ್ಯಾರಾ
Dushman	ದುಶ್ಮನ್
Goresuar	ಗೊರೆಸುವರ್
Raghuvansh	ರಘುವಂಶ್
Mandara	ಮಂದರಾ
Eileen	ಈಲೀನ್
Laajavantee	ಲಾಜವಂತಿ
Municipal	ಮುನಿಸಿಪಲ್
Gallery	ಗ್ಯಾಲರಿ
of	ಆಫ್
Rhodes	ರೋಡ್ಸ್
Nandita	ನಂದಿತಾ
Angaarika	ಅಗಾರಿಕ
Margaret	ಮಾರ್ಗರೇಟ್
Bombay	ಬಾಂಬೆ
Raat	ರಾತ್
Ki	ಕಿ
Bahon	ಬಾಹೋ
Mein	ಮೆ
Samarendra	ಸಮರೇಂದ್ರ
Obaidullah	ಒಬೇದುಲ್ಲಾ
Gurudwara	ಗುರುದ್ವಾರ
Jund	ಜುಂಡ್
Sahib	ಸಾಹಿಬ್
Abdul	ಅಬ್ದುಲ್
walee	ವಲೀ
Fort	ಫೋರ್ಟ್
brown	ಬ್ರೌನ್
Annapoorna	ಅನ್ನಪೂರ್ಣ
Milo	ಮಿಲೊ
Anupgarh	ಅನುಪ್‌ಗಢ್
Pink	ಪಿಂಕ್
Model	ಮಾಡೆಲ್
School,	ಸ್ಕೂಲ್,
Bikaner	ಬಿಕನೇರ್
Gazi	ಗಾಝಿ
Ashraf	ಅಶ್ರಫ್
Khubgaonkar	ಖುಬಗಾಂವ್ಕರ್
Rose	ರೋಸ್
Selkirk	ಸೆಲ್‌ಕಿರ್ಕ್
Dorothea	ಡೊರೋಥಿಯಾ
Dino	ಡಿನೊ
Nat	ನ್ಯಾಟ್
King	ಕಿಂಗ್
Cole	ಕೋಲ್
Excalibur	ಎಕ್ಸ್‌ಕ್ಯಾಲಿಬರ್
Jill	ಜಿಲ್
Abbaasee	ಅಬ್ಬಾಸೀ
Puvis	ಪುವಿಸ್
de	ಡಿ
Chavannes	ಚವನೀಸ್
Prize	ಪ್ರೈಜ್
Yves	ವ್ಯಸ್
Dhasa	ಧಾಸಾ
Junction	ಜಂಕ್ಷನ್
Vaidya	ವೈದ್ಯ
Adonia	ಅಡೋನಿಯಾ
Police	ಪೊಲೀಸ್
Public	ಬಬ್ಲಿಕ್
Hillier	ಹಿಲ್ಲಿಯರ್
Frieda	ಫ್ರೀಡಾ
SIGNY	ಸಿಗ್ನಿ
award	ಆವಾರ್ಡ್
Fujai	ಫುಜಾಯ್
Arasur	ಅರಸೂರ್
Andal	ಅಂಡಾಲ್
Junction	ಜಂಕ್ಷನ್
Derawar	ದೆರಾವರ್
fort	ಫೋರ್ಟ್
Rajan	ರಾಜನ್
Raeesah	ರಯೀಸಾಹ್
Qamra	ಕಮ್ರಾ
Urbana	ಅರ್ಬಾನಾ
Achaarynandan	ಆಚಾರ್ಯನಂದನ್
Isaura	ಇಸಾರಾ
Manipur	ಮಣಿಪುರ್
today	ಟುಡೆ
Carlow	ಕಾರ್ಲೋ
University	ಯುನಿವರ್ಸಿಟಿ
of	ಆಫ್
Cambridge	ಕೇಂಬ್ರಿಡ್ಜ್
Swiss	ಸ್ವಿಸ್
Life	ಲೈಫ್
Bedaag	ಬೆದಾಗ್
Ryan	ರಯಾನ್
Hinds	ಹಿಂಡ್ಸ್
Uqbah	ಉಕ್ಬಾ
Huge	ಹ್ಯೂಜ್
Grant	ಗ್ರಾಂಟ್
Fico	ಫಿಕೊ
Dil	ದಿಲ್
Hi	ಹೀ
To	ತೋ
Hai	ಹೈ
Donovan	ಡೊನವನ್
Daawat	ದಾವತ್
Chhidgaon	ಛಿದ್‌ಗಾಂವ್
Asija	ಅಸಿಜಾ
Balrampur	ಬಲರಾಮಪುರ್
Chini	ಚಿನಿ
Yosemite	ಯೋಸಿಮೈಟಿ
Ek	ಏಕ್
Se	ಸೇ
Badhkar	ಬಢಕರ್
Ek	ಏಕ್
Pritha	ಪೃಥಾ
Phir	ಫಿರ್
Wohi	ವಹೀ
Dil	ದಿಲ್
Laya	ಲಾಯಾ
Hoon	ಹೂ
Thattha	ಠಠ್ಠಾ
Daler	ದಲೆರ್
Ito	ಇಟೋ
Yokado	ಯಕಾಡೊ
Bassi	ಬಸ್ಸಿ
Pathanam	ಪಠಣಮ್
Pahuja	ಪಾಹೂಜಾ
Pooranasinh	ಪೂರಣ್‌ಸಿಂಹ
Mehandi	ಮೆಹಂದಿ
Rang	ರಂಗ್
Layegi	ಲಾಯೆಗೀ
Bank	ಬ್ಯಾಂಕ್
of	ಆಫ್
America	ಅಮೆರಿಕಾ
Plaza	ಪ್ಲಾಜಾ
Arjansar	ಅರ್ಜನ್‌ಸಾರ್
Jaiwant	ಜಯವಂತ್
Ankush	ಅಂಕುಶ್
Mahakaleshwar	ಮಹಾಕಾಲೇಶ್ವರ
Jyotirlinga	ಜ್ಯೋತಿರ್ಲಿಂಗ
Presidio	ಪ್ರೆಸಿಡಿಯೊ
Darpad	ದರ್ಪದ್
Leanna	ಲೀನಾ
State	ಸ್ಟೇಟ್
Grid	ಗ್ರಿಡ್
Samarah	ಸಮರಾ
Shamamah	ಶಮಾಮಾ
Bhupinder	ಭುಪಿಂದರ್
Singh	ಸಿಂಗ್
Dwijendra	ದ್ವಿಜೇಂದ್ರ
Dalel	ದಲೆಲ್
Chakraj	ಚಕ್ರಜ್
Mal	ಮಲ್
Mashoodah	ಮಶಹೂದಾ
Delia	ದೆಲಿಯಾ
Chandranath	ಚಂದ್ರನಾಥ್
Blind	ಬ್ಲೈಂಡ್
Golf	ಗಾಲ್ಫ್
Mera	ಮೇರಾ
Saya	ಸಾಯಾ
Darryl	ಡರೆಲ್
Brown	ಬ್ರೌನ್
Tsitsikamma	ಸಿಟ್ಸಿಕಮ್ಮ
Adawi	ಅದಾವಿ
Shergill	ಶೆರಗಿಲ್
Rochefort	ರಾಶ್ಫೋರ್ಟ್
Kamran	ಕಮ್ರಾನ್
Akmal	ಅಕ್ಮಲ್
Sterling	ಸ್ಟರ್ಲಿಂಗ್
Shoorveer	ಶೂರವೀರ್
Palekar	ಪಾಲೇಕರ್
Marsha	ಮಾರ್ಶಾ
Sagar	ಸಾಗರ್
Ki	ಕಿ
Kanya	ಕನ್ಯಾ
Tawseef	ತಾವ್ಸೀಫ್
Kiara	ಕಿಯಾರ
Ratnapriya	ರತ್ನಪ್ರಿಯ
Sparsh	ಸ್ಪರ್ಶ್
Baalmani	ಬಾಲಮಣಿ
Bhaton	ಭಟೋನ್
Ki	ಕಿ
Gali	ಗಲಿ
Chhabra	ಛಾಬರಾ
Gugor	ಗುಗೋರಾ
Welham	ವೇಲ್ಹಾಮ್
Girls'	ಗರ್ಲ್ಸ್
High	ಹೈ
School,	ಸ್ಕೂಲ್,
Dehradun	ಡೆಹ್ರಾಡೂನ್
Choki	ಚೋಕಿ
Sorath	ಸೋರಥ್
Greg	ಗ್ರೆಗ್
Matthews	ಮ್ಯಾಥ್ಯೂಸ್
Baja	ಬಾಜಾ
California	ಕ್ಯಾಲಿಫೋರ್ನಿಯಾ
Telephone	ಟೆಲಿಫೋನ್
Merlin	ಮೆರ್ಲಿನ್
kville	ವಿಲ್ಲೆ
Kunti	ಕುಂತಿ
Kunte	ಕುಂಟೆ
Belthara	ಬೆಲ್ಥಾರಾ
Road	ರೋಡ್
Abohar	ಅಬೋಹರ್
Wadhwan	ವಾಧವನ್
Genna	ಜೆನ್ನಾ
Patiala	ಪಾಟಿಯಾಲ
Nasiruddin	ನಾಸಿರುದ್ದೀನ್
Sailani	ಸೈಲಾನಿ
Badesha	ಬದೇಶಾ
Balqees	ಬಲ್ಕಿಸ್
Dhamkee	ಧಮಕಿ
Ramiz	ರಮಿಜ್
Hitesh	ಹಿತೇಶ್
Modi	ಮೋದಿ
Agaathaa	ಅಗಾಥಾ
Woh	ವಹ್
Saat	ಸಾತ್
Din	ದಿನ್
Dulha	ದುಲ್ಹಾ
Dulhan	ದುಲಹನ್
Anoush	ಅನೌಷ್
Abdul	ಅಬ್ದುಲ್
fatah	ಫತಾ
Wilbur	ವಿಲ್‌ಬುರ್
Museum	ಮ್ಯೂಸಿಯಂ
of	ಆಫ್
Anthropology	ಆಂಥ್ರೋಪಾಲಜಿ
Khalisah	ಖಲೀಸಾ
Dirt	ಡರ್ಟ್
Bike	ಬೈಕ್
Racing	ರೇಸಿಂಗ್
Mayura	ಮಯೂರ
Love	ಲವ್
Banbasa	ಬನಬಾಸಾ
Surur	ಸುರೂರ್
Terrence	ಟೆರೆನ್ಸ್
Rachna	ರಚನಾ
Tate	ಟೇಟ್
Gallery	ಗ್ಯಾಲರಿ
University	ಯುನಿವರ್ಸಿಟಿ
of	ಆಫ್
Central	ಸೆಂಟ್ರಲ್
Lancashire	ಲಂಕಾಶೈರ್
Laszlo	ಲಾಸ್ಝಲೊ
Mia	ಮಿಯಾ
Shripati	ಶ್ರೀಪತೀ
Ecrins	ಎಕ್ರಿನ್ಸ್
Izz	ಇಜ್ಜ್
an-nisa	ಅನ್-ನಿಸಾ
Bishan	ಬಿಶನ್
Singh	ಸಿಂಗ್
Bedi	ಬೇದಿ
Cesar	ಸೆಸಾರ್
Award	ಅವಾರ್ಡ್
Baalaaji	ಬಾಲಾಜಿ
William	ವಿಲಿಯಮ್
Randolph	ರೆಂಡೋಲ್ಫ್
Hearst	ಹರ್ಸ್ಟ್
Jainism	ಜೈನಿಸಂ
Baalgopaal	ಬಾಲ್‌ಗೋಪಾಲ್
Mudrit	ಮುದ್ರಿತ್
Bewafa	ಬೇವಫಾ
Swarg	ಸ್ವರ್ಗ್
Se	ಸೆ
Sunder	ಸುಂದರ್
Nabha	ನಾಭಾ
Ozzy	ಓಝಿ
Gurudwara	ಗುರುದ್ವಾರ
Makka	ಮಕ್ಕಾ
Madina	ಮದೀನಾ
Marathwada	ಮರಾಠ್‌ವಾಢಾ
Aas	ಆಸ್
Ka	ಕಾ
Panchhi	ಪಂಛೀ
Shoreham	ಶೊರೆಹಮ್
redoubt	ರಿಡೌಟ್
Antonia	ಆಂಟೋನಿಯಾ
Sugouri	ಸುಗೌರಿ
Badwal	ಬಡವಾಲ್
Kapila	ಕಪಿಲಾ
Bhagwantjot	ಭಗವಂತ್‌ಜೋತ್
Faruca	ಫಾರೂಕಾ
Flower	ಫ್ಲವರ್
Sheetalaa	ಶೀತಲಾ
Amalner	ಅಮಲ್‌ನೆರ್
Lakhon	ಲಾಖೋಂ
Mein	ಮೆ
Ek	ಏಕ್
Bunge	ಬಂಜ್
Danwar	ದಾನವರ್
John	ಜಾನ್
Grisham	ಗ್ರಿಶಮ್
Aparajit	ಅಪರಾಜಿತ್
Ashok	ಅಶೋಕ್
Sidhdh	ಸಿದ್ಧ
yogee	ಯೋಗಿ
Thyra	ಥಾಯರಾ
Chaela	ಚಾಯೆಲಾ
Dave	ಡೇವ್
Richardson	ರಿಚರ್ಡ್ಸನ್
Amerisourcebergen	ಅಮೆರಿಸೋರ್ಸ್ ಬರ್ಜನ್
Maxim	ಮ್ಯಾಕ್ಸಿಮ್
Garci	ಗಾರ್ಸಿ
Aurobindo	ಅರಬಿಂದೋ
Memorial	ಮೆಮೋರಿಯಲ್
School	ಸ್ಕೂಲ್
Janaki	ಜಾನಕಿ
Gemini	ಜೆಮಿನಿ
Chittapur	ಚಿತ್ತಾಪುರ್
Abdul	ಅಬ್ದುಲ್
haq	ಹಕ್
Cinema	ಸಿನಿಮಾ
Cinema	ಸಿನಿಮಾ
Gombe	ಗೋಂಬೆ
Stream	ಸ್ಟ್ರೀಮ್
Dhaleshwari	ಧಾಲೇಶ್ವರಿ
Dennis	ಡೆನಿಸ್
Rodman	ರಾಡ್ಮನ್
Nurul	ನೂರುಲ್
Abedin	ಅಬೆದಿನ್
Pavanjit	ಪವನಜಿತ್
Premanaaraayan	ಪ್ರೇಮನಾರಾಯಣ
Awaz	ಆವಾಜ್
De	ದೆ
Kahan	ಕಹಾ
Hai	ಹೈ
Wasimah	ವಸೀಮಾ
Surya	ಸೂರ್ಯ
Pahar	ಪಹರ್
Sharbati	ಶರ್ಬತಿ
Ankhen	ಆಂಖೇ
Sehra	ಸೆಹರಾ
Hochteif	ಹಾಚ್‌ಟಿಫ್
Advent	ಆಡ್ವೆಂಟ್
Christian	ಕ್ರಿಶ್ಚಿಯನ್
Kalare	ಕೇಲೇರ್
Imad	ಇಮದ್
Lalaatikaa	ಲಲಾಟಿಕಾ
Kartavya	ಕರ್ತವ್ಯ್
Catherine	ಕ್ಯಾಥರೀನ್
zeta	ಜೀಟಾ
-	-
Jones	ಜೋನ್ಸ್
Mohammad	ಮೊಹಮ್ಮದ್
Khalil	ಖಲೀಲ್
Novartis	ನೋವಾರ್ಟಿಸ್
India	ಇಂಡಿಯಾ
Imax	ಐಮ್ಯಾಕ್ಸ್
Corporation	ಕಾರ್ಪೊರೇಶನ್
Indika	ಇಂಡಿಕಾ
Gallage	ಗಲ್ಲಗೆ
Deepankar	ದೀಪಂಕರ್
Carissa	ಕ್ಯಾರಿಸ್ಸಾ
Woodrow	ವುಡ್‌ರೋ
Robbie	ರಾಬಿ
Kerr	ಕೆರ್
Katina	ಕ್ಯಾಟಿನಾ
Adriatic	ಆಡ್ರಿಯಾಟಿಕ್
Umm	ಉಮ್
kulthum	ಕುಲ್ತುಮ್
Graeme	ಗ್ರೀಮ್
Fowler	ಫ್ಲವರ್
Vahalkar	ವಹಲ್‌ಕರ್
Earnest	ಅರ್ನೆಸ್ಟ್
Mauritius	ಮಾರಿಷಸ್
Bruce	ಬ್ರೂಸ್
Blair	ಬ್ಲೇರ್
Vaaghmare	ವಾಘಮಾರೆ
Achyutraay	ಅಚ್ಯುತರಾಯ
Bill	ಬಿಲ್
Athey	ಅಥೆ
Salimbeni	ಸಲೀಮ್‌ಬೆನಿ
Prize	ಪ್ರೈಜ್
Stalin	ಸ್ಟ್ಯಾಲಿನ್
Yamashiro	ಯಮಶಿರೊ
Mone	ಮೋನೆ
Daniel	ಡೇನಿಯಲ್
Vettori	ವೆಟ್ಟೋರಿ
Tulika	ತುಲಿಕಾ
Kuala Lumpur	ಕೌಲಾಂಲಂಪುರ್
Spanish	ಸ್ಪ್ಯಾನಿಶ್
war	ವಾರ್
between	ಬಿಟ್ವೀನ್
England	ಇಂಗ್ಲೆಂಡ್
and	ಅಂಡ್
France	ಫ್ರಾನ್ಸ್
Bilaspur	ಬಿಲಾಸ್‌ಪುರ್
Road	ರೋಡ್
Surekha	ಸುರೇಖ
Tohana	ಟೆಹಾಣಾ
Thad	ಥಾಡ್
Sukhanand	ಸುಖಾನಂದ್
Colleen	ಕೊಲೀನ್
Mubarak	ಮುಬಾರಕ್
Mandy	ಮ್ಯಾಂಡಿ
Yachad	ಯಚಡ್
Mujhe	ಮುಝೆ
Seene	ಸೀನೆ
Se	ಸೆ
Laga	ಲಗಾ
Lo	ಲೋ
Dobbelaar	ಡೊಬೆಲಾರ್
Varada	ವರದಾ
Lockeridge	ಲಾಕ್‌ರಿಡ್ಜ್
Chaughule	ಚೌಘುಲೆ
Attacker	ಅಟ್ಟಾಕರ್
Natalia	ನಟಾಲಿಯಾ
Cecile	ಸಿಸಿಲ್
Jhitaruraam	ಝಿತರುರಾಮ್
California	ಕ್ಯಾಲಿಫೋರ್ನಿಯಾ
State	ಸ್ಟೇಟ್
University	ಯುನಿವರ್ಸಿಟಿ
Gore	ಗೋರೆ
Akzo	ಏಕ್ಜೋ
Nobel	ನೊಬೆಲ್
Bhavana	ಭಾವನಾ
Duguid	ಡುಗ್ಯೂಡ್
Raasavihaaree	ರಾಸವಿಹಾರೀ
San	ಸ್ಯಾನ್
Francisco	ಫ್ರಾನ್ಸಿಸ್ಕೋ
Alhaad	ಆಲ್ಹಾದ್
Maysa	ಮೇಸಾ
Henkel	ಹೆಂಕೆಲ್
Cholang	ಚೋಲಾಂಗ್
Museum	ಮ್ಯೂಸಿಯಂ
of	ಆಫ್
Royal	ರಾಯಲ್
Palace	ಪ್ಯಾಲೇಸ್
Nitya	ನಿತ್ಯ
Afdal	ಅಫ್ದಲ್
Dehri	ದೆಹರೀ
On	ಆನ್
Sone	ಸೋನಿ
Rayyan	ರೆಯಾನ್
Lillian	ಲಿಲಿಯನ್
Contai	ಕೊಂಟಾಯ್
Road	ರೋಡ್
Revati	ರೇವತಿ
Yeh	ಯೇ
Pyar	ಪ್ಯಾರ್
Nahin	ನಹೀ
Morinda	ಮೋರಿಂಡಾ
Daku	ಡಾಕೂ
Rani	ರಾಣಿ
Himmatwali	ಹಿಮ್ಮತ್‌ವಾಲಿ
Coolie	ಕೂಲಿ
Nandan	ನಂದನ್
Chhupa	ಛುಪಾ
Chhupee	ಛುಪೀ
Bheroolaal	ಭೇರೂಲಾಲ್
Azadi	ಆಜಾದೀ
Ke	ಕೆ
Baad	ಬಾದ್
Shawm	ಶಾಮ್
Bahadur	ಬಹಾದೂರ್
Kisan	ಕಿಸಾನ್
Tuhina	ತುಹಿನಾ
Hare	ಹರೇ
Rama	ರಾಮ
Hare	ಹರೇ
Krishna	ಕೃಷ್ಣ
Bangrod	ಬಂಗರೋದ್
Pyar	ಪ್ಯಾರ್
Jhukta	ಜುಕ್ತಾ
Nahin	ನಹೀ
Mohammad	ಮೊಹಮ್ಮದ್
Akram	ಅಕ್ರಂ
Museum	ಮ್ಯೂಸಿಯಂ
of	ಆಫ್
Welsh	ವೇಲ್ಶ್
Life	ಲೈಫ್
Gunung	ಗುನುಂಗ್
Halimun	ಹಲಿಮುನ್
Dhanbad	ಧನ್ ಬಾದ್
Veerbhum	ವೀರಭೂಮ್
Kalanki	ಕಲಂಕಿ
Birla	ಬಿರ್ಲಾ
Corp	ಕಾರ್ಪೊರೇಶನ್
Groupe	ಗ್ರೂಪ್
Danone	ಡೆನಾನ್
Main	ಮೈ
Aur	ಔರ್
Mera	ಮೇರಾ
Hathi	ಹಾಥಿ
Satyajit	ಸತ್ಯಜಿತ್
West	ವೆಸ್ಟ್
Side	ಸೈಡ್
General	ಜನರಲ್
Baptist	ಬ್ಯಾಪ್ಟಿಸ್ಟ್
More	ಮೋರೆ
Veeresh	ವೀರೇಶ್
Camilla	ಕ್ಯಾಮಿಲಾ
Madhavdas	ಮಾಧವದಾಸ್
Bal	ಬಾಲ
Yogi	ಯೋಗಿ
Maithili	ಮೈಥಿಲಿ
Shiv	ಶಿವ
Parvati	ಪಾರ್ವತಿ
Vivek	ವಿವೇಕ್
High	ಹೈ
School,	ಸ್ಕೂಲ್,
Chandigarh	ಚಂಡೀಗಢ್
Dotty	ಡಾಟಿ
Saint	ಸೇಂಟ್
George's	ಜಾರ್ಜಿಯಾಸ್
Yeh	ಯೇ
Kaisa	ಕೈಸಾ
Farz	ಫರ್ಜ್
Ganj	ಗಂಜ್
Basoda	ಬಸೋದಾ
Ghatna	ಘಟ್ನಾ
Chitrani	ಚಿತ್ರಾಣಿ
Nevan	ನೆವನ್
Waheeda	ವಹಿದಾ
Miss	ಮಿಸ್
Mary	ಮೇರಿ
Panchayat	ಪಂಚಾಯತ್
Naukar	ನೌಕರ್
Somerset	ಸಾಮರ್ಸೆಟ್
Mom	ಮಾಮ್
Anstice	ಆನ್‌ಸ್ಟೀಸ್
Luckett	ಲೂಕೆಟ್
Truckin	ಟ್ರುಕಿನ್
Trethewey	ಟ್ರೆಥವೆ
Zyta	ಜೀಟಾ
Goodwin	ಗುಡ್‌ವಿನ್
Kaleem	ಕಲೀಂ
Bhopatkar	ಭೋಪತ್ಕರ್
Abdul	ಅಬ್ದುಲ್
muhaayamin	ಮುಹಾಯಮೀನ್
Daata	ದಾತಾ
Doris	ಡೊರಿಸ್
Catherine	ಕ್ಯಾಥರೀನ್
Turner	ಟರ್ನರ್
Dorothy	ಡೊರೋಥಿ
Darnarik	ದರನಾರಿಕ್
Farz	ಫರ್ಜ್
Ki	ಕಿ
Jung	ಜಂಗ್
Ishan	ಈಶನ್
Air	ಏರ್
France	ಫ್ರಾನ್ಸ್
Klm	ಕೆಎಲ್ಎಂ
Group	ಗ್ರೂಪ್
Margo	ಮಾರ್ಗೊ
Texas	ಟೆಕ್ಸಾಸ್
Health	ಹೆಲ್ತ್
Science	ಸೈನ್ಸ್
Center	ಸೆಂಟರ್
Max	ಮ್ಯಾಕ್ಸ್
Walker	ವಾಕರ್
Dil	ದಿಲ್
Diya	ದಿಯಾ
Dard	ದರ್ದ್
Liya	ಲಿಯಾ
Minal	ಮಿನಾಲ್
Kanvar	ಕನ್ವರ್
Dumbra	ಡುಂಬ್ರಾ
Tanuj	ತನುಜ್
Daurai	ದೌರಾಯ್
Xarles	ಜಾರ್ಲೆಸ್
Trafalgar	ಟ್ರಫಾಲ್ಗರ್
Meghnad	ಮೇಘನಾದ್
Pope	ಪೋಪ್
John	ಜಾನ್
Paul	ಪೌಲ್
XXIII	XXIII
Aayushmaan	ಆಯುಷ್ಮಾನ್
E'jaaz	ಎಜಾಜ್
Bhagwanpur	ಭಗವಾನ್‌ಪುರ್
Chanchal	ಚಂಚಲ್
Raamanaaraayan	ರಾಮನಾರಾಯಣ
Balmani	ಬಾಲ್ಮಣಿ
University	ಯುನಿವರ್ಸಿಟಿ
of	ಆಫ್
Ulster	ಅಲ್ಸ್ಟರ್
Shahrukh	ಶಾಹರುಕ್
Khatavkar	ಖಟಾವ್ಕರ್
Chikjajur	ಚಿಕ್‌ಜಾಜೂರ್
Junction	ಜಂಕ್ಷನ್
Kala	ಕಾಲಾ
Chor	ಚೋರ್
Tiruvanantpuram	ತಿರುವನಂತಪುರಂ
Seeta	ಸೀತಾ
Ram	ರಾಮ್
Radheshyam	ರಾಧೇಶ್ಯಾಮ್
Prerna	ಪ್ರೇರಣಾ
Chaphekar	ಛಾಪೇಕರ್
Rathapati	ರತ್ನಪತಿ
Vedika	ವೇದಿಕ
Serengeti	ಸೆರೆಂಗೆಟಿ
Tawanda	ತವಾಂಡ
Mupariwa	ಮುಪಾರಿವ
Audrey	ಆಡ್ರೆ
Barkaat	ಬರ್ಕಾತ್
Majboor	ಮಜಬೂರ್
Anou	ಅನೌ
Ifflis	ಇಫ್ಲಿಸ್
Reetinder	ರಿತಿಂದರ್
Sodhi	ಸಿಂಗ್
Rakhshan	ರಖಶಾನ್
Shilling	ಶಿಲ್ಲಿಂಗ್
Shahenshah	ಶಹನ್‌ಶಾಹ್
Palnitkar	ಪಲ್ನಿಟ್‌ಕರ್
Rocky	ರಾಕಿ
mountain	ಮೌಂಟನ್
house	ಹೌಸ್
Dnieper	ಡೆನೀಪರ್
Australian	ಆಸ್ಟ್ರೇಲಿಯನ್
National	ನ್ಯಾಷನಲ್
University	ಯುನಿವರ್ಸಿಟಿ
Vindex	ವಿಂಡೆಕ್ಸ್
Najma	ನಜ್ಮಾ
Synchronised	ಸಿಂಕ್ರನೈಸ್ಡ್
Swimming	ಸ್ವಿಂಮಿಂಗ್
Buckingham	ಬಕ್ಕಿಂಗ್‌ಹ್ಯಾಮ್
Indulal	ಇಂದುಲಾಲ್
Chaitanya	ಚೈತನ್ಯ
Jayashree	ಜಯಶ್ರೀ
Gagroli	ಗಗರೋಲಿ
American	ಅಮೆರಿಕನ್
War	ವಾರ್
of	ಆಫ್
Independence	ಇಂಡಿಪೆಂಡೆನ್ಸ್
Panhala	ಪನ್‌ಹಾಲಾ
Rufus	ರಫಸ್
Cardiff	ಕಾರ್ಡಿಫ್
University	ಯುನಿವರ್ಸಿಟಿ
Shivlal	ಶಿವಲಾಲ್
Yadav	ಯಾದವ್
Malaysia	ಮಲೇಷಿಯಾ
Airell	ಏರೆಲ್
Kavita	ಕವಿತಾ
Hindustan	ಹಿಂದೂಸ್ತಾನ್
Ki	ಕಿ
Kasam	ಕಸಮ್
Muriel	ಮೌರಿಲ್
Maryada	ಮರ್ಯಾದಾ
Chakdaha	ಚಕದಾಹಾ
University	ಯುನಿವರ್ಸಿಟಿ
of	ಆಫ್
Durham	ಡರ್ಹಂ
Mahommed	ಮಹಮೂದ್
Ghaus	ಗೌಸ್
Macumbo	ಮ್ಯಾಕುಂಬೊ
Gajapaal	ಗಜಪಾಲ್
Badampudi	ಬದಾಮ್‌ಪುಡಿ
Laiq	ಲಯಿಖ್
Jalendra	ಜಲೇಂದ್ರ
Meyrick	ಮೆರಿಕ್
Pringle	ಪ್ರಿಂಗ್ಲ್
Chor	ಚೋರ್
Bazar	ಬಜಾರ್
Samayapuram	ಸಮಯಾಪುರಂ
Hoor-E-Arab	ಹೂರ್-ಎ-ಅರಬ್
Bhamini	ಭಾಮಿನಿ
Jaani	ಜಾನಿ
Dost	ದೋಸ್ತ್
Lokre	ಲೋಕ್ರೆ
Dindayal	ದೀನ್‌ದಯಾಳ್
Evan	ಈವನ್
Gray	ಗ್ರೇ
Toran	ತೋರನ್
Matwala	ಮತವಾಲಾ
Paanch	ಪಾಂಚ್
Fauladi	ಫೌಲಾದಿ
Matwale	ಮತವಾಲೇ
Evette	ಇವೆಟ್
Balram	ಬಲರಾಮ್
Shrikrishna	ಶ್ರೀಕೃಷ್ಣ
Olivia	ಒಲಿವಿಯಾ
Chalti	ಚಲ್ತೀ
Ka	ಕಾ
Naam	ನಾಮ್
Gaadi	ಗಾಢೀ
Ian	ಇಯಾನ್
Chappell	ಚಾಪೆಲ್
Wavre-sainte-catherine	ವೇವ್ರಿ-ಸೆಂಟ್-ಕ್ಯಾಥರೀನ್
Innisfallen	ಇನ್ನಿಸ್‌ಫಾಲನ್
Rajaji	ರಾಜಾಜಿ
Royal	ರಾಯಲ್
Arch	ಆರ್ಕ್
Burlington	ಬರ್ಲಿಂಗ್ಟನ್
Luxembourg	ಲಕ್ಸೆಂಬರ್ಗ್
Ankarana	ಅಂಕರಣ
Karlyn	ಕೀರ್ಲಿನ್
Naazneen	ನಾಜನೀನ್
Cipla	ಸಿಪ್ಲಾ
Desh	ದೇಶ್
Shatru	ಶತ್ರು
University	ಯುನಿವರ್ಸಿಟಿ
of	ಆಫ್
Bristol	ಬ್ರಿಸ್ಟಲ್
Anisaa	ಅನಿಸಾ
Jay	ಜೇ
Leno	ಲೀನೋ
Jivan	ಜಿವನ್
Thurayya	ಥುರಯ್ಯ
Auryon	ಆರ್ಯಾನ್
Johar	ಜೋಹರ್
In	ಇನ್
Kashmir	ಕಾಶ್ಮೀರ್
Vanshadhar	ವಂಶಧರ್
Harshe	ಹರ್ಷೆ
Garrison	ಗ್ಯಾರಿಸನ್
Shakdar	ಶೇಕ್‌ದಾರ್
Kamesh	ಕಾಮೇಶ್
Bettiah	ಬೆತ್ತಾಯ್
Dannie	ಡ್ಯಾನಿ
Heineman	ಹೈನೆಮನ್
Prize	ಪ್ರೈಜ್
Park	ಪಾರ್ಕ
Tower	ಟವರ್
Thyssenkrupp	ಥೈಸೆನ್‌ಕ್ರುಪ್
Umamah	ಉಮಾಮಾ
Mardi	ಮಾರ್ಡಿ
Whitcomb	ವಿಟ್‌ಕಾಂಬ್
Thomas	ಥಾಮಸ್
Hardy	ಹಾರ್ಡಿ
Godhra	ಗೋಧ್ರಾ
Junction	ಜಂಕ್ಷನ್
Mutsu	ಮುಟ್ಸು
Lincoln	ಲಿಂಕನ್
Roberts	ರೋಬರ್ಟ್ಸ್
Shrihari	ಶ್ರೀಹರಿ
Kyushu	ಕ್ಯುಶು
Electric	ಎಲೆಕ್ಟಿರ್ಕ್
Power	ಪವರ್
Kratz	ಕ್ರೇಟ್ಸ್
Tarunima	ತರುಣಿಮಾ
Living	ಲಿವಿಂಗ್
Word	ವರ್ಡ್
Family	ಫ್ಯಾಮಿಲಿ
World	ವರ್ಲ್ಡ್
Outreach	ಔಟ್‌ರೀಚ್
San	ಸಾನ್
Jose	ಜೋಸ್
Banbhatta	ಬಾಣಭಟ್ಟ
Huria	ಹುರಿಯಾ
Emma	ಎಮ್ಮಾ
Vellore	ವೆಲ್ಲೂರ್
fort	ಫೋರ್ಟ್
Baliakheri	ಬಲಿಯಾಖೇರಿ
Paavgi	ಪಾವ್‌ಗೀ
Joul	ಜೌಲ್
Chamkee	ಚಮ್ಕಿ
Naqeeb	ನಖೀಬ್
Singhasan	ಸಿಂಹಾಸನ್
Scot	ಸ್ಕಾಟ್
Abhaynanda	ಅಭಯ್‌ನಂದ
Rahul	ರಾಹುಲ್
Sanghvi	ಸಾಂಘ್ವಿ
College	ಕಾಲೇಜ್
Girl	ಗರ್ಲ್
GlaxoSmith	ಗ್ಲ್ಯಾಕ್ಸೊಸ್ಮಿತ್
Con	ಕಾನ್
Manjareek	ಮಂಜಾರೀಕ್
Ek	ಏಕ್
Chadar	ಚಾದರ್
Maili	ಮೈಲೀ
Si	ಸೀ
Charles	ಚಾರ್ಲ್ಸ್
Dickens	ಡಿಕನ್ಸ್
Musafir	ಮುಸಾಫಿರ್
The	ದಿ
Girl	ಗರ್ಲ್
Scout	ಸ್ಕೌಟ್
Gold	ಗೋಲ್ಡ್
Award	ಅವಾರ್ಡ್
Do	ದೋ
Roti	ರೋಟಿ
Derek	ಡೆರೆಕ್
Stirling	ಸ್ಟರ್ಲಿಂಗ್
Raj	ರಾಜ್
Nandini	ನಂದಿನಿ
Hamilton	ಹ್ಯಾಮಿಲ್ಟನ್
Masakadza	ಮಸಾಕಜಾ
Norwich	ನಾರ್ವಿಚ್
University	ಯೂನಿವರ್ಸಿಟಿ
Museum	ಮ್ಯೂಸಿಯಂ
Great	ಗ್ರೇಟ್
Basin	ಬೇಸಿನ್
Bosch	ಬೋಶ್
Chassis	ಚಾಸಿಸ್
Vartouhi	ವರ್ತೌಹಿ
Gurudwara	ಗುರುದ್ವಾರ
Punja	ಪಂಜಾ
Sahib	ಸಾಹಿಬ್
Aerona	ಏರೋನಾ
Benin	ಬೆನಿನ್
Bankimchandra	ಬಂಕಿಮಚಂದ್ರ
Museum-Art	ಮ್ಯೂಸಿಯಂ-ಆರ್ಟ್
Collection	ಕಲೆಕ್ಷನ್
of	ಆಫ್
the	ದ
National	ನ್ಯಾಶನಲ್
Bank	ಬ್ಯಾಂಕ್
Jawani	ಜವಾನಿ
Solah	ಸೋಲಹ್
Saal	ಸಾಲ್
Ki	ಕಿ
Stora	ಸ್ಟೋರಾ
Enso	ಎನ್ಸೋ
Rudolph	ರುಡೋಲ್ಫ್
Holikaa	ಹೋಲಿಕಾ
Abhisyant	ಅಭಿಷ್ಯಂತ್
Bhartiya	ಭಾರತೀಯ
Sarswati	ಸರಸ್ವತಿ
iGATE	ಐಗೇಟ್
Solutions	ಸಲ್ಯೂಷನ್ಸ್
Order	ಆರ್ಡರ್
of	ಆಫ್
Civil	ಸಿವಿಲ್
Merit	ಮೆರಿಟ್
Altai	ಅಲ್ಟಾಯ್
Jhoom	ಝೂಮ್
Utha	ಉಠಾ
Akaash	ಆಕಾಶ್
Banoo	ಬನ್ನೋ
Ivvavik	ಇವ್ವಾಕ್
Shafiek	ಶಫೀಕ್
Abrahams	ಅಬ್ರಹಾಮ್ಸ್
Phanse	ಫಣಸೆ
Shubhaasheesh	ಶುಭಾಶೀಷ್
Meghan	ಮೇಘನ್
Nirala	ನಿರಾಲಾ
Adishree	ಆದಿಶ್ರೀ
Abdul	ಅಬ್ದುಲ್
waliy	ವಲೀ
Dapodi	ದಾಪೋದೀ
Dispur	ದೀಸ್ಪುರ್
Abdur	ಅಬ್ದುರ್
rahaman	ರಹಮಾನ್
Henry	ಹೆನ್ರಿ
Ford	ಫೋರ್ಡ್
Avishkar	ಆವಿಶ್ಕಾರ್
Salvi	ಸಾಳ್ವಿ
Boris	ಬೋರಿಸ್
Pasternek	ಪ್ಯಾಸ್ಟರ್ನೆಕ್
Captain	ಕ್ಯಾಪ್ಟನ್
Kishore	ಕಿಶೋರ್
Lockheed	ಲಾಕ್‌ಹೀಡ್
Martin	ಮಾರ್ಟಿನ್
Bhatke	ಭಟಕೆ
Rahi	ರಾಹೀ
Neptunium	ನೆಪ್ಚುನಿಯಂ
Suvarnaprabha	ಸುವರ್ಣಪ್ರಭಾ
Sophia	ಸೋಫಿಯಾ
High	ಹೈ
School	ಸ್ಕೂಲ್
Stefan	ಸ್ಟೀಫನ್
Amin	ಅಮಿನ್
Jahangir	ಜಹಾಂಗಿರ್
Alam	ಅಲಾಂ
De	ಡಿ
Ruyter	ರೂಥರ್
Chubb	ಚುಬ್
Pushpa	ಪುಷ್ಪಾ
Urooj	ಉರೂಜ್
Shashiprabh	ಶಶಿಪ್ರಭ
Barsi	ಬಾರ್ಸಿ
Takli	ತಕ್ಲಿ
Gurudwara	ಗುರುದ್ವಾರ
Taashkand	ತಾಶ್‌ಕಂಡ್
Berger	ಬರ್ಜರ್
Paints	ಪೇಂಟ್ಸ್
Devajyoti	ದೇವಜ್ಯೋತಿ
Chhipadohar	ಛಿಪಾದೋಹರ್
Carlton	ಕಾರ್ಲ್ಟನ್
Bruce	ಬ್ರೂಸ್
Laird	ಲಾಯರ್ಡ್
Gold	ಗೋಲ್ಡ್
Medal	ಮೆಡಲ್
of	ಆಫ್
the	ದ
Royal	ರಾಯಲ್
Astronomical	ಅಸ್ಟ್ರಾನಾಮಿಕಲ್
Society	ಸೊಸೈಟಿ
Bhadravati	ಭದ್ರಾವತಿ
Ratan	ರತನ್
Deep	ದೀಪ್
To'ere	ಟಾಯ್ರಿ
Anis	ಅನೀಸ್
Somalakshmi	ಸೋಮಲಕ್ಷ್ಮಿ
Tareq	ತಾರೀಖ್
Aziz	ಅಝಿಜ್
Vipul	ವಿಪುಲ್
Ameenaa	ಅಮೀನಾ
Sri	ಶ್ರೀ
Ramakrishna	ರಾಮಕೃಷ್ಣಾ
Vidyashala,	ವಿದ್ಯಾಶಾಲಾ,
Mysore	ಮೈಸೂರ್
Merle	ಮೆರ್ಲೆ
Therese	ಥೇರೇಸಿ
Akmaal	ಅಕ್ಮಾಲ್
Theresa	ತೆರೇಸಾ
Nisal	ನಿಸಲ್
Fernando	ಫರ್ನಾಂಡೊ
Barad	ಬರಾಡ್
Canada's	ಕೆನಡಾಸ್
Walk	ವಾಕ್
of	ಆಫ್
Fame	ಫೇಮ್
Prashanti	ಪ್ರಶಾಂತಿ
Kameng	ಕಮೇಂಗ್
Abdul	ಅಬ್ದುಲ್
wahid	ವಹೀದ್
Cryptologic	ಕ್ರಿಪ್ಟೋಲಾಜಿಕ್
June	ಜೂನ್
Conocophillips	ಕೊನೊಕೊಫಿಲಿಪ್ಸ್
Saubal	ಸೌಬಲ್
Nehal	ನಿಹಾಲ್
Geranium	ಜೆರಾನಿಯಮ್
Train	ಟ್ರೇನ್
Dacoity	ಡಕಾಯ್ತಿ
Selene	ಸೆಲೀನ್
Vinny	ವಿನ್ನಿ
Fort	ಫೋರ್ಟ್
clatsop	ಕ್ಲಾಟ್‌ಸೊಪ್
Cuddalore	ಕಡಲೂರ್
Junction	ಜಂಕ್ಷನ್
Schock	ಸ್ಕೋಕ್
Prize	ಪ್ರೈಜ್
in	ಇನ್
Visual	ವಿಷುವಲ್
Arts	ಆರ್ಟ್ಸ್
Mitravaan	ಮಿತ್ರವಾನ್
Abdul	ಅಬ್ದುಲ್
wadud	ವದೂದ್
Shrikirti	ಶ್ರೀಕೀರ್ತಿ
Northern	ನಾರ್ದರ್ನ್
Territory	ಟೆರಿಟರಿ
University	ಯುನಿವರ್ಸಿಟಿ
Shehar	ಶೆಶಾರ್
Aur	ಔರ್
Sapna	ಸಪನಾ
Dainik	ದೈನಿಕ್
janambhumi	ಜನ್ಮಭೂಮಿ
Debra	ಡೆಬ್ರಾ
Winger	ವಿಂಗರ್
Aashaa	ಆಶಾ
Vitalis	ವಿಟಲಿಸ್
Rajeshwar	ರಾಜೇಶ್ವರ್
Medal	ಮೆಡಲ್
for	ಫಾರ್
Heroism	ಹೀರೋಯಿಸಮ್
in	ಇನ್
Silver	ಸಿಲ್ವರ್
Krishnagiri	ಕೃಷ್ಣಗಿರಿ
Reservoir	ರಿಜರ್ವಾಯರ್
Nakodar	ನಕೋದರ್
Luke	ಲ್ಯೂಕ್
Flint	ಫ್ಲಿಂಟ್
Clive	ಕ್ಲಿವ್
Radley	ರಾಡ್ಲೆ
Jheel	ಝೀಲ್
Ke	ಕೆ
Us	ಉಸ್
Paar	ಪಾರ್
Pyar	ಪ್ಯಾರ್
Ka	ಕಾ
Sagar	ಸಾಗರ್
Anadyant	ಅನಾದ್ಯಂತ
Marv	ಮಾರ್ವ್
Willie	ವಿಲೀ
Nelson	ವೆಲ್ಸನ್
Sa'ir	ಸಾಯಿರ್
Vineeta	ವಿನೀತಾ
Lokapradip	ಲೋಕಪ್ರದೀಪ್
Yasmine	ಯಾಸ್ಮಿನ್
Atonement	ಅಟೋನ್ಮೆಂಟ್
Lutheran	ಲುಥೆರಾನ್
Shiv	ಶಿವ
nandan	ನಂದನ್
Brooke	ಬ್ರೂಕ್
Shields	ಶೀಲ್ಡ್ಸ್
Dabur	ಡಾಬರ್
Pharma	ಫಾರ್ಮ
Khel	ಖೇಲ್
Kismat	ಕಿಸ್ಮತ್
Ka	ಕಾ
Murali	ಮುರುಳಿ
Kartik	ಕಾರ್ತಿಕ್
Anjaane	ಅಂಜಾನೆ
Jihan	ಜಿಹಾನ್
Dushmani	ದುಶ್ಮನಿ
Richelle	ರಿಶೋಲ್
Dhawan	ಧಾವನ್
Dalmau	ದಾಲಮಾವ್
Junction	ಜಂಕ್ಷನ್
University	ಯುನಿವರ್ಸಿಟಿ
of	ಆಫ್
Miami	ಮಿಯಾಮಿ
Sach	ಸಚ್
Leonard	ಲಿಯೋನಾರ್ಡ್
Nimoy	ನಿಮೋಯ್
Jeene	ಜೀನೆ
Ki	ಕಿ
Arzoo	ಆರಜೂ
Yauvani	ಯೋವನಿ
Sanchay	ಸಂಚಯ್
Girls	ಗರ್ಲ್ಸ್
Hostel	ಹಾಸ್ಟಲ್
Srimati	ಶ್ರೀಮತಿ
Sulochanadevi	ಸುಲೋಚನಾದೇವಿ
Singhania	ಸಿಂಘಾನಿಯಾ
School,	ಸ್ಕೂಲ್,
Thane	ಥಾಣೆ
Vevina	ವೆವಿನಾ
Jawani	ಜವಾನಿ
Ki	ಕಿ
Lehren	ಲಹರೇ
Kaspar	ಕಾಸ್ಪರ್
Lark	ಲಾರ್ಕ್
Zandunga	ಝಂಡುಂಗಾ
Ramanuj	ರಾಮಾನುಜ್
Bushra	ಬುಶ್ರಾ
Ajradaah	ಅಜ್ರದಾ
Kevin	ಕೆವಿನ್
Arnott	ಅರ್ನಾಟ್
Beacon	ಬೇಕನ್
hill	ಹಿಲ್
battery	ಬ್ಯಾಟರಿ
fort	ಫೋರ್ಟ್
Gangabhrit	ಗಂಗಾಬೃತ
Burhwal	ಬುಢವಾಲ್
Ghar	ಘರ್
Grihasti	ಗೃಹಸ್ಥೀ
Rawh	ರೌಹ್
Philippa	ಪಿಲಿಪ್ಪಾ
Ghufran	ಗುಫರಾನ್
Angelina	ಏಂಜೆಲಿನಾ
Shrikumari	ಶ್ರೀಕುಮಾರಿ
Valentina	ವ್ಯಾಲಂಟಿನಾ
Exxon	ಎಕ್ಸಾನ್
Valdez	ವಲ್ಡೇಜ್
Michael	ಮೈಕೇಲ್
Hussey	ಹಸ್ಸೆ
Machhal	ಮಛಲ್
Darsh	ದರ್ಶ್
Taro	ಟಾರೋ
Pharmaceutical	ಫಾರ್ಮಾಸ್ಯೂಟಿಕಲ್
Industries	ಇಂಡಸ್ಟ್ರೀಸ್
Fort	ಫೋರ್ಟ್
fareham	ಫರೇಹಮ್
Courtney	ಕೌರ್ಟ್ನಿ
Love	ಲೌವ್
Kumaar	ಕುಮಾರ್
Amolik	ಅಮೋಲಿಕ್
Qutb	ಕುತ್ಬ್
Comparsa	ಕಂಪಾರ್ಸಾ
Zulm	ಜುಲ್ಮ್
Ka	ಕಾ
Badla	ಬದಲಾ
Amitaabh	ಅಮಿತಾಭ್
Reekhabachandr	ರೀಖಾಬಚಂದ್ರ
Order	ಆರ್ಡರ್
of	ಆಫ್
Military	ಮಿಲಿಟರಿ
Merit	ಮೆರಿಟ್
Welham	ವೇಲ್ಹಾಮ್
Boys'	ಬಾಯ್ಸ್
School,	ಸ್ಕೂಲ್,
Dehradun	ಡೆಹ್ರಾಡೂನ್
Adbul	ಅಬ್ದುಲ್
qawi	ಕಾವಿ
Jai	ಜೈ
Ambe	ಅಂಬೆ
Maa	ಮಾ
Mercator	ಮರ್ಕೇಟರ್
Lines	ಲೈನ್ಸ್
Brett	ಬ್ರೆಟ್
Dorey	ಡೊರೆ
Marmit	ಮರ್ಮಿತ್
Bajaj	ಬಜಾಜ್
Sacred	ಸೇಕ್ರೆಡ್
Heart	ಹಾರ್ಟ್
Senior	ಸೀನಿಯರ್
Secondary	ಸೆಕೆಂಡರಿ
School,	ಸ್ಕೂಲ್,
Chandigarh	ಚಂಡೀಗಢ್
La	ಲಾ
Mauricie	ಮಾರಿಸಿ
Daksha	ದಕ್ಷ
Kalchakra	ಕಾಲಚಕ್ರ್
Saful	ಸಫುಲ್
islam	ಇಸ್ಲಾಂ
Carolina	ಕರೊಲಿನಾ
Ladaai	ಲಡಾಯಿ
National	ನ್ಯಾಶನಲ್
Order	ಆರ್ಡರ್
of	ಆಫ್
Quebec	ಕ್ಯೂಬೆಕ್
Terry	ಟೆರಿ
Alderman	ಆಲ್ಡರ್ಮನ್
Tarun	ತರುಣ್
Gurudwara	ಗುರುದ್ವಾರ
Bangla	ಬಂಗ್ಲಾ
Sahib	ಸಾಹಿಬ್
Cullman	ಕಲ್‌ಮ್ಯಾನ್
Ester	ಎಸ್ಟರ್
Ind	ಇಂಡ್
Tarub	ತರುಬ್
The	ದ
satyam	ಸತ್ಯಮ್
times	ಟೈಮ್ಸ್
Crest	ಕ್ರೆಸ್ಟ್
Animation	ಅನಿಮೇಶನ್
Jab	ಜಬ್
Yaad	ಯಾದ್
Kisi	ಕಿಸೀ
Ki	ಕಿ
Aati	ಆತಿ
Hai	ಹೈ
Baumgarten	ಬೌಮ್‌ಗಾರಟೆನ್
Prize	ಪ್ರೈಜ್
Intezar	ಇಂತಜಾರ್
Shams	ಶಮಾಸ್
Makatkar	ಮತಾಕರ್
Dhiren	ಧೀರೇನ್
Colin	ಕಾಲಿನ್
Cowdrey	ಕೌಡ್ರೆ
Gharoda	ಘರೋಡಾ
Mandy	ಮ್ಯಾಂಡಿ
Gurudas	ಗುರುದಾಸ್
Hendy	ಹೆಂಡಿ
Bryan	ಬ್ರಯಾನ್
San	ಸಾನ್
Diego	ಡೀಗೋ
Sati	ಸತಿ
Toral	ತೊರಾಲ
Farrar	ಫರಾರ್
Stone	ಸ್ಟೋನ್
Order	ಆರ್ಡರ್
of	ಆಫ್
National	ನ್ಯಾಶನಲ್
Security	ಸೆಕ್ಯೂರಿಟಿ
Merit	ಮೆರಿಟ್
Balasor	ಬಾಲಸೋರ್
Khubsurat	ಖೂಬಸೂರತ್
Kullursandai	ಕುಲ್ಲೂರ್‌ಸಂದೈ
Reservoir	ರಿಜರ್ವಾಯರ್
Flann	ಫ್ಲಾನ್
Raksha	ರಕ್ಷಾ
Bandhan	ಬಂಧನ್
Lojki	ಲೋಜ್ಕಿ
Gangaganj	ಗಂಗಾಗಂಜ್
Sheikh	ಶೇಖ್
Said	ಸಾಯಿದ್
Arche	ಆರ್ಕ್
Geraint	ಗೆರೆಂಟ್
Jones	ಜೋನ್ಸ್
Aldan	ಅಲ್ಡಾನ್
Bhayavadar	ಭಯವದರ್
Fort	ಫೋರ್ಟ್
assiniboine	ಆಸಿನ್‌ಬೊಯ್ನಿ
Himalay	ಹಿಮಾಲಯ್
University	ಯುನಿವರ್ಸಿಟಿ
College	ಕಾಲೇಜ್
London	ಲಂಡನ್
Hisham	ಹಿಶಮ್
Kabbani	ಕಬ್ಬಾನಿ
Sofia	ಸೋಫಿಯಾ
Gammon	ಗ್ಯಾಮನ್
India	ಇಂಡಿಯಾ
Patthar	ಪತ್ಥರ್
Havana	ಹವಾನಾ
Vipin	ವಿಪಿನ್
Kachche	ಕಚ್ಚೆ
Heere	ಹೀರಾ
Bu	ಬು
Ali	ಅಲಿ
Shah	ಶಾ
Qalandar	ಖಲಂದರ್
Bhaaskar	ಭಾಸ್ಕರ್
Wallbank	ವಾಲ್‌ಬ್ಯಾಂಕ್
University	ಯುನಿವರ್ಸಿಟಿ
of	ಆಫ್
Glasgow	ಗ್ಲಾಸ್ಗೋ
Maik	ಮೈಕ್
Kiran	ಕಿರಣ್
More	ಮೋರೆ
Gyanendra	ಗ್ಯಾನೇಂದ್ರ
Pandey	ಪಾಂಡೆ
Jagdeesh	ಜಗದೀಶ್
Alpine	ಅಲ್ಫೈನ್
University	ಯುನಿವರ್ಸಿಟಿ
of	ಆಫ್
Exeter	ಎಕ್ಸೆಟರ್
Raadhaa	ರಾಧಾ
Nai	ನಯೀ
Imarat	ಇಮಾರತ್
Vilyat	ವಿಲ್ಯತ್
Khan	ಖಾನ್
Demetria	ಡೆಮಿಟ್ರಯಾ
NELCO	ನೆಲ್ಕೋ
Amirah	ಅಮಿರಾ
Burbank	ಬರ್ಬಾಂಕ್
Boris	ಬೋರಿಸ್
Yeltsin	ಯೆಲ್ಸಿನ್
Primo	ಪ್ರಿಮೊ
Sugandhi	ಸುಗಂಧಿ
Katadare	ಕಾಟದರೆ
Vanhi	ವನ್ಹಿ
Bhattu	ಭಾಟು
Cianna	ಸಿಯಾನಾ
Ariadne	ಏರಿಯೇಡನ್
President	ಪ್ರೆಸಿಡೆಂಟ್
Hayes	ಹಯೀಸ್
Pyar	ಪ್ಯಾರ್
Ki	ಕಿ
Baaten	ಬಾತೇ
Hum	ಹಮ್
Intezaar	ಇಂತಜಾರ್
Karenge	ಕರೇಂಗೆ
Ganga	ಗಂಗಾ
Maiya	ಮೈಯಾ
Rangnathar	ರಂಗನಾಥರ್
Gratia	ಗ್ರೆಟಿಯಾ
Najeeb	ನಜೀಬ್
Balafon	ಬಲಫೋನ್
Hindu	ಹಿಂದು
American	ಅಮೇರಿಕನ್
Prabal	ಪ್ರಬಲ್
Rohan	ರೋಹನ್
Kanhai	ಕನ್ನಾಯ್
Rajendra	ರಾಜೇಂದ್ರ
Prasad	ಪ್ರಸಾದ್
Kawthar	ಕಾವ್ತಾರ್
"	ಎತ್ನೋಗ್ರಾಫಿಕಲ್ ಹಿಸ್ಟಾರಿಕಲ್ ಮ್ಯೂಸಿಯಂ ಆಫ್ ಲಾರಿಸಾ
Germaine	ಜರ್ಮೈನ್
Dobry	ಡಾಬ್ರೆ
Monty	ಮಾಂಟಿ
Panesar	ಪಾನೇಸರ್
Fateh	ಫತೇ
Yogish	ಯೋಗಿಶ್
Dillon	ಡಿಲ್ಲೊನ್
Waelhem	ವೆಲ್‌ಹೆಮ್
Sherkar	ಶೇರ್ಕರ್
Magdalen	ಮ್ಯಾಗ್ದಲೆನ್
Aabhaa	ಆಭಾ
Mugdha	ಮುಗ್ಧಾ
Paachanee	ಪಾಚಾನೀ
Matsya	ಮತ್ಸ್ಯಾ
Gandha	ಗಾಂಧಾ
Mirc	ಮಿರ್ಕ್
Electronic	ಎಲೆಕ್ಟ್ರಾನ್ಸಿಕ್ಸ್
Shiv	ಶಿವ
Charan	ಶರಣ್
Pushpinder	ಪುಷ್ಪಿಂದರ್
Jal	ಜಲ್
Bin	ಬಿನ್
Machali	ಮಛಲೀ
Jayashekhar	ಜಯಶೇಖರ್
Gunnar	ಗುನ್ನಾರ್
Myrdal	ಮಿರ್ಡಾಲ್
Bansi	ಬನ್ಸಿ
Paharpur	ಪಹಾರ್‌ಪುರ್
Field	ಫೀಲ್ಡ್
Hockey	ಹಾಕಿ
Vincent	ವಿನ್ಸೆಂಟ್
Van	ವ್ಯಾನ್
Gogh	ಗೋಹ್
Leverett	ಲೆವ್ರೆಟ್
Dhruv	ಧೃವ್
Srisailam	ಶ್ರೀಶೈಲಂ
Ati	ಅತಿ
Visisht	ವಿಶಿಷ್ಟ
Seva	ಸೇವಾ
Medal	ಮೆಡಲ್
New	ನ್ಯೂ
Hope	ಹೋಪ್
Community	ಕಮ್ಯುನಿಟಿ
Cape	ಕೇಪ್
Frontier	ಫ್ರಂಟಿಯರ್
War	ವಾರ್
Hirakud	ಹಿರಾಕುಡ್
Shiv	ಶಿವ
Leela	ಲೀಲಾ
Udhampur	ಉಧಾಮ್ ಪುರ್
Laurence	ಲಾರೆನ್ಸ್
Olivier	ಓಲಿವರ್ಸ್
Awards	ಅವಾರ್ಡ್ಸ್
Adityavardhan	ಆದಿತ್ಯವರ್ಧನ್
Hunting	ಹಂಟಿಂಗ್
Melbourne	ಮೆಲ್ಬಾರ್ನ್
Cup	ಕಪ್
Aafat	ಆಫತ್
Pahadi	ಪಹಾಡೀ
Kanya	ಕನ್ಯಾ
Melisande	ಮೆಲಿಸಂಡೇ
Deandra	ಡೆಂಡ್ರಾ
Fathom	ಫಥೊಮ್
Five	ಫೈವ್
Chanel	ಚೈನಲ್
Yadoon	ಯಾದೋ
Ka	ಕಾ
Mausam	ಮೌಸಮ್
Durvish	ದುರ್ವಿಶ್
Paap	ಪಾಪ್
Ka	ಕಾ
Anth	ಅಂತ್
Firoza	ಫಿರೋಜಾ
Matanga	ಮಾತಂಗ
Nanhe	ನನ್ಹೆ
Munne	ಮುನ್ನೆ
Mraganayanaa	ಮೃಗನಯನಾ
Sharan	ಶರಣ್
Taipei	ತೈಪೆ
101	101
Vitankar	ವಿಟಾಂಕರ್
Sapnon	ಸಪನೋ
Ka	ಕಾ
Saudagar	ಸಾಗರ್
German	ಜರ್ಮನ್
Historical	ಹಿಸ್ಟಾರಿಕಲ್
Museum	ಮ್ಯೂಸಿಯಂ
Allan	ಅಲನ್
Border	ಬಾರ್ಡರ್
Medal	ಮೆಡಲ್
Boxer	ಬಾಕ್ಸರ್
Shirley	ಶಿರ್ಲೆ
Aetna	ಏಟ್ನಾ
Cosette	ಕೋಸೆಟ್
Deswell	ಡೆಸ್ವೆಲ್
Industries	ಇಂಡಸ್ಟ್ರೀಸ್
Barh	ಬಾರ್ಹಾ
Burmah	ಬರ್ಮಾ
Road	ರೋಡ್
Maiyaa	ಮೈಯಾ
Open	ಓಪನ್
Door	ಡೋರ್
Baptist	ಬ್ಯಾಪ್ಟಿಸ್ಟ್
Devasheesh	ದೇವಶೀಶ್
Heroine	ಹೀರೋಯಿನ್
Bichpuri	ಬಿಛಪುರಿ
Saptahik	ಸಾಪ್ತಾಹಿಕ್
hindustan	ಹಿಂದೂಸ್ತಾನ್
Simmond	ಸಿಮ್ಮಾಂಡ್
Golden	ಗೋಲ್ಡನ್
Temple	ಟೆಂಪಲ್
Annora	ಅನ್ನೋರಾ
Veneriology	ವೆನಿರಿಯಾಲಜಿ
Luana	ಲುವಾನಾ
Kyzyl-Kum	ಕೈಜಲ್-ಕುಮ್
Sautela	ಸೌತೆಲಾ
Bhai	ಭೈ
Craig	ಕ್ರೆಗ್
Spearman	ಸ್ಪಿಯರ್‌ಮನ್
Mujhe	ಮುಝೆ
Jeene	ಜೀನಾ
Do	ದೋ
Tabla	ತಬಲಾ
Turkey	ಟರ್ಕಿ
trot	ಟ್ರಾಟ್
Peter	ಪೀಟರ್
Taylor	ಟೇಲರ್
Ghana	ಘಾನಾ
Sumter	ಸಮ್ಟರ್
Haddad	ಹದ್ದದ್
Kerryn	ಕೆರಿನ್
Durga	ದುರ್ಗಾ
Rangeela	ರಂಗೀಲಾ
Raja	ರಾಜಾ
Andhra	ಆಂಧ್ರ
bhoomi	ಭೂಮಿ
Chastity	ಚೆಸ್ಟೀ
Jallad	ಜಲ್ಲಾದ್
Mahabal	ಮಹಾಬಲ್
Lambada	ಲಂಬ್ಡಾ
Scouts	ಸ್ಕೌಟ್ಸ್
Lack	ಲ್ಯಾಕ್
Walesa	ವೆಲೇಸಾ
Mac	ಮ್ಯಾಕ್
Donnell	ಡೊನೆಲ್
Dan	ಡೆನ್
David	ಡೇವಿಡ್
Prize	ಪ್ರೈಜ್
Basava	ಬಸವಾ
Sagar	ಸಾಗರ್
Dam	ಡ್ಯಾಮ್
Khallad	ಖಲ್ಲಾಡ್
Gandhinagar	ಗಾಂಧಿನಗರ
Vrahaspativaar	ವೃಹಸ್ಪತಿವಾರ್
Chhapra	ಛಾಪ್ರಾ
Kacheri	ಕಚೇರಿ
Mere	ಮೇರೆ
Bhagwan	ಭಗವಾನ್
Ladka	ಲಡಕಾ
Ladki	ಲಡಕಿ
Akalkot	ಅಕಲ್ಕೋಟ್
Road	ರೋಡ್
Husn	ಹುಸ್ನ್
Ka	ಕಾ
Ghulam	ಗುಲಾಮ್
Schock	ಸ್ಕೋಕ್
Prize	ಪ್ರೈಜ್
in	ಇನ್
Mathematics	ಮ್ಯಾಥಮೆಟಿಕ್ಸ್
Finola	ಫಿನೋಲಾ
Arub	ಅರುಬ್
Renu	ರೇಣು
Kerinci	ಕೆರಿಂಚಿ
Seblat	ಸೆಬ್ಲಟ್
Manmayi	ಮನ್ಮಯಿ
Pradyot	ಪ್ರದ್ಯೋತ್
Arab	ಅರಬ್
Lewis	ಲಿವಿಸ್
Farrakhan	ಫರಾಖಾನ್
Anokha	ಅನೋಖಾ
Milan	ಮಿಲನ್
Kaaleecharan	ಕಾಳೀಚರಣ್
Pyas	ಪ್ಯಾಸ್
Gajaanan	ಗಜಾನನ
Namumkin	ನಾಮುಮಕಿನ್
Angaraj	ಅಂಗರಾಜ್
Abdul	ಅಬ್ದುಲ್
wahhab	ವಹಾಬ್
Romney	ರಾಮ್ನಿ
Aderyn	ಏಡೆರಿನ್
Motor	ಮೋಟಾರ್
Racing	ರೇಸಿಂಗ್
Augustus	ಆಗಸ್ಟಸ್
Lalaji	ಲಲಾಜಿ
Makhtooma	ಮಖತೂಮಾ
Vidyul	ವಿದ್ಯುಲ್
Hamara	ಹಮಾರಾ
Adhikar	ಅಧಿಕಾರ್
Shamsheer	ಶಮಶೀರ್
E	ಎ
Arab	ಅರಬ್
O	ಓ
Jane	ಜಾನೆ
Wale	ವಾಲೆ
Husn	ಹುಸ್ನ್
Aur	ಔರ್
Ishq	ಇಶ್ಕ್
Bisla	ಬಿಸ್ಲಾ
Geoff	ಜಿಯೋಫ್
Lawson	ಲಾಸನ್
Bisle	ಬಿಸ್ಲೆ
Rohit	ರೋಹಿತ್
Anant	ಅನಂತ್
Melanie	ಮಿಲಾನಿ
Griffith	ಗ್ರಿಫಿತ್
Afsana	ಅಫ್ಸಾನಾ
Pyar	ಪ್ಯಾರ್
Ka	ಕಾ
Prema	ಪ್ರೇಮಾ
America's	ಅಮೆರಿಕಾಸ್
Space	ಸ್ಪೇಸ್
Prize	ಪ್ರೈಜ್
Abdul	ಅಬ್ದುಲ್
muhaayi	ಮುಹಾಯಿ
Seva	ಸೇವಾ
Gram	ಗ್ರಾಮ್
Pelly	ಪೆಲ್ಲಿ
Birla	ಬಿರ್ಲಾ
Larchmont	ಲಾರ್ಚ್‌ಮಾಂಟ್
Avenue	ಅವೆನ್ಯೂ
Church	ಚರ್ಚ್
of	ಆಫ್
the	ದ
Open	ಓಪನ್
Door	ಡೋರ್
Silver	ಸಿಲ್ವರ್
Akosombo	ಅಕೋಸೋಂಬೋ
Dam	ಡ್ಯಾಮ್
Amritlal	ಅಮೃತಲಾಲ್
nagar	ನಗರ್
Iodine	ಅಯೋಡಿನ್
Hanfa	ಹನ್ಫಾ
Presidential	ಪ್ರೆಸಿಡೆನ್ಶಿಯಲ್
Medal	ಮೆಡಲ್
of	ಆಫ್
Freedom	ಫ್ರೀಡಂ
Fort	ಫೋರ್ಟ್
sheffield	ಶೆಫಿಲ್ಡ್
Lal	ಲಾಲ್
Batti	ಬತ್ತಿ
Raat	ರಾತ್
Andheri	ಅಂಧೇರಿ
Thi	ಥಿ
Reed	ರೀಡ್
Ayyappan	ಅಯ್ಯಪ್ಪನ್
Kermit	ಕೆರ್ಮಿಟ್
Saanch	ಸಾಂಚ್
Ko	ಕೋ
Aanch	ಆಂಚ್
Nahin	ನಹೀ
Shaun	ಶಾನ್
Udal	ಉಡಾಲ್
Vanhishikha	ವನ್ಶಿಕಾ
Abdul	ಅಬ್ದುಲ್
qayyoom	ಕಯ್ಯೂಮ್
Romeo	ರೋಮಿಯೋ
Juliet	ಜುಲಿಯಟ್
Gyaanaprakaash	ಜ್ಞಾನಪ್ರಕಾಶ್
Ek	ಏಕ್
Phool	ಪೂಲ್
Char	ಚಾರ್
Kante	ಕಾಂಟೆ
Roentgenium	ರೋಂಟ್‌ಜೀನಿಯಂ
Order	ಆರ್ಡರ್
of	ಆಫ್
Reverence	ರೆವೆರೆನ್ಸ್
Michael	ಮೈಕೇಲ್
Clarke	ಕ್ಲಾರ್ಕ್
George	ಜಾರ್ಜ್
Weston	ವೆಸ್ಟನ್
Potdar	ಪೋತದಾರ
Gumnaam	ಗುಮ್ನಾಮ್
Bijolia	ಬಿಜೋಲಿಯಾ
Rik	ರಿಕ್
Fort	ಫೋರ್ಟ್
hawkins	ಹಾಕಿನ್ಸ್
Dindigul	ದಿಂಡಿಗಲ್
Junction	ಜಂಕ್ಷನ್
Andher	ಅಂಧೆರ್
Nagari	ನಗರೀ
Chapat	ಚೌಪಟ್
Raja	ರಾಜಾ
Agostino	ಅಗೋಸ್ಟಿನೋ
Paul	ಪಾಲ್
and	ಅಂಡ್
Alexandra	ಅಲೆಕ್ಸಾಂಡ್ರಾ
Canellopoulos	ಕ್ಯಾನೆಲೊಪೊಲಾಸ್
Museum	ಮ್ಯೂಸಿಯಂ
Agosh	ಆಗೋಶ್
Amaatullah	ಅಮಾತುಲ್ಲಾ
Nellur	ನೆಲ್ಲೂರ್
Dadwal	ಡಡವಾಲ್
Sholayar	ಶೋಲಾಯರ್
Reservoir	ರಿಜರ್ವಾಯರ್
Dhari	ಧಾರೀ
Junction	ಜಂಕ್ಷನ್
Bob	ಬಾಬ್
Hope	ಹೋಪ್
Samtel	ಸ್ಯಾಮ್‌ಟೆಲ್
Color	ಕಲರ್
Rhone	ರೋನ್
Amajad	ಅಮಜದ್
Atacama	ಅಟಾಕಾಮಾ
Bharadwaj	ಭಾರದ್ವಾಜ್
Prakat	ಪ್ರಕಟ
Canon	ಕೆನನ್
del	ಡೆಲ್
Sumidero	ಸುಮಿಡೆರೊ
Warrick	ವಾರಕ್
Borgaonkar	ಬೋರಗಾವಕರ್
Chandok	ಚಂದೋಕ್
Gadagad	ಗದಾಗದ್
Shivaraam	ಶಿವರಾಮ
Graeme	ಗ್ರೇಮ್
Smith	ಸ್ಮಿತ್
Shantanu	ಶಾಂತನು
Vairaaj	ವೈರಾಜ್
Saahas	ಸಾಹಸ್
Goneana	ಗೊನೀಯಾನಾ
Kanpur	ಕಾನ್ಪುರ್
Order	ಆರ್ಡರ್
of	ಆಫ್
the	ದ
Redeemer	ರೆಡೀಮರ್
Edaline	ಎಡಲಿನ್
Aan	ಆನ್
Milo	ಮಿಲೋ
Sajna	ಸಜನಾ
Siyasat	ಸಿಯಾಸತ್
Baligh	ಬಲಿಗ್
University	ಯುನಿವರ್ಸಿಟಿ
of	ಆಫ್
Ballarat	ಬಲಾರಟ್
Jahan	ಜಹಾನ್
Ara	ಅರಾ
Main	ಮೈ
Hoon	ಹೂ
Jadugar	ಜಾದೂಗರ್
Library	ಲೈಬ್ರರಿ
of	ಆಫ್
Congress	ಕಾಂಗ್ರೆಸ್
Living	ಲಿವಿಂಗ್
Legend	ಲೆಜೆಂಡ್
Chipurupalle	ಚಿಪುರುಪಲ್ಲಿ
Mukilteo	ಮುಕಿಲ್ಟಿವೊ
Presbyterian	ಪ್ರೆಸ್ಬಿಟೇರಿಯನ್
Pehchan	ಪಹಚಾನ್
John	ಜಾನ್
Jameson	ಜೇಮ್ಸನ್
Citigroup	ಸಿಟಿಗ್ರೂಪ್
Uttar	ಉತ್ತರ್
Holi	ಹೋಲಿ
Ayee	ಆಯಿ
Re	ರೆ
Sanghod	ಸಂಘೋಡ್
Stephan	ಸ್ಟೀಫನ್
Khanna	ಖನ್ನಾ
Mangataraam	ಮಂಗತರಾಮ್
Maadrey	ಮಾದ್ರೇಯ್
Santander	ಸಾಂಟಾಂಡರ್
Central	ಸೆಂಟ್ರಲ್
IFlex	ಐಫ್ಲೆಕ್ಸ್
Solution	ಸಲ್ಯೂಷನ್ಸ್
Tyco	ಟೈಕೋ
International	ಇಂಟರ್ನ್ಯಾಷನಲ್
Sirvat	ಸಿರ್ವತ್
Murlin	ಮರ್ಲಿನ್
munro	ಮನ್ರೋ
Bheeshm	ಭೀಷ್ಮ್
Elke	ಎಲ್ಕೆ
Queen	ಕ್ವೀನ್
Elizabeth	ಎಲಿಜಬೆತ್
II	II
Hum	ಹಮ್
Dono	ದೋನೋ
Hero	ಹೀರೋ
Hiralal	ಹೀರಾಲಾಲ್
Viribus	ವಿರಿಬಸ್
Unitis	ಯುನಿಟಿಸ್
Sekhwa	ಸೆಖ್ವಾ
Marvin	ಮಾರ್ವಿನ್
Governor	ಗವರ್ನರ್
General's	ಜನರಲ್ಸ್
Award	ಅವಾರ್ಡ್
Alfa	ಆಲ್ಫಾ
Laval	ಲಾವಲ್
Prem	ಪ್ರೇಮ್
Ki	ಕಿ
Devi	ದೇವಿ
Paraas	ಪರಾಸ್
Fort	ಫೋರ್ಟ್
matanzas	ಮತಂಜಾಸ್
Bijli	ಬಿಜಲೀ
Eknath	ಏಕನಾಥ್
Solkar	ಸೋಳ್ಕರ್
Albatross	ಅಲ್ಬಟ್ರಾಸ್
Chromium	ಕ್ರೋಮಿಯಂ
Dyan	ಡೈನಾ
Jeevankala	ಜೀವನ್‌ಕಲಾ
Horse	ಹಾರ್ಸ್
sand	ಸ್ಯಾಂಡ್
fort	ಫೋರ್ಟ್
Zurich	ಜ್ಯೂರಿಕ್
Financial	ಫೈನಾನ್ಷಿಯಲ್
Services	ಸರ್ವಿಸಸ್
Athletics	ಅಥ್ಲೆಟಿಕ್ಸ್
Canada	ಕೆನಡಾ
Southern	ಸದರ್ನ್
Petroleum	ಪೆಟ್ರೋಲಿಯಂ
Giuseppe	ಗ್ಯುಸೆಪ್
Garibaldi	ಗರಿಬಲ್ದಿ
Sema	ಸೀಮಾ
Kodaganar	ಕೊಡಂಗನಾರ್
Reservoir	ರಿಜರ್ವಾಯರ್
Dharam	ಧರಮ್
Aur	ಔರ್
Kanoon	ಕಾನೂನ್
Raqibul	ರಖಿಬುಲ್
Hasan	ಹಸನ್
Bellsouth	ಬೆಲ್ ಸೌತ್
Faith	ಫೇತ್
Samrat	ಸಾಮ್ರಾಟ್
Chandragupt	ಚಂದ್ರಗುಪ್ತ್
Bluenose	ಬ್ಲೂನೋಸ್
Brittany	ಬ್ರಿಟ್ಟಾನಿ
Foolan	ಫೂಲನ್
Davidson	ಡೇವಿಡ್ಸನ್
Fynn	ಫಿನ್
Shabri	ಶಬರಿ
Rajdhani	ರಾಜಧಾನಿ
Anuhya	ಅನೂಹ್ಯ
Pakkhoke	ಪಖೋಕೆ
Bakhtaawar	ಭಕ್ತಾವರ್
Bindu	ಬಿಂದು
Obie	ಓಬೀ
Award	ಅವಾರ್ಡ್
Ram	ರಾಮ್
Laxman	ಲಕ್ಷ್ಮಣ್
Monish	ಮೋನಿಶ್
Vaageeshvar	ವಾಗೀಶ್ವರ್
Mangetar	ಮಂಗೇತರ್
Triumph	ಟ್ರಿಂಪ್
Eilis	ಈಲಿಸ್
Ellamanchili	ಎಲಮನ್ಚಿಲಿ
Milan	ಮಿಲನ್
Ki	ಕಿ
Raat	ರಾತ್
Qiana	ಕ್ವಿಯಾನಾ
Bhola	ಭೊಲ್ಲಾ
Shankar	ಶಂಕರ್
Graeme	ಗ್ರೀಮ್
Porter	ಪೋರ್ಟರ್
Fort	ಫೋರ್ಟ್
mcclary	ಮ್ಯಾಕ್‌ಕ್ಲಾರಿ
Krittika	ಕೃತ್ತಿಕಾ
Robin	ರಾಬಿನ್
Brown	ಬ್ರೌನ್
Geodesic	ಜಿಯೊಡೆಸಿಕ್
Yagy	ಯಾಜಿ
Kutharaiyar	ಕುಥಾರಾಯರ್
Reservoir	ರಿಜರ್ವಾಯರ್
Appu	ಅಪ್ಪು
Raja	ರಾಜಾ
Qayamat	ಕಯಾಮತ್
Ki	ಕೀ
Raat	ರಾತ್
Jawara	ಜವಾರಾ
James	ಜೇಮ್ಸ್
Michener	ಮಿಕೆನರ್
Sankoch	ಸಂಕೋಚ್
Shikayat	ಶಿಕಾಯತ್
Abdus	ಅಬ್ದುಸ್
Maisie	ಮೈಸಿ
Pisa	ಪೀಸಾ
Galileo	ಗೆಲಿಲಿಯೊ
Galilei	ಗೆಲಿಲಿ
Abdul	ಅಬ್ದುಲ್
Pramila	ಪ್ರಮೀಳಾ
Adityapur	ಆದಿತ್ಯಾಪುರ್
Fort	ಫೋರ್ಟ್
le	ಲೆ
vieux	ವಿಕ್ಸ್
Guido	ಗುಯ್ಡೊ
Figure	ಫಿಗರ್
Skating	ಸ್ಕೇಟಿಂಗ್
Guru	ಗುರು
Ghantal	ಘಂಟಾಲ್
Thorington	ತೊರಿಂಗ್ಟನ್
Road	ರೋಡ್
Baptist	ಬ್ಯಾಪ್ಟಿಸ್ಟ್
Edinburgh	ಎಡಿನ್‌ಬರ್ಗ್
College	ಕಾಲೇಜ್
of	ಆಫ್
Art	ಆರ್ಟ್
Bandurria	ಬಂಡುರಿಯಾ
Laxmi	ಲಕ್ಷ್ಮಿ
Shukla	ಶುಕ್ಲಾ
Saint	ಸೆಂಟ್
lucian	ಲ್ಯುಕಿಯನ್
tower	ಟವರ್
Meru	ಮೆರು
Hans	ಹನ್ಸ್
Christian	ಕ್ರಿಸ್ಟಿಯನ್
Andersen	ಆಂಡರ್ಸನ್
Della	ಡೆಲ್ಲಾ
Yeshiva	ಯೆಶಿವಾ
University	ಯೂನಿವರ್ಸಿಟಿ
Museum	ಮ್ಯೂಸಿಯಂ
Jawani	ಜವಾನಿ
Ke	ಕೆ
Gunah	ಗುನಾಹ್
Aspreva	ಆಸ್ಪ್ರೆವಾ
Pharmaceuticals	ಫಾರ್ಮಾಸ್ಯೂಟಿಕಲ್ಸ್
Corporation	ಕಾರ್ಪೊರೇಶನ್
Ruth	ರುಥ್
Bader	ಬೇಡರ್
Ginsburg	ಗಿನ್ಸ್‌ಬರ್ಗ್
Amerada	ಅಮೆರಡಾ
Hess	ಹೆಸ್
Bargarh	ಬಾರಗಢ್
Road	ರೋಡ್
Aahwanit	ಆಹ್ವಾನಿತ್
Arad	ಅರದ್
fort	ಫೋರ್ಟ್
Jamie	ಜಾಮಿ
Siddons	ಸಿಡೋನ್ಸ್
Jangal	ಜಂಗಲ್
Mein	ಮೆ
Mangal	ಮಂಗಲ್
Guntur	ಗುಂಟೂರು
Weissenburg	ವೆಸಿನ್‌ಬರ್ಗ್
Saajan	ಸಾಜನ್
Bina	ಬಿನಾ
Suhagan	ಸುಹಾಗನ್
Kaun	ಕೌನ್
Apana	ಅಪನಾ
Kaun	ಕೌನ್
Paraya	ಪರಾಯಾ
Freddie	ಫ್ರೆಡ್ಡೀ
Mac	ಮ್ಯಾಕ್
Bahu	ಬಹು
Ki	ಕಿ
Awaaz	ಆವಾಜ್
Saagar	ಸಾಗರ
devataa	ದೇವತಾ
Tamatha	ತಮಾತಾ
Santayani	ಸಂತಯಾನೀ
Borneo	ಬೋರ್ನಿ
Hera	ಹೀರಾ
Gurudwara	ಗುರುದ್ವಾರ
Bibeksar	ಬಿಬೇಕ್‌ಸರ್
Humber	ಹಂಬರ್
Art	ಆರ್ಟ್
Sunje	ಸುಂಜ್
Museum	ಮ್ಯೂಸಿಯಂ
Mohabbat	ಮೊಹಬ್ಬತ್
Foster's	ಫೋಸ್ಟರ್ಸ್
Beer	ಬೀರ್
All-America	ಆಲ್-ಅಮೆರಿಕಾ
City	ಸಿಟಿ
Award	ಅವಾರ್ಡ್
Door	ದೂರ್
Door	ದೂರ್
Paas	ಪಾಸ್
Paas	ಪಾಸ್
Maa	ಮಾ
Bahen	ಬಹನ್
Aur	ಔರ್
Biwi	ಬೀವಿ
Wahla	ವಾಹಲಾ
Dalmia	ಡಾಲ್ಮಿಯಾ
Cement	ಸಿಮೆಂಟ್
Scott	ಸ್ಕಾಟ್
Styris	ಸ್ಟೈರಿಸ್
Hena	ಹೀನಾ
Mutatkar	ಮುತಾತ್ಕರ್
Beed	ಬೀಡ್
Swaha	ಸ್ವಾಹಾ
Fort	ಫೋರ್ಟ್
borstal	ಬೋರ್‌ಸ್ಟಲ್
Niggly	ನಿಗ್ಲಿ
Masta	ಮಸ್ತಾ
Fakir	ಫಕೀರ್
Lear	ಲಿಯರ್
Bow	ಬೋ
Derrick	ಡೆರಿಕ್
Burdah	ಬುರ್ದಾ
Rajagopala	ರಾಜಗೋಪಾಲ
Ramat-Gan	ರಮತ್-ಗನ್
Fritz	ಫ್ರಿಟ್ಜ್
Pregl	ಪ್ರೆಗ್ಲ್
Prize	ಪ್ರೈಜ್
Suru	ಸುರು
Nayak	ನಾಯಕ್
Pervez	ಪರ್ವೆಜ್
Mir	ಮಿರ್
Broadmoor	ಬ್ರಾಡ್ಮೂರ್
Baptist	ಬ್ಯಾಪ್ಟಿಸ್ಟ್
Frederic	ಫ್ರೆಡ್ರಿಕ್
Esser	ಈಸರ್
Nemmers	ನೇಮರ್ಸ್
Prize	ಪ್ರೈಜ್
Big	ಬಿಗ್
Brother	ಬ್ರದರ್
Awards	ಅವಾರ್ಡ್ಸ್
Do	ದೋ
Qaidi	ಕೈದಿ
Indal	ಇಂಡಲ್
Amir	ಅಮೀರ್
Khusro	ಖುಸ್ರೋ
Dehlo	ದೆಹ್ಲೋ
Parveen	ಪರ್ವೀನ್
Nanad	ನನದ್
Bhaujai	ಭೌಜಾಯಿ
Devvrat	ದೇವರತ್
Bitragunta	ಬಿತ್ರಾಗುಂಟಾ
Koryak	ಕೊರ್ಯಾಕ್
George	ಜಾರ್ಜ್
Kolbe	ಕೋಲ್ಬೇ
Museum	ಮ್ಯೂಸಿಯಂ
Tapan	ತಪನ್
Natiq	ನತೀಕ್
Balearic	ಬಲೇರಿಕ್
Thunderer	ಥಂಡರರ್
Thuringen	ಥರಿಂಗನ್
Devayush	ದೇವಯುಶ್
Darcie	ದಾರ್ಸಿ
Chakri	ಚಕ್ರಿ
Nareubet	ನರುಬೆಟ್
Amurt	ಅಮೂರ್ತ್
Kusumavati	ಕುಸುಮಾವತಿ
Madadgar	ಮದದ್‌ಗಾರ್
Fluorine	ಫ್ಲೋರಿನ್
Muhajir	ಮುಹಾಜಿರ್
Abdul	ಅಬ್ದುಲ್
azeez	ಅಜೀಜ್
Lesa	ಲೆಸಾ
Mangal	ಮಂಗಲ್
Dada	ದಾದಾ
Dil	ದಿಲ್
Dil	ದಿಲ್
Ka	ಕಾ
Thug	ಠಗ್
Gursar	ಗುರ್ಸಾರ್
Shnewala	ಸ್ನೇವಾಲಾ
Seemantini	ಸೀಮಂತಿನಿ
Iain	ಇಯಾನ್
Butchart	ಬುಚಾರ್ಟ್
Aayushman	ಆಯುಷ್ಮಾನ್
Financial	ಫೈನಾನ್ಶಿಯಲ್
express	ಎಕ್ಸ್‌ಪ್ರೆಸ್
Sharadini	ಶಾರದಿನಿ
Muazah	ಮುಆಜಾಹ್
Metripolitan	ಮೆಟ್ರಿಪೊಲಿಟನ್
Museum	ಮ್ಯೂಸಿಯಂ
of	ಆಫ್
art	ಆರ್ಟ್
Chamila	ಚಮೀಲ
Gamage	ಗಮಗೆ
Mera	ಮೇರಾ
Karam	ಕರಮ್
Mera	ಮೇರಾ
Dharam	ಧರಮ್
Gir	ಗಿರ್
Manojav	ಮನೋಜವ
Manaj	ಮಾನಜ್
Chemancheri	ಚೆಮನ್‌ಚೆರಿ
Champakali	ಚಂಪಕಲೀ
Ghaziyah	ಗಾಜಿಯಾಹ್
Pothohar	ಪೋಠೋಹಾರ್
Kendrapada	ಕೇಂದ್ರಪಾಡ
Voltas	ವೋಲ್ಟಾಸ್
John	ಜಾನ್
Jani	ಜಾನಿ
Janardan	ಜನಾರ್ದನ್
Deol	ಡಿಯೊಲ್
Abhayananda	ಅಭಯಾನಂದ
Abhishek	ಅಭಿಷೇಕ್
Pamelia	ಪಮೇಲಿಯಾ
Fia	ಫಿಯಾ
Score	ಸ್ಕೋರ್
Kal	ಕಲ್
Hamara	ಹಮಾರಾ
Hai	ಹೈ
Abhishok	ಅಭಿಶೋಕ್
Gundardehi	ಗುಂದರದೆಹಿ
Hum	ಹಮ್
Se	ಸೆ
Na	ನಾ
Jeeta	ಜೀತಾ
Koi	ಕೋಯಿ
Hind	ಹಿಂದ್
Oil	ಆಯಿಲ್
Explor	ಎಕ್ಸ್‌ಪ್ಲೋರ್
Heriot-Watt	ಹೆರಿಯಟ್-ವಾಟ್
University	ಯುನಿವರ್ಸಿಟಿ
Yasir	ಯಾಸಿರ್
Arafat	ಅರಾಫತ್
Lily	ಲಿಲಿ
Manohar	ಮನೋಹರ
Burnpur	ಬುರ್ನಪುರ್
Raat	ರಾತ್
Ke	ಕೆ
Rahi	ರಾಹಿ
Malcolm	ಮಾಲ್ಕಂ
Jarvis	ಜಾರ್ವಿಸ್
Maharani	ಮಹಾರಾಣಿ
Padmini	ಪದ್ಮಿನಿ
Annabelle	ಅನಾಬೆಲ್ಲಿ
Condecoracion	ಕಾಂಡೆಕೊರಾಕಿಯನ್
Miguel	ಮಿಗಿಯುಲ್
Hidalgo	ಹಿಡಲ್ಗೊ
Olesia	ಒಲೀಸಿಯಾ
Nissan	ನಿಸಾನ್
Motor	ಮೋಟರ್
Bhairav	ಭೈರವ್
Paheli	ಪಹೇಲಿ
Fender	ಫೆಂಡರ್
Rhodes	ರೋಡ್ಸ್
Deiter	ಡೀಟರ್
Sandhyanand	ಸಂಧ್ಯಾನಂದ್
Ab	ಅಬ್
Dilli	ದಿಲ್ಲಿ
Door	ದೂರ್
Nahin	ನಹೀ
Cameron	ಕೆಮರೂನ್
Cuffy	ಕಫಿ
Do	ದೋ
Khiladi	ಖಿಲಾಡಿ
Patralekha	ಪತ್ರಲೇಖ
Anandpur	ಆನಂದ್‌ಪುರ್
Sahib	ಸಾಹಿಬ್
Ek	ಏಕ್
Kali	ಕಲೀ
Muskai	ಮುಸ್ಕಾಯಿ
Navin	ನವಿನ್
Gihlan	ಗಿಲ್ಹನ್
Hanmee	ಹಾನ್ಮೀ
Presbyterian	ಪ್ರೆಸ್ಬಿಟೇರಿಯನ್
Gautami	ಗೌತಮೀ
Knorr	ನೋರ್
Kamakhya	ಕಾಮಾಖ್ಯ
devi	ದೇವಿ
Dhirganj	ಧೀರಗಂಜ್
Bajaj	ಬಜಾಜ್
Group	ಗ್ರೂಪ್
Manavendra	ಮಾನವೇಂದ್ರ
Denis	ಡೆನಿಸ್
Crete	ಕ್ರೀಟ್
Maritime	ಮೆರಿಟೈಮ್
Museum	ಮ್ಯೂಸಿಯಂ
Manasvi	ಮನಸ್ವಿ
Thomas	ಥಾಮಸ್
Stone	ಸ್ಟೋನ್
Fort	ಫೋರ್ಟ್
dix	ಡಿಕ್ಸ್
Ranaveer	ರಣವೀರ್
Gopinath	ಗೋಪಿನಾಥ್
Mohanti	ಮೊಹಂತಿ
Haridwar	ಹರಿದ್ವಾರ್
Manjyot	ಮನ್‌ಜ್ಯೋತ್
Aasami	ಅಸ್ಸಾಮಿ
Ajooba	ಅಜೂಬಾ
Dassault	ದಸ್ಸಾಲ್ಟ್
Systems	ಸಿಸ್ಟಮ್ಸ್,
Sindhu	ಸಿಂಧು
Ghar	ಘರ್
Dwar	ದ್ವಾರ್
Saggu	ಸಗ್ಗು
Agrimaa	ಅಗ್ರಿಮಾ
Delora	ಡೆಲೇರೊ
Ab	ಅಬ್
Kya	ಕ್ಯಾ
Hoga	ಹೋಗಾ
Paapi	ಪಾಪಿ
Sansar	ಸನ್ಸಾರ್
Giriraaj	ಗಿರಿರಾಜ್
Balaveer	ಬಲವೀರ್
Riyasat	ರಿಯಾಸತ್
Bear	ಬಿಯರ್
River	ರಿವರ್
Nasik	ನಾಸಿಕ್
Jai	ಜೈ
Ambe	ಅಂಬೆ
Freer	ಫ್ರೀರ್
Gallery	ಗ್ಯಾಲರಿ
of	ಆಫ್
Art	ಆರ್ಟ್
Macquarie	ಮೆಕ್ವಾರೀ
University	ಯುನಿವರ್ಸಿಟಿ
Phool	ಪೂಲ್
Aur	ಔರ್
Patthar	ಪತ್ಥರ್
Peace	ಪೀಸ್
Lutheran	ಲುತೆರನ್
Chosla	ಚೋಸ್ಲಾ
Maluku	ಮಲುಕು
and	ಅಂಡ್
Irian	ಇರಿಯನ್
Jaya	ಜಾಯಾ
Anupam	ಅನುಪಮ್
Shankar	ಶಂಕರ್
Parvati	ಪಾರ್ವತಿ
The	ದ
asian	ಏಶಿಯನ್
age	ಏಜ್
Takeda	ತಕೇಡಾ
Award	ಅವಾರ್ಡ್
Siddhu	ಸಿದ್ಧೂ
Shoushan	ಶೌಶನ್
Ajmani	ಅಜ್ಮಾನಿ
British	ಬ್ರಿಟಿಷ್
Comedy	ಕಾಮೆಡಿ
Awards	ಅವಾರ್ಡ್ಸ್
Pepin	ಪೆಪಿನ್
Mahaaksh	ಮಹಾಕ್ಷ
Jeff	ಜೆಫ್
Bridges	ಬ್ರಿಡ್ಜಸ್
Raakhi	ರಾಖಿ
London	ಲಂಡನ್
Express	ಎಕ್ಸ್‌ಪ್ರೆಸ್
Naqid	ನಾಖಿದ್
Cairbre	ಕೇರ್ಬ್ರಿ
Paharpur	ಪಹಾರ್‌ಪುರ್
Cooling	ಕೂಲಿಂಗ್
Towers	ಟವರ್ಸ್
Elburz	ಎಲ್‌ಬುರ್ಜ್
Neil	ನೀಲ್
Fairbrother	ಫೇರ್‌ಬ್ರದರ್
Channery	ಚನೇರಿ
People's	ಪೀಪಲ್ಸ್
Choice	ಚಾಯ್ಸ್
Award	ಅವಾರ್ಡ್
Mastana	ಮಸ್ತಾನಾ
Abhr	ಅಭ್ರ
Jawhar	ಜವಹರ್
Mastani	ಮಸ್ತಾನೀ
Aangan	ಆಂಗನ್
Cherry	ಚೆರ್ರಿ
Carl	ಕಾರ್ಲ್
Bulfin	ಬಲ್ಫಿನ್
David	ಡೇವಿಡ್
Mutendera	ಮುಟೆಂಡರಾ
Bhagavat	ಭಗವತ
Rishta	ರಿಶ್ತಾ
Kagaz	ಕಾಗಜ್
Ka	ಕಾ
Kaushik	ಕೌಶಿಕ್
Amalean	ಅಮಲೀನ್
Skating	ಸ್ಕೇಟಿಂಗ್
Sawan	ಸಾವನ್
Bhadon	ಭಾದೋ
Ghungroo	ಘುಂಗರೂ
Ki	ಕಿ
Awaz	ಆವಾಜ್
Balagovind	ಬಾಲಗೋವಿಂದ್
Spector	ಸ್ಪೆಕ್ಟರ್
Naparajit	ನಪರಾಜಿತ್
Georgianne	ಜಾರ್ಜಿಯಾನಿ
General	ಜನರಲ್
George	ಜಾರ್ಜ್
Castro	ಕ್ಯಾಸ್ಟ್ರೋ
Hindustan	ಹಿಂದೂಸ್ತಾನ್
Lever	ಲೀವರ್
Saint	ಸೇಂಟ್
Olavs	ಒಲಾವ್ಸ್
medal	ಮೆಡಲ್
Ytterbium	ಯೆಟರ್‌ರ್ಬಿಯಂ
Mera	ಮೇರಾ
Desh	ದೇಶ್
Mera	ಮೆರಾ
Dharam	ಧರ್ಮ್
Carl	ಕಾರ್ಲ್
Vinson	ವಿನ್ಸನ್
Azra	ಅಜ್ರಾ
Gary	ಗ್ಯಾರಿ
Kirsten	ಕರ್ಸ್ಟನ್
Awaragardi	ಆವಾರಾಗರ್ದೀ
Mera	ಮೇರಾ
Munna	ಮುನ್ನಾ
Denise	ಡೆನೈಸ್
Trieste	ಟ್ರಿಸ್ಟೆ
Takiuddeen	ತಾಕಿವುದ್ದೀನ್
Juneja	ಜುನೇಜಾ
Osmond	ಆಸ್ಮಂಡ್
Badriyah	ಬದ್ರಿಯಾ
Gibbons	ಗಿಬ್ಬನ್ಸ್
Miami	ಮಿಯಾಮಿ
University	ಯುನಿವರ್ಸಿಟಿ
Gajraula	ಗಜ್ರೌಲಾ
Junction	ಜಂಕ್ಷನ್
Jajpur	ಜಾಜ್ಪುರ್
Ciel	ಸಿಯೆಲ್
Akutagawa	ಅಕುಟಗವಾ
Prize	ಪ್ರೈಜ್
Cuatro	ಕ್ವಾಟ್ರೊ
Fish	ಫಿಶ್
River	ರಿವರ್
Canyon	ಕ್ಯಾನ್ಯೋನ್
Paap	ಪಾಪ್
Aur	ಔರ್
Punya	ಪುಣ್ಯ್
Raakhee	ರಾಖೀ
Yamamah	ಯಾಮಮ
Gydan	ಗೈಡನ್
Ryan	ರಯಾನ್
Ramdass	ರಾಮ್‌ದಾಸ್
Hum	ಹಮ್
Tum	ತುಮ್
Aur	ಔರ್
Who	ವೋ
Edwin	ಎಡ್ವಿನ್
Gachhipura	ಗಚ್ಚಿಲಿಪುರಾ
Jaipur	ಜೈಪುರ
Diwankhavati	ದಿವಾನಖಾವತಿ
Hosanna	ಹೊಸಾನಾ
Lutheran	ಲುಥೆರನ್
Chand	ಚಂದ್
Chakori	ಚಕೋರಿ
Crocker	ಕ್ರಾಕರ್
Jasrah	ಜಸ್ರಾ
Bhagirathi	ಭಾಗೀರಥಿ
Zakhmi	ಜಖ್ಮೀ
Sher	ಶೇರ್
Kaaran	ಕಾರಣ್
Dawlat	ದೌಲತ್
Aan	ಆನ್
Baan	ಬಾನ್
Saarangee	ಸಾರಂಗೀ
Malise	ಮ್ಯಾಲಿಸ್
Aurat	ಔರತ್
Pair	ಪೈರ್
Ki	ಕಿ
Joti	ಜೂತೀ
Nahin	ನಹೀ
Cellebes	ಸೆಲ್ಲಿಬೆಸ್
Phazom	ಫಾಜೋಂ
Nishan	ನಿಶಾನ್
Danka	ಡಂಕಾ
Pathan	ಪಠಾನ್
Matthew	ಮ್ಯಾಥ್ಯೂ
Bell	ಬೆಲ್
Tatra	ಟಾಟ್ರಾ
Shardul	ಶಾರ್ದುಲ್
Aanandini	ಆನಂದಿನಿ
Moses	ಮೋಸೆಸ್
Rafiqah	ರಫಿಕಾ
Alphonse	ಅಲ್ಫೋನ್ಸ್
Chetan	ಚೇತನ್
Chauhan	ಚೌಹಾನ್
Gurbachan	ಗುರುಬಚನ್
Peruvaripallam	ಪೆರುವರಿಪಳ್ಳಂ
Nazih	ನಾಜೀ
Edric	ಎಡ್ರಿಕ್
Cathedral	ಕ್ಯಥೆಡ್ರಲ್
and	ಅಂಡ್
John	ಜಾನ್
Connon	ಕೊನ್ನನ್
School,	ಸ್ಕೂಲ್,
Mumbai	ಮುಂಬೈ
Alaina	ಅಲೈನಾ
Flamel	ಫ್ಲೇಮೆಲ್
Technologies	ಟೆಕ್ನಾಲಜೀಸ್
Sumantra	ಸುಮಂತ್ರಾ
Robert	ರಾಬರ್ಟ್
Bridges	ಬ್ರಿಜಸ್
Derrick	ಡೆರಿಕ್
David	ಡೇವಿಡ್
Chapel	ಚಾಪೆಲ್
Missionary	ಮಿಶನರಿ
Baptist	ಬ್ಯಾಪ್ಟಿಸ್ಟ್
Keshi	ಕೇಶಿ
Uttam	ಉತ್ತಮ್
Galva	ಗಾಲ್ವಾ
Gillespie	ಗಿಲೆಸ್ಪೀ
Mujhe	ಮುಝೆ
Vachan	ವಚನ್
Do	ದೋ
Wawona	ವೆವೋನಾ
Owais	ಒವೈಸ್
Akila	ಅಕಿಲಾ
daily	ಡೈಲಿ
Draco	ಡ್ರ್ಯಾಕೊ
Night	ನೈಟ್
Bird	ಬರ್ಡ್
Camden	ಕ್ಯಾಮ್ಡೆನ್
Copley	ಕಾಪ್ಲೆ
Medal	ಮೆಡಲ್
Arthur	ಆರ್ಥರ್
Sarakatsanoi	ಸರಕಾಸನೋಯ್
Folklore	ಫೋಕ್ಲೋರ್
Museum	ಮ್ಯೂಸಿಯಂ
Chirayinkil	ಚಿರಾಯಿನ್‌ಕಿಲ್
Escondido	ಎಸ್ಕೋಂಡಿಡೊ
Joel	ಜೋಯಲ್
Garner	ಗಾರ್ನರ್
Jiniteshnar	ಜಿನಿತೇಶನರ್
Robbie	ರಾಬೀ
Hart	ಹಾರ್ಟ್
Ivory	ಐವರಿ
Abdul	ಅಬ್ದುಲ್
matin	ಮತೀನ್
Bhadohi	ಭಡೋಹಿ
Diler	ದಿಲೇರ್
Hanwha	ಹಾನ್ವಾ
Banarasi	ಬನಾರಸೀ
Thug	ಠಗ್
Is	ಇಸ್
Paar	ಪಾರ್
Ya	ಯಾ
Us	ಉಸ್
Paar	ಪಾರ್
Kanakpriya	ಕನಕಪ್ರಿಯ
Central	ಸೆಂಟ್ರಲ್
Michigan	ಮಿಚಿಗನ್
University	ಯುನಿವರ್ಸಿಟಿ
Devar	ದೇವರ್
Bhabi	ಭಾಭೀ
Fenella	ಫೆನೆಲಾ
Kamana	ಕಾಮನಾ
Felis	ಫೆಲಿಸ್
Shelf	ಶೆಲ್ಫ್
Futuremedia	ಫ್ಯೂಚರ್‌ಮೀಡಿಯಾ
Public	ಪಬ್ಲಿಕ್
Limited	ಲಿಮಿಟೆಡ್
Company	ಕಂಪನಿ
Algiers	ಅಲ್ಜೀರ್ಸ್
Nagarjuna	ನಾಗಾರ್ಜುನಾ
Fert	ಫರ್ಟ್
Janmabhoomi	ಜನ್ಮಭೂಮಿ
Kainji	ಕೈಂಜಿ
dam	ಡ್ಯಾಮ್
Meri	ಮೇರಿ
Zubaan	ಜುಬಾನ್
Pramit	ಪ್ರಮಿತ್
Khulud	ಖುಲೂದ್
Vesuvius	ವೆಸುವಿಯಸ್
India	ಇಂಡಿಯಾ
Motor	ಮೋಟಾರ್
cycling	ಸೈಕ್ಲಿಂಗ್
George	ಜಾರ್ಜ್
Lavina	ಲವೀನಾ
Bhagwat	ಭಗವತ್
Mahima	ಮಹಿಮಾ
Prasanna	ಪ್ರಸನ್ನ
Jayawardene	ಜಯವರ್ದನೆ
Sanath	ಸನತ್
Kaluperuma	ಕಲುಪೆರುಮ
Devnath	ದೇವನಾಥ್
Krone	ಕ್ರೋನ್
Lipi	ಲಿಪಿ
Krona	ಕ್ರೋನಾ
Do	ದೋ
Premee	ಪ್ರೇಮೀ
Sajjo	ಸಜ್ಜೋ
Rani	ರಾಣಿ
Ayushmati	ಆಯುಷ್ಮತಿ
Dhadial	ಢಡಿಯಾಲ್
Bhindra	ಭಿಂಡರಾ
Carl	ಕಾರ್ಲ್
Friedrich	ಫ್ರೈಡ್‌ರಿಚ್
Gauss	ಗಾಸ್
Prize	ಪ್ರೈಜ್
Vijayaa	ವಿಜಯಾ
Shekhar	ಶೇಖರ್
Mera	ಮೇರಾ
Naam	ನಾಮ್
Fujitsu	ಫ್ಯುಜಿಟ್ಸು
Do	ದೋ
Dushman	ದಶಮನ್
Pakhewal	ಪಖೇವಾಲ್
Mandape	ಮಂಡಪೆ
Perrier	ಪೆರ್ರಿಯರ್
Comedy	ಕಾಮೆಡಿ
Award	ಅವಾರ್ಡ್
Kanta	ಕಾಂತಾ
Karunamay	ಕರುಣಾಮಯ
Hornet	ಹಾರ್ನೆಟ್
Gajraj	ಗಜರಾಜ್
Bill	ಬಿಲ್
Cosby	ಕಾಸ್ಬೀ
Chennai	ಚೆನ್ನೈ
Central	ಸೆಂಟ್ರಲ್
Bhawani	ಭವಾನೀ
Bhattacharya	ಭಟ್ಟಾಚಾರ್ಯ
Linganamakki	ಲಿಂಗನಮಕ್ಕಿ
Dam	ಡ್ಯಾಮ್
The	ದಿ
Royal	ರಾಯಲ್
Norwegian	ನಾರ್ವೇಜಿಯನ್
Order	ಆರ್ಡರ್
of	ಆಫ್
Merit	ಮೆರಿಟ್
Prakaash	ಪ್ರಕಾಶ
Comet	ಕಾಮೆಟ್
Music	ಮ್ಯೂಸಿಕ್
award	ಅವಾರ್ಡ್
Yamashiro	ಯಮಾಶಿರೊ
Maru	ಮರು
Jahan	ಜಹಾನ್
khatoon	ಖಾತೂನ್
Gangsar	ಗಂಗ್ಸಾರ್
Jaitu	ಜೈತು
Onkar	ಓಂಕಾರ್
Octavious	ಒಕ್ಟೇವಿಯಸ್
Zanna	ಜನ್ನಾ
Bhoke	ಭೋಕೆ
Dhadkan	ದಡಕನ್
Akeel	ಅಕೀಲ್
Saumarez	ಸಾಮರೆಜ್
Lilac	ಲಿಲಾಕ್
Bombay	ಬಾಂಬೆ
Talkies	ಟಾಕಿಸ್
Hindu	ಹಿಂದು
Shiela	ಶೀಲಾ
Valli	ವಲ್ಲಿ
Pickens	ಪಿಕೆನ್ಸ್
Sorcha	ಸೋರ್ಚಾ
Bhanesh	ಭಾನೇಶ್
Sukhija	ಸುಖೀಜಾ
Darban	ದರಬಾನ್
Michael	ಮೈಕೆಲ್
Mason	ಮಾಸನ್
Ahmed	ಅಹಮದ್
ar-Rifai	ಅರ್-ರಿಫಾಯ್
Yaminee	ಯಾಮಿನೀ
Saratoga	ಸರಾಟೋಗಾ
Sherwood	ಶೇರ್‌ವುಡ್
College,	ಕಾಲೇಜ್,
Nainital	ನೈನಿತಾಲ್
Dheera	ಧೀರಾ
Ammarah	ಅಮ್ಮಾರಾ
Archon	ಆರ್ಕನ್
Norbert	ನಾರ್ಬರ್ಟ್
Phillip	ಫಿಲಿಪ್
Saleem	ಸಲೀಂ
Jaffar	ಜಾಫರ್
Dheena	ಧೀನಾ
Umeed	ಉಮ್ಮೀದ್
Seanna	ಸೀನ್ನಾ
Chaitrasakha	ಚೈತ್ರಸಖ
Bajva	ಬಜ್ವಾ
Achand	ಅಚಂದ್
Chitrod	ಚಿತ್ರೋದ್
Goldsmith	ಗೋಲ್ಡ್‌ಸ್ಮಿತ್
Book	ಬುಕ್
Prize	ಪ್ರೈಜ್
Darrin	ಡ್ಯಾರಿನ್
Murray	ಮುರೇ
Khanuja	ಖನೂಜಾ
Agasti	ಅಗಸ್ತಿ
Trinity	ಟ್ರಿನಿಟಿ
Biotech	ಬಯೋಟೆಕ್
Vivien	ವಿವಿನ್
Vitran	ವಿಟ್ರಾನ್
Corporation	ಕಾರ್ಪೊರೇಶನ್
Corazon	ಕೋರೆಜೋನ್
Aquino	ಅಕ್ಯೂನೋ
Muradabad	ಮುರಾದಾಬಾದ್
Dil	ದಿಲ್
Ka	ಕಾ
Heera	ಹೀರಾ
Ajar	ಅಜರ್
Sabnis	ಸಬ್ನಿಸ್
Acharyasut	ಆಚಾರ್ಯಸುತ
Congregation	ಕಾಂಗ್ರಿಗೇಶನ್
Kyle	ಕೈಲ್
Mills	ಮಿಲ್ಲಿಸ್
Fort	ಫೋರ್ಟ್
widley	ವಿಡ್ಲೆ
Dheerendra	ಧೀರೇಂದ್ರ
Gurudwara	ಗುರುದ್ವಾರ
Doot-talai	ದೂತ್-ತಾಲೈ
Vidur	ವಿದುರ್
Reservoir	ರಿಜರ್ವಾಯರ್
Bandera	ಬಂದೇರಾ
Kuldeep	ಕುಲದೀಪ್
Barks	ಬಾರ್ಕ್ಸ್
Jaise	ಜೈಸೆ
Ko	ಕೊ
Taisa	ತೈಸಾ
Seymour	ಸೀಮೋರ್
Prokofiev	ಪ್ರೊಕೊಫೀವ್
Dak	ಡಾಕ್
Bungla	ಬಂಗಲಾ
Vinodini	ವಿನೋದಿನಿ
Cathy	ಕ್ಯಾಥಿ
Lee	ಲೀ
Gifford	ಜಿಫಾರ್ಡ್
Zensar	ಜೆನ್ಸಾರ್
Parambikulam	ಪರಂಬಿಕುಲಂ
Reservoir	ರಿಜರ್ವಾಯರ್
Jai	ಜೈ
Jagat	ಜಗತ್
Janani	ಜನನಿ
Jaureguiberry	ಜೌರೇಗ್ಯುಬೆರಿ
Sarhad	ಸರಹದ್
Bantawala	ಬಂಟ್ವಾಲಾ
Ernakulam	ಎರ್ನಾಕುಲಮ್
Junction	ಜಂಕ್ಷನ್
Abdul	ಅಬ್ದುಲ್
barr	ಬಾರ್
Elden	ಎಲ್ಡೆನ್
Barqi	ಬಾರ್ಖಿ
Rehana	ರೆಹಾನಾ
Kamalini	ಕಮಲಿನಿ
Jyoti	ಜ್ಯೋತಿ
Yadav	ಯಾದವ್
Lauderdale	ಲಾಡರ್‌ಡೆಲ್
Percy	ಪೆರ್ಸಿ
Tripurari	ತ್ರಿಪುರಾರಿ
Shabbir	ಶಬ್ಬೀರ್
Ahmed	ಅಹ್ಮದ್
Shree	ಶ್ರೀ
Satyanarayan	ಸತ್ಯನಾರಾಯಣ
Surinder	ಸುರಿಂದರ್
Khanna	ಖನ್ನಾ
Sadhan	ಸಾಧನ್
Sitamadhi	ಸೀತಾಮಢಿ
Cheer	ಚೀರ್
leading	ಲೀಡಿಂಗ್
Lola	ಲೋಲಾ
Awards	ಅವಾರ್ಡ್ಸ್
Praneet	ಪ್ರಣೀತ್
James	ಜೇಮ್ಸ್
Kirtley	ಕಿರ್ಟ್ಲೆ
Panacea	ಪನಸಿಯಾ
Biotech	ಬಯೋಟೆಕ್
Smita	ಸ್ಮಿತ
Seema	ಸೀಮಾ
Umar	ಉಮರ್
Gul	ಗುಲ್
Swimming	ಸ್ವಿಂಮಿಂಗ್
Saarang	ಸಾರಂಗ್
Wyndham	ವಿಂಧಮ್
Tirucherai	ತಿರುಚೆರೈ
Columbia	ಕೊಲಂಬಿಯಾ
river	ರಿವರ್
Vanoise	ವನೋಯ್ಸಿ
Khushboo	ಖುಶಬೂ
Cascata	ಕಸ್ಕಟಾ
Bhaarat	ಭಾರತ್
Abdul	ಅಬ್ದುಲ್
waajid	ವಾಜಿದ್
Marathi	ಮರಾಠಿ
Saharanpur	ಸಹರಾನ್ಪುರ್
Nizambad	ನಿಜಾಮಬಾದ್
Madmust	ಮದಮಸ್ತ್
Bialik	ಬಿಯಾಲಿಕ್
Prize	ಪ್ರೈಜ್
Beguine	ಬೆಜ್ಯೂನಿ
Deevaan	ದೀವಾನ್
Moles	ಮೋಲಿಸ್
Bhimana	ಭಿಮಾನಾ
Shyaamalataa	ಶ್ಯಾಮಲತಾ
Plaza	ಪ್ಲಾಜಾ
66	66
Saddam	ಸದ್ದಾಂ
Hussain	ಹುಸೇನ್
Mandakini	ಮಂದಾಕಿನಿ
Laurie	ಲಾರೀ
Williams	ವಿಲಿಯಮ್ಸ್
The	ದ
afternoon	ಆಫ್ಟರ್‌ನೂನ್
Susheet	ಸುಶೀತ್
Millionaire	ಮಿಲಿಯನರ್
Arvind	ಅರವಿಂದ್
Desai	ದೇಸಾಯಿ
Ki	ಕಿ
Ajeeb	ಅಜೀಬ್
Dastan	ದಾಸ್ತಾನ್
Squiddy	ಸ್ಕ್ವಿಡ್ಡಿ
Awards	ಅವಾರ್ಡ್ಸ್
David	ಡೇವಿಡ್
Capel	ಕೇಪೆಲ್
Susheel	ಸುಶೀಲ್
Alembic	ಅಲೆಂಬಿಕ್
Ajendra	ಅಜೇಂದ್ರ
Maroke	ಮರೋಕೆ
Imaandar	ಇಮಾನ್ದಾರ್
O^kaar	ಓಂಕಾರ್
El-saraya	ಅಲ್-ಸರಯಾ
Daku	ಡಾಕೂ
Bhupat	ಭೂಪತ್
Jethani	ಜೆಠಾನಿ
Bunny	ಬನ್ನಿ
hop	ಹಾಪ್
Graeme	ಗ್ರೇಮ್
Labrooy	ಲಬ್ರೂಯ್
Aap	ಆಪ್
Ka	ಕಾ
Pyar	ಪ್ಯಾರ್
Cincinnati	ಸಿನ್ಸಿನಾಟಿ
Players	ಪ್ಲೇಯರ್ಸ್
Phool	ಪೂಲ್
Aur	ಔರ್
Insaan	ಇನ್ಸಾನ್
Hamish	ಹಮೀಶ್
Marshall	ಮಾರ್ಷಲ್
Order	ಆರ್ಡರ್
of	ಆಫ್
the	ದ
Crown	ಕ್ರೌನ್
Commander	ಕಮಾಂಡರ್
Waseemah	ವಸೀಮಾ
Cort	ಕಾರ್ಟ್
Gurudwara	ಗುರುದ್ವಾರ
Patalpuri	ಪಾತಾಳ್‌ಪುರಿ
Caesar	ಸೀಸರ್
Fortum	ಫೋರ್ಟಮ್
Hercules	ಹರ್ಕ್ಯುಲಿಸ್
Aithal	ಐತಲ್
Lloyd	ಲಾಯ್ಡ್
Bridges	ಬ್ರಿಜಸ್
Foolwati	ಫೂಲ್‌ವತಿ
Aadharshila	ಆಧಾರಶೀಲಾ
Apoorv	ಅಪೂರ್ವ
Saheli	ಸಹೇಲಿ
Jennica	ಜೆನೀಕಾ
Bahrupiya	ಬಹರೂಪಿಯಾ
Kenilworth	ಕೆನಿಲ್‌ವರ್ತ್
Nottingham	ನಾಟಿಂಗ್‌ಹ್ಯಾಂ
Trent	ಟ್ರೆಂಟ್
University	ಯುನಿವರ್ಸಿಟಿ
National	ನ್ಯಾಶನಲ್
Medal	ಮೆಡಲ್
of	ಆಫ್
Technology	ಟೆಕ್ನಾಲಜಿ
Murdiyya	ಮುರ್ದಿಯ್ಯಾ
Graeme	ಗ್ರೀಮ್
Swann	ಸ್ವಾನ್
Tarangini	ತರಂಗಿಣಿ
Jonty	ಜಾಂಟಿ
Rhodes	ರೋಡ್ಸ್
Maritime	ಮೆರಿಟೈಮ್
Museum	ಮ್ಯೂಸಿಯಂ
of	ಆಫ್
Greece	ಗ್ರೀಸ್
Thirty	ಥರ್ಟಿ
Six	ಸಿಕ್ಸ್
Chowrangee	ಚೌರಂಗೀ
Lane	ಲೇನ್
Mort	ಮೋರ್ಟ್
Shradhanjali	ಶ್ರದ್ಧಾಂಜಲಿ
Kevina	ಕೆವಿನಾ
Hansie	ಹ್ಯಾನ್ಸೀ
Cronje	ಕ್ರೋನಿಯೆ
Najmeddin	ನಜ್ಮೆದ್ದೀನ್
Razi	ರಾಜಿ
Johan	ಜೋಹಾನ್
Straus	ಸ್ಟ್ರೌಸ್
Batch	ಬ್ಯಾಚ್
Kevalkishore	ಕೇವಲ್‌ಕಿಶೋರ್
Alan	‌ಅಲನ್
Igglesden	ಇಗ್ಲೆಸ್‌ಡನ್
Fort	ಫೋರ್ಟ್
pasir	ಪಾಸಿರ್
panjang	ಪಂಜಂಗ್
Sigourney	ಸಿಗೋರ್ನೀ
Weaver	ವೀವರ್
Hulla	ಹಲ್ಲಾ
Gulla	ಗುಲ್ಲಾ
Hamish	ಹಮೀಶ್
Anthony	ಅಂತೋನಿ
Order	ಆರ್ಡರ್
of	ಆಫ್
the	ದ
Precious	ಪ್ರೀಶಿಯಸ್
Crown	ಕ್ರೌನ್
Wasan	ವಸಣ್
Sher	ಶೇರ್
Ka	ಕಾ
Punja	ಪಂಜಾ
Dost	ದೋಸ್ತ್
Dehrabad	ದೆಹ್ರಾಬಾದ್
Silesian	ಸಿಲೆಸಿಯನ್
War	ವಾರ್
Resham	ರೇಶಮ್
Ki	ಕಿ
Dori	ಡೋರಿ
Ram	ರಾಮ್
Kasam	ಕಸಮ್
Yaachit	ಯಾಚಿತ್
Triveni	ತ್ರಿವೇಣಿ
Ataturk	ಅಟಾಟರ್ಕ್
Bidar	ಬೀದರ್
fort	ಫೋರ್ಟ್
Andy	ಆಂಡಿ
Roberts	ರಾಬರ್ಟ್ಸ್
Jalaput	ಜಾಲಪುತ್
Hindee	ಹಿಂದೀ
Kaiser	ಕೈಸರ್
Friedrich	ಫ್ರೆಡ್ರಿಕ್
III.	III.
Talakkad	ತಲಕಾಡು
Ankola	ಅಂಕೋಲಾ
General	ಜನರಲ್
Noriega	ನೋರಿಯೇಗಾ
Finn	ಫಿನ್
Aristotle	ಅರಿಸ್ಟಾಟಲ್
Anokha	ಅನೋಖಾ
Prem	ಪ್ರೇಮ್
Abdul	ಅಬ್ದುಲ್
hafeed	ಹಫೀದ್
Shri	ಶ್ರೀ
Harimandir	ಹರಿಮಂದಿರ್
Sahib,	ಸಾಹಿಬ್,
Amritsar	ಅಮೃತಸರ
(Punjab)	(ಪಂಜಾಬ್)
Cesar	ಕೇಸರ್
Gauloise	ಗೌಲೋಯ್ಸಿ
Do	ದೋ
Sholay	ಶೋಲೆ
Vedavyaas	ವೇದವ್ಯಾಸ
Tha'labah	ಥಲಾಬಾ
Randy	ರೇಂಡಿ
Khubayb	ಖುಬೇಬ್
Colin	ಕಾಲಿನ್
Stuart	ಸ್ಟುವರ್ಟ್
Moser	ಮೋಸರ್
Baer	ಬೇರ್
Orion	ಓರಿಯನ್
Eveready	ಎವರೆಡೀ
Ind	ಇಂಡ್
Na	ನಾ
Hone	ಹೋನೆ
Wali	ವಾಲೀ
Baat	ಬಾತ್
Maan	ಮಾನ್
Jaiye	ಜಾಯಿಯೆ
Margaux	ಮಾರ್ಗೌಕ್ಸ್
Liberty	ಲಿಬರ್ಟಿ
Baptist	ಬ್ಯಾಪ್ಟಿಸ್ಟ್
Nasir	ನಾಸಿರ್
Ahmed	ಅಹ್ಮದ್
Akhil	ಅಖಿಲ್
Dhanari	ಧನಾರೀ
Duniya	ದುನಿಯಾ
Meri	ಮೇರೀ
Jeb	ಜೇಬ್
Mein	ಮೇ
Aap	ಆಪ್
Ki	ಕಿ
Khatir	ಖಾತಿರ್
Naughty	ನಾಟಿ
Boy	ಬಾಯ್
Reshma	ರೇಶ್ಮಾ
Shah	ಶಾಹ
Behram	ಬೆಹರಾಮ್
Raajwade	ರಾಜವಾಡೆ
Shepherd	ಶೆಫರ್ಡ್
of	ಆಫ್
the	ದ
Valley	ವ್ಯಾಲಿ
Bible	ಬೈಬಲ್
Cher	ಚೇರ್
Dil	ದಿಲ್
Tujh	ತುಝ್
Ko	ಕೊ
Diya	ದಿಯಾ
Quentin	ಕೆಂಟಿನ್
Toor	ತೂರ್
Battice	ಬ್ಯಾಟಿಸ್
fort	ಫೋರ್ಟ್
Casper	ಕ್ಯಾಸ್ಪರ್
Community	ಕಮ್ಯುನಿಟಿ
Ghaare	ಘಾರೆ
Barwa	ಬರವಾ
Sagar	ಸಾಗರ್
Hotel	ಹೋಟೆಲ್
Burbara	ಬರ್ಬರಾ
Bush	ಬುಷ್
Baare	ಬಾರೆ
Reshma	ರೇಶಮ್
Aur	ಔರ್
Shera	ಶೇರಾ
Sulalita	ಸುಲಲಿತ
Adarshi	ಆದರ್ಶಿ
Donnelly	ಡಾನೆಲ್ಲಿ
Shrilekha	ಶ್ರೀಲೇಖಾ
Eenadu	ಈನಾಡು
Bijli	ಬಿಜಲೀ
Aur	ಔರ್
Toofan	ತೂಫಾನ್
Craig	ಕ್ರೆಗ್
Evans	ಇವನ್ಸ್
Mahadevi	ಮಹಾದೇವಿ
Rainbow	ರೈನ್‌ಬೋ
Warrior	ವಾರಿಯರ್
Hillary	ಹಿಲೆರಿ
Swank	ಸ್ವಾಂಕ್
GENETIC	ಜೆನೆಟಿಕ್
TECHNOLOGIES	ಟೆಕ್ನಾಲಜೀಸ್
Greta	ಗ್ರೆಟಾ
Francesco	ಫ್ರಾನ್ಸಿಸ್ಕೊ
Morosini	ಮೊರೊಸಿನಿ
Naimisharanya	ನೈಮಿಷಾರಾಣ್ಯ
Unicoi	ಯುನಿಕೊಯ್
Christian	ಕ್ರಿಶ್ಚಿಯನ್
Akhlaaq	ಅಖ್‌ಲಾಕ್
Jacada	ಜಕಾಡಾ
Shoaib	ಶೋಯೆಬ್
Akhtar	ಅಖ್ತರ್
Bhavan	ಭವನ್
Dollar	ಡಾಲರ್
Suchi	ಸುಚಿ
Naved	ನವೆದ್
Chanderiya	ಚಂದೇರಿಯಾ
Katrina	ಕತ್ರಿನಾ
Bandhan	ಬಂಧನ್
P'yongyang	ಪಿಯಾಂಗ್‌ಯಾಂಗ್
Fort	ಫೋರ್ಟ್
charlotte	ಚಾರ್ಲೊಟಿ
Bhawanipur	ಭವಾನಿಪುರ್
Kalan	ಕಲನ್
Maurizio	ಮೊರಿಜಿಯೊ
Barakaat	ಬಾರಾಕಾತ್
Tristan	ಟ್ರಿಸ್ಟನ್
Mustaneer	ಮುಸ್ತಾನೀರ್
Patagonian	ಪೆಟಗೋನಿಯನ್
Gupt	ಗುಪ್ತ್
Gyan	ಜ್ಞಾನ್
Post	ಪೋಸ್ಟ್
Box	ಬಾಕ್ಸ್
Maple	ಮ್ಯಾಪೆಲ್
Museum	ಮ್ಯೂಸಿಯಂ
Main	ಮೈ
Shadi	ಶಾದಿ
Karne	ಕರ್ನೆ
Chala	ಚಲಾ
Ameya	ಅಮೇಯ
SUNDAY	ಸಂಡೇ
Communications	ಕಮ್ಯೂನಿಕೇಶನ್ಸ್
Limited	ಲಿಮಿಟೆಡ್
Pati	ಪತಿ
Pawan	ಪಾವನ್
Ashby	ಆಶ್‌ಬೈ
Cemal	ಕೆಮೆಲ್
Ekma	ಎಕ್ಮಾ
Asbat	ಅಸ್ಬತ್
Creative	ಕ್ರಿಯೇಟಿವ್
Technology	ಟೆಕ್ನಾಲಜಿ
Balak	ಬಾಲಕ್
Dhruv	ಧ್ರುವ್
Keshav	ಕೇಶವ
Kepler	ಕೆಪ್ಲರ್
Wessels	ವೆಸೆಲ್ಸ್
Dimow	ದಿಮೋವ್
Rahamat	ರಹಮತ್
Magnolia	ಮ್ಯಾಗ್ನೋಲಿಯಾ
Maninder	ಮಣಿಂದರ್
Hoor	ಹೂರ್
Iqbal	ಇಕ್ಬಾಲ್
Claude	ಕ್ಲಾಡ್
Gauri	ಗೌರಿ
Shankar	ಸರಕಾರ್
Allahabad	ಅಲಹಾಬಾದ್
Junction	ಜಂಕ್ಷನ್
Dirac	ಡಿರಾಕ್
Prize	ಪ್ರೈಜ್
Raquetball	ರಾಕೆಟ್‌ಬಾಲ್
Baidu.com	ಬಾಯ್ದು.ಕಾಂ
Amaanda	ಅಮಾಂಡಾ
Dasuha	ದಸೂಹಾ
Sans	ಸ್ಯಾನ್ಸ್
Pareil	ಪೆರಿಲ್
Anuppur	ಅನುಪುರ್
Junction	ಜಂಕ್ಷನ್
Achyutray	ಅಚ್ಯುತರಾಯ
Deabia	ದೀಬಿಯಾ
Ranchandi	ರಣಚಂಡಿ
Ajeebaah	ಅಜೀಬಾ
Thermax	ಥರ್ಮ್ಯಾಕ್ಸ್
Williamite	ವಿಲಿಯಮೈಟ್
war	ವಾರ್
in	ಇನ್
Ireland	ಐರ್ಲ್ಯಾಂಡ್
Raghad	ರಘಡ್
Gambhiri	ಗಂಭೀರೀ
Road	ರೋಡ್
Nizzar	ನಿಜಾರ್
Roger	ರೋಗರ್
Woolley	ವೂಲೆ
Nancy	ನ್ಯಾನ್ಸಿ
Great	ಗ್ರೇಟ್
Barrier	ಬ್ಯಾರಿಯರ್
Gardner	ಗಾರ್ಡನರ್
Memorial	ಮೆಮೋರಿಯಲ್
United	ಯುನೈಟೆಡ್
Methodist	ಮೆಥೋಡಿಸ್ಟ್
Prajasrij	ಪ್ರಜಾಸೃಜ
Jaladhip	ಜಲದೀಪ್
Research	ರಿಸರ್ಚ್
in	ಇನ್
Motion	ಮೋಷನ್
Limited	ಲಿಮಿಟೆಡ್
China's	ಚೈನಾಸ್
Great	ಗ್ರೇಟ್
Wall	ವಾಲ್
Museum	ಮ್ಯೂಸಿಯಂ
Char	ಚಾರ್
Dil	ದಿಲ್
Char	ಚಾರ್
Raahen	ರಾಹೇ
Garma	ಗರಮ್
Garam	ಗರಮ್
Historical	ಹಿಸ್ಟಾರಿಕಲ್
and	ಅಂಡ್
Folklore	ಫೋಕ್ಲೋರ್
Museum	ಮ್ಯೂಸಿಯಂ
of	ಆಫ್
Corinth	ಕಾರ್ನಿತ್
Joshila	ಜೋಶಿಲಾ
Bikaner	ಬಿಕಾನೇರ್
Handball	ಹ್ಯಾಂಡ್‌ಬಾಲ್
Adriano	ಅಡ್ರಿಯಾನೊ
Louisiana	ಲೂಯಿಸಿಯಾನಾ
Harishchandra	ಹರಿಶ್ಚಂದ್ರ
Aurat	ಔರತ್
Aur	ಔರ್
Patthar	ಪತ್ಥರ್
Vijite^driy	ವಿಜಿತೇಂದ್ರಿಯಾ
Pembrokeshire	ಪೆಂಬ್ರೋಕೆಶೈರ್
Coast	ಕೋಸ್ಟ್
Suhayb	ಸುಹೇಬ್
Sukant	ಸುಕಾಂತ್
Sanchi	ಸಾಂಚಿ
Stupa	ಸ್ತೂಪ
Mojave	ಮೋಜಾವೆ
Sew	ಶಿವ್
Shivnarine	ಶಿವನಾರಾಯಣ್
Yadon	ಯಾದೋ
Ki	ಕಿ
Kasam	ಕಸಮ್
Abhyuday	ಅಭ್ಯುದಯ್
Barchi	ಬರ್ಚಿ
Road	ರೋಡ್
Nallur	ನಲ್ಲೂರು
Kandaswamy	ಕಂದಸ್ವಾಮಿ
Pyar	ಪ್ಯಾರ್
Ki	ಕೀ
Dastan	ದಾಸ್ತಾನ್
Nafisah	ನಫೀಶಾ
Dolly	ಡಾಲಿ
Parton	ಪಾರ್ಟನ್
Sahalpur	ಸಾಹಲ್‌ಪುರ್
Foster	ಫೋಸ್ಟರ್
Wheeler	ವೀಲರ್
Norma	ನಾರ್ಮಾ
Fleck	ಫ್ಲೆಕ್
Award	ಅವಾರ್ಡ್
Trevor	ಟ್ರೆವರ್
Madondo	ಮರ್ಡೊಂಡೊ
Iqtidar	ಇಕ್ತಿದಾರ್
Gulzarilal	ಗುಲ್ಜಾರಿಲಾಲ್
Abdul	ಅಬ್ದುಲ್
qahhar	ಕಹಾರ್
Abhinandaa	ಅಭಿನಂದಾ
Dharti	ಧರತೀ
Kahe	ಕಹೆ
Pukar	ಪುಕಾರ್
Ke	ಕೆ
Beraham	ಬೆರಹಮ್
Daku	ಡಾಕು
Abdul	ಅಬ್ದುಲ್
mughanee	ಮುಗಾನಿ
Webster	ವೆಬ್‌ಸ್ಟರ್
Bahauddin	ಬಹಾವುದ್ದೀನ್
Yaajak	ಯಾಜಕ್
Jabalpur	ಜಬಲ್ಪುರ್
Doyen	ಡೊಯನ್
Stash	ಸ್ಟಾಶ್
Sokhal	ಸೋಖಲ್
Noor	ನೂರ್
Jahan	ಜಹಾಂ
Gerald	ಗೆರಾಲ್ಡ್
Whenham	ವೆನ್‌ಹ್ಯಾಮ್
Chlorine	ಕ್ಲೋರಿನ್
Lloyds	ಲಯಾಡ್ಸ್
Steel	ಸ್ಟೀಲ್
Sumnah	ಸುಮ್ನಾ
Bahaadur	ಬಹಾದುರ್
Gondia	ಗೊಂಡಿಯಾ
Junction	ಜಂಕ್ಷನ್
Noor	ನೂರ್
Do	ದೋ
Raha	ರಹಾ
Princess	ಪ್ರಿನ್ಸೆಸ್
Ajitaabh	ಅಜಿತಾಭ್
Andrew	ಆಂಡ್ರ್ಯೂ
Strauss	ಸ್ಟ್ರಾವಸ್
Haimavat	ಹೈಮವತ್
Ajwad	ಅಜ್ವಡ್
Campbell	ಕ್ಯಾಂಪ್‌ಬೆಲ್
Macmillan	ಮೆಕ್‌ಮಿಲನ್
Vyanjana	ವ್ಯಂಜನಾ
Muammar	ಮುಅಮ್ಮರ್
Nandalaal	ನಂದಲಾಲ್
Government	ಗವರ್ನಮೆಂಟ್
Model	ಮಾಡೆಲ್
Higher	ಹೈಯ್ಯರ್
Secondary	ಸೆಕೆಂಡರಿ
School,	ಸ್ಕೂಲ್,
Thiruvananthapuram	ತಿರುವನಂತಪುರಂ
Raj	ರಾಜ್
Nartaki	ನರ್ತಕಿ
Park	ಪಾರ್ಕ್
Place	ಪ್ಲೇಸ್
Baptist	ಬ್ಯಾಪ್ಟಿಸ್ಟ್
Apradhi	ಅಪರಾಧೀ
Logie	ಲಾಗಿ
Award	ಅವಾರ್ಡ್
Bahnod	ಬನೋಡ್
Joru	ಜೋರೂ
Ka	ಕಾ
Bhai	ಭಾಯಿ
Abhirup	ಅಭಿರೂಪ
Mohammad	ಮೊಹಮ್ಮದ್
Wasim	ವಾಸಿಂ
Lavinia	ಲವಿನಿಯಾ
Bhoot	ಭೂತ್
Mera	ಮೇರಾ
Saathi	ಸಾಥೀ
Suhasini	ಸುಹಾಸಿನಿ
Carolyn	ಕರೋಲಿನ್
French	ಫ್ರೆಂಚ್
Open	ಓಪನ್
champions	ಚಾಂಪಿಯನ್ಸ್
Ammasandra	ಅಮ್ಮಸಂದ್ರ
Beckham	ಬೇಕ್ಹಮ್
Medal	ಮೆಡಲ್
for	ಫಾರ್
Outstanding	ಔಟ್‌ಸ್ಟ್ಯಾಂಡಿಂಗ್
Civic	ಸಿವಿಕ್
Achievement	ಅಚೀವ್‌ಮೆಂಟ್
Betul	ಬೇತುಲ್
Tube	ಟ್ಯೂಬ್
Investment	ಇನ್‌ವೆಸ್ಟ್‌ಮೆಂಟ್
Bedroom	ಬೆಡ್‌ರೂಮ್
Story	ಸ್ಟೋರಿ
Baahi	ಬಾಹಿ
Bataan	ಬತಾನ್
Dharam	ಧರಮ್
Kanta	ಕಾಂಟಾ
Orava	ಒರಾವಾ
Mushtaq	ಮುಷ್ತಾಖ್
Terry	ಟೆರ್ರಿ
Halifax	ಹ್ಯಾಲಿಫ್ಯಾಕ್ಸ್
citadel	ಸಿಟಾಡೆಲ್
Anvil	ಅನ್ವಿಲ್
Zapateado	ಝಪಟಿಡೊ
Massenhoven	ಮಾಸೆನ್‌ಹೋವನ್
Fort	ಫೋರ್ಟ್
siloso	ಸಿಲೋಸೊ
Chitradurg	ಚಿತ್ರದುರ್ಗ
Lanthanum	ಲ್ಯಾನ್ಥನೇನಿಯಂ
Mirza	ಮಿರ್ಜಾ
Tanners	ಟ್ಯಾನರಿ
Banmankhi	ಬನ್ಮಂಖಿ
Junction	ಜಂಕ್ಷನ್
Shri	ಶ್ರೀ
Nagad	ನಗದ್
Narayan	ನಾರಾಯಣ್
Thaqaf	ಥಾಕಾಫ್
Chandan	ಚಂದನ್
Ka	ಕಾ
Palna	ಪಾಲನಾ
Aldona	ಅಲ್ಡೋನಾ
Shahzadi	ಶಹಜಾದೀ
Alia	ಅಲಿಯಾ
Bada	ಬಡಾ
Fatehgarh	ಫತೇಗರ್
Sahib	ಸಾಹಿಬ್
Ellard	ಎಲಾರ್ಡ್
Ahmadnagar	ಅಹಮದ್‌ನಗರ್
Shoaib	ಶೋಯೆಬ್
Malik	ಮಲಿಕ್
Shunbhanaashinee	ಶುಂಭನಾಶಿನಿ
Federal	ಫೆಡರಲ್
Express	ಎಕ್ಸ್‌ಪ್ರೆಸ್
Pyar	ಪ್ಯಾರ್
Ke	ಕೆ
Naam	ನಾಮ್
Qurban	ಕುರ್ಬಾನ್
Usman	ಉಸ್ಮಾನ್
dan	ದಾನ್
Fodio	ಫೋಡಿಯಾ
Florence	ಫ್ಲಾರೆನ್ಸ್
Vanakan_yaa	ವನಕನ್ಯಾ
Rookie	ರೂಕಿ
of	ಆಫ್
the	ದಿ
Year	ಇಯರ್
Award	ಅವಾರ್ಡ್
Khadikar	ಖಾಡಿಕರ್
Kaishori	ಕೈಶೋರಿ
Lions	ಲಯನ್ಸ್
Gate	ಗೇಟ್
Graeme	ಗ್ರೀಮ್
Wood	ವುಡ್
Alan	ಅಲನ್
Mullally	ಮುಲ್ಲಾಲಿ
Meghamala	ಮೇಘಮಾಲಾ
Agnija	ಅಗ್ನಿಜ
Annadata	ಅನ್ನದಾತಾ
Glenveagh	ಗ್ಲೆನ್‌ವೇಗ್
Pirelli	ಪಿರೆಲೀ
Award	ಅವಾರ್ಡ್
Madhulekha	ಮಧುಲೇಖಾ
Franklin	ಫ್ರ್ಯಾಂಕ್ಲಿನ್
Medal	ಮೆಡಲ್
Nashitah	ನಶೀತಾ
Aadikavi	ಆದಿಕವಿ
University	ಯುನಿವರ್ಸಿಟಿ
of	ಆಫ್
Sydney	ಸಿಡ್ನಿ
Steven	ಸ್ಟೀವನ್
Hawking	ಹಾಕಿಂಗ್
Raiqah	ರೈಖಾ
Dick	ಡಿಕ್
Gregory	ಗ್ರೆಗೋರಿ
Arafura	ಅರಾಫುರಾ
Banka	ಬಂಕಾ
Romantic	ರೊಮ್ಯಾಂಟಿಕ್
India	ಇಂಡಿಯಾ
Ek	ಏಕ್
Ke	ಕೆ
Baad	ಬಾದ್
Ek	ಏಕ್
Tansin	ತಾನ್ಸಿನ್
Karimnagar	ಕರೀಂನಗರ್
San	ಸಾನ್
Pablo	ಪಾಬ್ಲೋ
Bay	ಬೇ
Panavin	ಪನವಿನ್
Shane	ಶೇನ್
Lee	ಲೀ
York	ಯಾರ್ಕ್
Dubaha	ದುಬಾಹಾ
Tim	ಟಿಮ್
Zoehrer	ಜೋಹರರ್
Indeever	ಇದೀವರ
Mardangi	ಮರ್ದಾಂಗೀ
Rangila	ರಂಗೀಲಾ
Jawan	ಜವಾನ್
Jorn	ಜೋರ್ನ್
Love	ಲವ್
Love	ಲವ್
Love	ಲವ್
New	ನ್ಯೂ
York	ಯಾರ್ಕ್
Historical	ಹಿಸ್ಟಾರಿಕಲ್
Society	ಸೊಸೈಟಿ
Neepa	ನೀಪಾ
Zoltan	ಝೋಲ್ಟನ್
Gangaaraam	ಗಂಗಾರಾಮ್
Saudagar	ಸೌದಾಗರ್
Prix	ಪ್ರಿಕ್ಸ್
Goncourt	ಗಾನ್‌ಕೋರ್ಟ್
Udaipur	ಉದಯ್ ಪುರ್
Yafi	ಯಾಫಿ
Dara	ದಾರಾ
Singh	ಸಿಂಗ್
Farah	ಫರಾಹ್
Town	ಟೌನ್
Jewel	ಜ್ವಾಲ್
Amar	ಅಮರ್
Pyar	ಪ್ಯಾರ್
Apatkaal	ಆಪತ್ಕಾಲ್
Galvin	ಗಾಲ್ವಿನ್
Aamirah	ಆಮೀರಾ
Beryllium	ಬೆರೀಲಿಯಂ
Amar	ಅಮರ್
saritaa	ಸರಿತಾ
Western	ವೆಸ್ಟರ್ನ್
Samoa	ಸಮಾವೋ
Sarojani	ಸರೋಜನಿ
Do	ದೋ
Raaste	ರಾಸ್ತೆ
Playwin	ಪ್ಲೇವಿನ್
Devinderpal	ದೇವೀಂದರ್‌ಪಾಲ್
Mashaal	ಮಶಾಲ್
Achhnera	ಅಚ್ನೆರಾ
Junction	ಜಂಕ್ಷನ್
Ranchi	ರಾಂಚಿ
express	ಎಕ್ಸ್‌ಪ್ರೆಸ್
Bhindaranwale	ಭಿಂಡರನ್‌ವಾಲೆ
Arusha	ಅರುಷಾ
Naveen	ನವೀನ್
Posen	ಪೊಸೆನ್
Brendon	ಬ್ರೆಂಡನ್
Bracewell	ಬ್ರೇಸ್‌ವೆಲ್
Ignatius	ಇಗ್ನೇಷಿಯಸ್
Melchior	ಮೆಲ್ಚಿಯೋರ್
Ajaad	ಆಜಾದ್
Aftek	ಅಫ್ಟೆಕ್
Infosys	ಇನ್ಫೋಸಿಸ್
Kiana	ಕಿಯಾನ
Farrukh	ಫಾರ್ರುಖ್
Geraldine	ಚೆರಾಲ್ಡಿನ್
Ferrero	ಫೆರೇರೋ
Rohitashv	ರೋಹಿತಾಶ್ವ
Saqi	ಸಕಿ
Varuna	ವರುಣಾ
Sumana	ಸುಮನ
Rishi	ಋಷಿ
Valley	ವ್ಯಾಲಿ
School	ಸ್ಕೂಲ್
Fort	ಫೋರ್ಟ್
uitermeer	ಉಟರ್‌ಮೀರ್
Christ	ಕ್ರೈಸ್ಟ್
United	ಯುನೈಟೆಡ್
Methodist	ಮೆಥೋಡಿಸ್ಟ್
Ludhianwi	ಲೂಧಿಯಾನವಿ
Sharanyu	ಶರಣ್ಯು
Hotton	ಹಾಟನ್
Hwange	ಹ್ವಾಂಗೆ
Altair	ಆಲ್ಟೇರ್
Nanotechnologies	ನ್ಯಾನೋಟೆಕ್ನಾಲಜೀಸ್
Sagarika	ಸಾಗರಿಕಾ
Requinto	ರೇಕಿಂಟೊ
Jailakshmi	ಜಯಲಕ್ಷ್ಮಿ
Mirabel	ಮಿರಾಬೆಲ್
Alok	ಅಲೋಕ್
Industries	ಇಂಡಸ್ಟ್ರೀಸ್
Bilhar	ಬಿಲಹರ್
Ghat	ಘಾಟ್
Yaasmeen	ಯಾಸ್ಮೀನ್
Melania	ಮಿಲಾನಿಯಾ
Kevin	ಕೆವಿನ್
Curran	ಕುರನ್
Ivor	ಇವೋರ್
Novello	ನಾವೆಲೋ
Award	ಅವಾರ್ಡ್
Sudhakar	ಸುಧಾಕರ್
Saradindu	ಸರದಿಂದು
Mukherjee	ಮುಖರ್ಜಿ
Bedardi	ಬೆದರ್ದೀ
Barchon	ಬಾರ್ಚನ್
fort	ಫೋರ್ಟ್
Naseen	ನಸೀನ
Chichagof	ಚಿಕಾಗುವಾಫ್
Starr	ಸ್ಟಾರ್
Roydon	ರಾಯ್ಡನ್
Hayes	ಹೇಯ್ಸ್
Xerxes	ಜೆರ್ಕ್ಸಿಸ್
Gidhaur	ಗಿಧಾರ್
Jal	ಜಲ್
Mahal	ಮಹಲ್
Dhanbad	ಧನಬಾದ್
Junction	ಜಂಕ್ಷನ್
Man	ಮ್ಯಾನ್
of	ಆಫ್
the	ದ
Year/Person	ಈಯರ್/ಪರ್ಸನ್
of	ಆಫ್
the	ದ
Year	ಈಯರ್
Agaatha	ಅಗಾಥ
Fort	ಫೋರ್ಟ್
de	ಡಿ
kock	ಕಾಕ್
Amar	ಅಮರ್
asom	ಅಸೋಮ್
Oadira	ಓದಿರಾ
Lokamaan_y	ಲೋಕಮಾನ್ಯ
Torrent	ಟಾರೆನ್ಟ್
Group	ಗ್ರೂಪ್
Sheesh	ಶೀಶ್
Inayat	ಇನಾಯತ್
Kendra	ಕೆಂಡ್ರಾ
Haddock	ಹ್ಯಾಡೊಕ್
Hum	ಹಮ್
Rahe	ರಹಿ
Na	ನಾ
Hum	ಹಮ್
Sadiyah	ಸದೀಯಾ
Agaton	ಅಗಟಾನ್
fort	ಫೋರ್ಟ್
Xongo	ಜೋಂಗೋ
Leighanna	ಲೈಘಾನ್ನಾ
Wafi	ವಾಫೀ
Vaidyanath	ವೈದ್ಯನಾಥ
Jyotirlinga	ಜ್ಯೋತಿರ್ಲಿಂಗ
Vadvekar	ವಡ್ವೇಕರ್
Karz	ಕರ್ಜ್
Xexilia	ಜೆಕ್ಸಿಲಿಯಾ
Nirad	ನಿರದ್
Boot	ಬೂತ್
Polish	ಪಾಲಿಶ್
Fort	ಫೋರ್ಟ್
bembridge	ಬೆಮ್‌ಬ್ರಿಡ್ಜ್
Chhattisgarh	ಚತ್ತೀಸ್‌ಗಢ
Vafi	ವಾಫಿ
Indrakanta	ಇಂದ್ರಕಾಂತ
Mandelina	ಮ್ಯಾಂಡೆಲಿನಾ
Urian	ಯ್ಯುರಿಯನ್
Nanwan	ನನವಾನ್
Chris	ಕ್ರಿಸ್
Silverwood	ಸಿಲ್ವರ್‌ವುಡ್
Gurdayal	ಗುರುದಯಾಳ್
Pandit	ಪಂಡಿತ್
Jasraj	ಜಸರಾಜ್
Vari	ವಾರಿ
Jaiprakash	ಜೈಪ್ರಕಾಶ್
Narayan	ನಾರಾಯಣ್
Kiski	ಕಿಸ್ಕಿ
Pyari	ಪ್ಯಾರಿ
Socrates	ಸಾಕ್ರಟೀಸ್
Makhowal	ಮಾಖೋವಾಲ್
Hurdles	ಹರ್ಡಲ್ಸ್
Taklamakan	ತಕ್ಲಾಮಾಕನ್
Garrett	ಗ್ಯಾರೆಟ್
Roshanalaal	ರೋಶನಲಾಲ್
Istabraq	ಇಸ್ತಾಬ್ರಕ್
Sun	ಸನ್
Network	ನೆಟ್ವರ್ಕ್
Desh	ದೇಶ್
Drohi	ದ್ರೋಹಿ
Gwyneth	ಗ್ವಾಯನೆಥ್
Amararaj	ಅಮರರಾಜ್
Imogene	ಇಮೋಜಿನ್
Shulka	ಶುಕ್ಲಾ
Khingan	ಖಿಂಗನ್
Barkur	ಬರಕೂರ್
Golden	ಗೋಲ್ಡ್‌ನ್
Turkey	ಟರ್ಕಿ
Award	ಅವಾರ್ಡ್
Akshitaa	ಅಕ್ಷಿತಾ
Eamon	ಈಮನ್
Kari	ಕ್ಯಾರಿ
West	ಪಶ್ಚಿಮ
Bengal	ಬಂಗಾಲ
Jnyandeep	ಜ್ಞಾನದೀಪ್
Jock	ಜಾಕ್
Asomiya	ಅಸೋಮಿಯಾ
pratidin	ಪ್ರತಿದಿನ್
Achcha	ಅಚ್ಛಾ
Bura	ಬುರಾ
Ankh	ಅಂಖ್
Ka	ಕಾ
Nasha	ನಶಾ
Ghunghat	ಘೂಂಘಟ್
Wali	ವಾಲಿ
Osric	ಆಸ್ರಿಕ್
Raameshvar	ರಾಮೇಶ್ವರ
lyon	ಇಯಾನ್
saint	ಸೈಂಟ್
exupery	ಎಕ್ಸುಪೆರಿ
Aadityavardhan	ಆದಿತ್ಯವರ್ಧನ್
Kali	ಕಾಳಿ
Sipaahi	ಸಿಪಾಹಿ
Jati	ಜತಿ
Gaayatree	ಗಾಯತ್ರೀ
Gajendra	ಗಜೇಂದ್ರ
Gijare	ಗಿಜಾರೆ
Freeman	ಫ್ರೀಮ್ಯಾನ್
Aa'idah	ಆಇದಾ
Elyas	ಎಲ್ಯಾಸ್
Quran	ಖುರಾನ್
Shahi	ಶಾಹಿ
Chor	ಚೋರ್
Saan	ಸಾನ್
Alexandre	ಅಲೆಕ್ಸಾಂಡರ್
Dumas	ಡ್ಯೂಮಾಸ್
Gascogne	ಗ್ಯಾಸ್‌ಕಾಗ್ನೆ
Sanduri	ಸಂಡುರಿ
Khare	ಖರೆ
Mradutaa	ಮೃದುತಾ
Kali	ಕಾಲಿ
Basti	ಬಸ್ತಿ
Niraj	ನಿರಜ್
Natrona	ನೆಟ್ರೋನಾ
Bhalerao	ಭಾಲೆರಾವ್
jagannath	ಜಗನ್ನಾಥ
puri	ಪುರಿ
Soryu	ಸೋರ್ಯೂ
Manganese	ಮ್ಯಾಂಗನೈಸ್
Haitian	ಹೈಶಿಯನ್
Revolution	ರೆವಲ್ಯೂಶನ್
Jeevan	ಜೀವನ್
Dhara	ಧಾರಾ
Lucille	ಲುಕಿಲ್ಲೆ
Sihota	ಸಿಹೋತಾ
Aadishree	ಆದಿಶ್ರೀ
Bamnia	ಬಮ್ನಿಯಾ
Insaaf	ಇನ್ಸಾಫ್
Kaun	ಕೌನ್
Karega	ಕರೇಗಾ
Larry	ಲ್ಯಾರಿ
Girindra	ಗಿರೀಂದ್ರ
Itochu	ಇಟೋಚು
Karston	ಕಾರ್ಸ್ಟನ್
Mandir	ಮಂದಿರ್
Masjid	ಮಸ್ಜಿದ್
Mard	ಮರ್ದ್
Ki	ಕಿ
Zabaan	ಜಬಾನ್
Wali	ವಲೀ
Tower	ಟವರ್
Semiconductor	ಸೆಮಿಕಂಡಕ್ಟರ್
Sadiqah	ಸಾದಿಕಾ
Talwarkar	ತಲ್ವಾರ್‌ಕರ್
Gawarikar	ಗವಾರಿಕರ್
Shing	ಶಿಂಗ್
Mun	ಮುನ್
Reservoir	ರಿಜರ್ವಾಯರ್
Schwaben	ಸ್ಕ್ವಾಬೆನ್
Fatihah	ಫತಿಹಾ
Shah	ಶಾ
Abdul	ಅಬ್ದುಲ್
Latif	ಲತೀಫ್
Bhittai	ಭಿಟ್ಟಾಯ್
Dichpalli	ದಿಚಪಲ್ಲಿ
Judaai	ಜುದಾಯಿ
Hanste	ಹಂಸತೇ
Khelte	ಖೇಲ್ತೇ
Xalvadora	ಜಾಲ್ವಡೊರಾ
Naseem	ನಸೀಮ್
Spectramind	ಸ್ಪೆಕ್ಟ್ರಾಮೈಂಡ್
Ziarre	ಜಿಯಾರಿ
Qamar	ಕಮರ್
Paravasu	ಪರವಾಸು
Parth	ಪರ್ಥ
Kumar	ಕುಮಾರ್
Abdul	ಅಬ್ದುಲ್
mujeeb	ಮುಜೀಬ್
Cardiome	ಕಾರ್ಡಿಯೋಮ್
Pharma	ಫಾರ್ಮಾ
Corporation	ಕಾರ್ಪೊರೇಶನ್
Roger	ರೋಜರ್
Harper	ಹಾರ್ಪರ್
Guttoo	ಗುಟ್ಟೂ
Deshpande	ದೇಶಪಾಂಡೆ
Frasier	ಫ್ರೇಜಿಯರ್
Taan	ತಾನ್
Ek	ಏಕ್
Din	ದಿನ್
Achanak	ಅಚಾನಕ್
Sodexho	ಸೊಡೆಕ್ಸೋ
Alliance	ಅಲಯನ್ಸ್
Saralaa	ಸರಳಾ
Lassie	ಲಸ್ಸೀ
Strawberry	ಸ್ಟ್ರಾಬೆರ್ರಿ
Fields	ಫೀಲ್ಡ್ಸ್
World	ವರ್ಲ್ಡ್
School	ಸ್ಕೂಲ್
Dharam	ಧರಂ
Kimber	ಕಿಂಬರ್
BHEL	ಬಿಎಚ್ಇಎಲ್
Ladies	ಲೇಡೀಸ್
Only	ಓನ್ಲಿ
Narapat	ನರಪತ್
Fritz	ಫ್ರಿಟ್ಸ್
Yahan	ಯಹಾ
Se	ಸೆ
Shaher	ಶಹರ್
Ko	ಕೋ
Dekho	ದೇಖೋ
Aplam	ಅಪಲಮ್
Chaplam	ಚಪಲಮ್
Millea	ಮಿಲ್ಲೀ
Holdings	ಹೋಲ್ಡಿಂಗ್ಸ್
Allayna	ಅಲ್ಲಾಯ್ನಾ
Bakhtiaar	ಭಕ್ತಿಯಾರ್
Provence	ಪ್ರೋವೆನ್ಸ್
Karunamayi	ಕರುಣಾಮಯಿ
Raj	ರಾಜ್
Dulari	ದುಲಾರಿ
Ayman	ಅಯ್ಮಾನ್
Fort	ಫೋರ್ಟ್
lovrijenac	ಲೌರಿಜೆನಕ್
Kal	ಕಲ್
Aaj	ಆಜ್
Aur	ಔರ್
Kal	ಕಲ್
Dhulkot	ಧೂಲಕೋಟ್
Baat	ಬಾತ್
Ek	ಏಕ್
Raat	ರಾತ್
Ke	ಕೀ
Aaye	ಆಯೆ
Din	ದಿನ್
Bahar	ಬಹಾರ್
Ke	ಕೆ
Astro	ಆಸ್ಟ್ರೋ
Chess	ಚೆಸ್
Bankata	ಬಂಕತಾ
Ganeshganj	ಗಣೇಶ್‌ಗಂಜ್
Rajin	ರಜಿನ್
Saleh	ಸಾಲೇ
Prachetas	ಪ್ರಚೇತಸ್
Passing	ಪಾಸ್ಸಿಂಗ್
Show	ಶೋ
Laheri	ಲಹರೀ
Jiwan	ಜೀವನ್
Philo	ಫಿಲೋ
Wallace	ವ್ಯಾಲೇಸ್
Ahmed	ಅಹಮದ್
al-Buni	ಅಲ್-ಬುನಿ
Payasvinee	ಪಯಸ್ವಿನೀ
Ahmad	ಅಹಮದ್
al-Arabi	ಅಲ್-ಅರಾಬಿ
al-Darqawi	ಅಲ್-ದರ್ಖಾವಿ
Atticus	ಏಟಿಕಸ್
Dulrasar	ದುಲರಾಸರ್
Tata	ಟಾಟಾ
Sponge	ಸ್ಪಾನ್ಜ್
Iro	ಇರೊ
Vinoba	ವಿನೋಬಾ
Bhave	ಭಾವೆ
Banjaran	ಬಂಜರನ್
Kirtana	ಕೀರ್ತನಾ
Shaanxi	ಶಾಂಕ್ಸಿ
History	ಹಿಸ್ಟರಿ
Museum	ಮ್ಯೂಸಿಯಂ
Baqi	ಬಾಕಿ
Mahalon	ಮಹಲೋಂ
Ke	ಕೆ
Khwab	ಖ್ವಾಬ್
Marlon	ಮರ್ಲಾನ್
Samuels	ಸ್ಯಾಮುಯಲ್ಸ್
Imam	ಇಮಾಮ್
Shamil	ಶಾಮಿಲ್
Kamajit	ಕಾಮಜಿತ್
Shyamala	ಶ್ಯಾಮಲ
Amadeus	ಅಮೆಡಿಯಸ್
Hum	ಹಮ್
Bhi	ಭೀ
Insaan	ಇನ್ಸಾನ್
Hai	ಹೈ
Anshi	ಅನ್ಶಿ
Thiruvazhunthoor	ತಿರುವಳಂತೂರ್
Abdul	ಅಬ್ದುಲ್
jabbar	ಜಬ್ಬಾರ್
Aslana	ಅಸ್ಲಾನಾ
Konkar	ಕೋಂಕರ್
Sushanti	ಸುಶಾಂತಿ
Fort	ಫೋರ್ಟ್
calgary	ಕಲ್‌ಗಾರೆ
Pyar	ಪ್ಯಾರ್
Ki	ಕಿ
Manzil	ಮನ್ಜಿಲ್
Godavari	ಗೋದಾವರಿ
Carnegie	ಕಾರ್ನೆಜ್
Medal	ಮೆಡಲ್
Gholvad	ಘೋಲ್ವಾಡ್
Gurudwara	ಗುರುದ್ವಾರ
Pounta	ಪೌಂಟಾ
Sahib	ಸಾಹಿಬ್
Punyabrat	ಪುಣ್ಯಬ್ರತ್
Mani	ಮಣಿ
Aaminah	ಆಮಿನಾ
Silverline	ಸಿಲ್ವರ್‌ಲೈನ್
Heera	ಹೀರಾ
Panna	ಪನ್ನಾ
Neelabja	ನೀಲಾಬ್ಜಾ
Toyota	ಟೊಯೊಟಾ
Motor	ಮೋಟಾರ್
Dashasyajit	ದಶಾಯಜಿತ್
Jaan	ಜಾನ್
Maan	ಮಾನ್
Maryada	ಮರ್ಯಾದಾ
Brendan	ಬ್ರೆಂಡಾನ್
Taylor	ಟೇಲರ್
Iwo	ಇವೋ
Jima	ಜಿಮಾ
Ajanta	ಅಜಂತಾ
Ellora	ಎಲ್ಲೋರಾ
Niyaz	ನಿಯಾಜ್
Utsaah	ಉತ್ಸಾ
Pundarik	ಪುಂಡರೀಕ್
The	ದಿ
humber	ಹಂಬರ್
forts	ಫೋರ್ಟ್ಸ್
Amoha	ಅಮೋಹಾ
Ovcharska	ಔಚಾರ್ಸ್ಕ
svirka	ಸ್ವಿರ್ಕ
Agorot	ಅಗೊರೊಟ್
Kessel	ಕೆಸೆಲ್
Manoranjan	ಮನೋರಂಜನ್
Kranti	ಕ್ರಾಂತಿ
Sienna	ಸಿಯೆನಾ
Gearing	ಗೇರಿಂಗ್
Rupaiya	ರುಪಯ್ಯಾ
Hague	ಹೇಗ್
Fadeelah	ಫದೀಲಾ
Srirangam	ಶ್ರೀರಂಗಂ
Hum	ಹಮ್
Hain	ಹೈ
Lajawab	ಲಾಜವಾಬ್
Karamdata	ಕರಮದಾತಾ
Mama	ಮಾಮಾ
Bhanja	ಭಾಂಜಾ
Tambe	ತಾಂಬೆ
Hugo	ಹ್ಯೂಗೋ
Award	ಅವಾರ್ಡ್
Abdul	ಅಬ್ದುಲ್
muhaaymin	ಮುಹಾಯಮೀನ್
Iliamna	ಇಲಿಯಾಮ್ನಾ
Jump	ಜಂಪ್
Rope	ರೋಪ್
Brad	ಬ್ರ್ಯಾಡ್
Pitt	ಪಿಟ್
Kamini	ಕಾಮಿನಿ
Saint	ಸೇಂಟ್
Olavs	ಒಲಾವ್ಸ್
medal	ಮೆಡಲ್
with	ವಿತ್
Oak	ಓಕ್
Branch	ಬ್ರ್ಯಾಂಚ್
Vishvajayee	ವಿಶ್ವಜಯ
Hum	ಹಮ್
Farishte	ಫರಿಶ್ತೆ
Nahin	ಹೈ
Dhodhar	ಧೋಧರ್
Pimpalkhare	ಪಿಂಪಲ್‌ಖರೆ
Kacy	ಕೇಸಿ
Xanthe	ಜಾನ್ತೆ
Aahi	ಆಹಿ
Tera	ಟೆರಾ
tali	ತಾಲಿ
Fort	ಫೋರ್ಟ್
crown	ಕ್ರೌನ್
point	ಪಾಯಿಂಟ್
Swiftsure	ಸ್ವಿಫ್ಟ್‌ಶೂರ್
Amrah	ಅಮ್ರಾ
Alvin	ಆಲ್ವಿನ್
Martin	ಮಾರ್ಟಿನ್
Harpertzoon	ಹಾರ್ಪೆರ್ಟ್ಸ್‌ಜೂನ್
Tromp	ಟ್ರಾಂಮ್ಪ್
Odele	ಒಡೀಲ್
Aandhi	ಆಂಧೀ
Aur	ಔರ್
Toofan	ತೂಫಾನ್
Fidelio	ಫಿಡೆಲಿಯೊ
Indu	ಇಂದು
Winnie	ವಿನ್ನೀ
Mandela	ಮಂಡೇಲಾ
Chandigadia	ಚಂಡೀಗಢಿಯಾ
Fort	ಫೋರ್ಟ್
sainte	ಸೆಂಟ್
anne	ಆನಿ
Toubro	ಟೂಬ್ರೊ
Infotech	ಇನ್ಫೋಟೆಕ್
Hinduja	ಹಿಂದುಜಾ
Group	ಗ್ರೂಪ್
Oklahoma	ಒಕ್ಲಹೋಮಾ
city	ಸಿಟಿ
Abdul	ಅಬ್ದುಲ್
tawwab	ತವ್ವಾಬ್
Nilay	ನಿಲಯ್
Malamaal	ಮಾಲಾಮಾಲ್
Albert	ಅಲ್ಬರ್ಟ್
Medal	ಮೆಡಲ್
Railway	ರೈಲ್ವೆ
Museum	ಮ್ಯೂಸಿಯಂ
of	ಆಫ್
Athens	ಅಥೆನ್ಸ್
Dwarikesh	ದ್ವಾರಕೀಶ್
Sugar	ಶುಗರ್
Denis	ಡೆನಿಸ್
Aberhart	ಅಬರಾರ್ಟ್
Fort	ಫೋರ್ಟ್
snelling	ಸ್ನೆಲ್ಲಿಂಗ್
Elham	ಎಲ್ಹಾಮ್
Spence	ಸ್ಪೆನ್ಸ್
Supreme	ಸುಪ್ರೀಂ
Ind	ಇಂಡ್
Diler	ದಿಲೇರ್
Daku	ಡಾಕೂ
Farhat	ಫರ್ಹತ್
Verna	ವೆರ್ನಾ
Indian	ಇಂಡಿಯನ್
International	ಇಂಟರ್‌ನ್ಯಾಶನಲ್
School	ಸ್ಕೂಲ್
Hoche	ಹೋಚಿ
Abdul	ಅಬ್ದುಲ್
muzanni	ಮುಜಾನ್ನಿ
Yaounde	ಯಾಂಡೆಡ್
Gangaa	ಗಂಗಾ
Aakrant	ಆಕ್ರಾಂತ್
Protection	ಪ್ರೊಟೆಕ್ಷನ್
of	ಆಫ್
Natural	ನ್ಯಾಚುರಲ್
Amenities	ಅಮೇನಿಟಿಸ್
Medal	ಮೆಡಲ್
Williams	ವಿಲಿಯಮ್ಸ್
Tower	ಟವರ್
Surana	ಸುರಾನಾ
Tumucumaque	ತುಮುಕುಮಾಕ್ಯು
Achalganj	ಅಚಲ್‌ಗಂಜ್
Mahanagar	ಮಹಾನಗರ್
Gas	ಗ್ಯಾಸ್
LeoNardo	ಲಿಯೋನಾರ್ಡೋ
Di	ಡೀ
Caprio	ಕೇಪ್ರಿಯೋ
Gajarupa	ಗಜರೂಪ
Century	ಸೆಂಚುರಿ
Textiles	ಟೆಕ್ಸ್‌ಟೈಲ್ಸ್
Ek	ಏಕ್
Shriman	ಶ್ರೀಮಾನ್
Ek	ಏಕ್
Shrimati	ಶ್ರೀಮತಿ
Franco-British	ಫ್ರಾಂಕೊ-ಬ್ರಿಟಿಶ್
War	ವಾರ್
Kowloon	ಕೌಲೂನ್
Trista	ತ್ರಿಸ್ತಾ
American	ಅಮೆರಿಕ
Numismatic	ನ್ಯೂಮಿಸ್‌ಮ್ಯಾಟಿಕ್
Society	ಸೊಸೈಟಿ
Museum	ಮ್ಯೂಸಿಯಂ
Fort	ಫೋರ್ಟ್
banks	ಬ್ಯಾಂಕ್ಸ್
Shake	ಶೇಕ್
Hands	ಹ್ಯಾಂಡ್ಸ್
University	ಯುನಿವರ್ಸಿಟಿ
of	ಆಫ್
Nevada	ನೇವಡಾ
Yashodhan	ಯಶೋಧನ್
Godavari	ಗೋದಾವರಿ
Fertilizers	ಫರ್ಟಿಲೈಜರ್ಸ್
and	ಅಂಡ್
Chemicals	ಕೆಮಿಕಲ್ಸ್
Ekadashi	ಏಕಾದಶಿ
Zoe	ಝೋಯ್
Chitrarath	ಚಿತ್ರರಥ್
Steven	ಸ್ಟೀವನ್
Jack	ಜಾಕ್
Janwar	ಜಾನವರ್
Dil	ದಿಲ್
Tera	ತೆರಾ
Diwana	ದೀವಾನಾ
Gurudwara	ಗುರುದ್ವಾರ
Maal	ಮಾಲ್
Tekri	ಟೇಕ್ರಿ
Purulia	ಪುರುಲಿಯಾ
Vibhooshan	ವಿಭೂಷಣ್
Hariprasad	ಹರಿಪ್ರಸಾದ್
chaurasia	ಚೌರಾಸಿಯಾ
Iman	ಇಮಾನ್
Bewakkoof	ಬೇವಕೂಫ್
Mandan	ಮಂಡನ್
Bk	ಬ್ಯಾಂಕ್
Of	ಆಫ್
Rajasthan	ರಾಜಸ್ತಾನ್
Chifley	ಸಿಪ್ಲೆ
Tower	ಟವರ್
Popli	ಪೋಪಲಿ
Farah	ಫರಾ
Nihal	ನಿಹಾಲ್
Giddh	ಗಿದ್ಧ್
Matkar	ಮಾತ್ಕರ್
Aerobics	ಏರೋಬಿಕ್ಸ್
Yehiam	ಯೆಹಿಯಮ್
fort	ಫೋರ್ಟ್
National	ನ್ಯಾಶನಲ್
Museum	ಮ್ಯೂಸಿಯಂ
of	ಆಫ್
American	ಅಮೇರಿಕನ್
Indian	ಇಂಡಿಯನ್
Arati	ಆರತಿ
Bhadrakh	ಭದ್ರಾಖ್
Allie	ಅಲ್ಲೀ
Newdigate	ನ್ಯೂಡಿಗೇಟ್
prize	ಪ್ರೈಜ್
Hidayat	ಹಿದಾಯತ್
Inayat	ಇನಾಯತ್
Khan	ಖಾನ್
Farihah	ಫರಿಹಾ
Ek	ಏಕ್
Raaz	ರಾಜ್
Bindiya	ಬಿಂದಿಯಾ
Aur	ಔರ್
Bandook	ಬಂದೂಕ್
Ek	ಏಕ್
Raat	ರಾತ್
Walter	ವಾಲ್ಟರ್
Scott	ಸ್ಕಾಟ್
Guiliaine	ಗುಯಿಲಿಯೆನ್
Wedlock	ವೆಡ್‌ಲಾಕ್
Man	ಮ್ಯಾನ್
Booker	ಬೂಕರ್
Prize	ಪ್ರೈಜ್
Dhanraj	ಧನರಾಜ್
Abduh	ಅಬ್ದು
shaahid	ಶಹೀದ್
Shashaank	ಶಶಾಂಕ್
Rugby	ರಗ್‌ಬೈ
Union	ಯೂನಿಯನ್
World	ವರ್ಲ್ಡ್
Cup	ಕಪ್
Ambedkarnagar	ಅಂಬೇಡ್ಕರ್ ನಗರ್
Takhat	ತಖ್ತ್
Shri	ಶ್ರೀ
Damdama	ದಂದಮಾ
Sahib,	ಸಾಹಿಬ್,
Banthida	ಭಟಿಂಡಾ
(Punjab)	(ಪಂಜಾಬ್)
State	ಸ್ಟೇಟ್
B	ಬ್ಯಾಂಕ್
Bikaner	ಬಿಕನೇರ್
Qameer	ಕಮೀರ್
Johny	ಜಾನಿ
I	ಐ
Love	ಲವ್
You	ಯು
Rain	ರೈನ್
Calcining	ಕ್ಯಾಲ್ಸಿನಿಂಗ್
Bagha	ಬಾಘಾ
Antu	ಅಂತು
Athens	ಅಥೆನ್ಸ್
Eleftherios	ಎಲೆಫ್ತೆರಿಯೊಸ್
Venizelos	ವೆನಿಜೆಲೊಸ್
Devadutt	ದೇವದತ್ತ
Niyati	ನಿಯತಿ
Fawn	ಫಾನ್
Ghaith	ಗೈಥ್
Rashtraveer	ರಾಷ್ಟ್ರವೀರ್
Shivaji	ಶಿವಾಜಿ
Bhaalachan_dr	ಭಾಲಚಂದ್ರ
K	ಕೆ
Sera	ಸೆರಾ
Sera	ಸೆರಾ
Balavaan	ಬಲವಾನ್
Ujaalaa	ಉಜಾಲಾ
Shubh	ಶುಭ್
Lucie	ಲೂಸಿ
Raag	ರಾಗ್
Rang	ರಂಗ್
Lucia	ಲುಸಿಯಾ
Kalimba	ಕಲಿಂಬಾ
Khushal	ಖುಶಾಲ್
Ekchari	ಎಕ್ಚಾರಿ
Vaishno Devi	ವೈಷ್ಣೋದೇವಿ
Leland	ಲಿಲ್ಯಾಂಡ್
Suramaee	ಸುರಮಯಿ
Taranga	ತರಂಗ
Babbar	ಬಬ್ಬರ್
Saaransh	ಸಾರಾಂಶ್
Deeptimoy	ದೀಪ್ತಿಮಯಿ
Pathyaa	ಪಥ್ಯಾ
Aaj	ಆಜ್
Ka	ಕಾ
Daur	ದೌರ್
Ammar	ಅಮ್ಮಾರ್
Anika	ಅನಿಕಾ
Alain	ಅಲೆನ್
Bimala	ಬಿಮಲಾ
Farlington	ಫಾರ್ಲಿಂಗ್ಟನ್
redoubt	ರಿಡೌಟ್
Indravishnu	ಇಂದ್ರವಿಷ್ಣು
Wail	ವೈಲ್
Ayyappa	ಅಯ್ಯಪ್ಪ
Halim	ಹಲೀಂ
Narsi	ನರಸೀ
Mehta	ಮೆಹ್ತಾ
Rama Lingeshwara	ರಾಮಲಿಂಗೇಶ್ವರ
Ruchira	ರುಚಿರಾ
Kaalanjay	ಕಾಲಂಜಯ
Hoysaleswara	ಹೊಯ್ಸಳೇಶ್ವರ
Qatar	ಖತಾರ್
Fareed	ಫರೀದ್
Carlos	ಕಾರ್ಲೋಸ್
Castaneda	ಕ್ಯಾಸ್ಟೆನೇಡಾ
Meghdutt	ಮೇಘದತ್
Gyaneshwari	ಜ್ಞಾನೇಶ್ವರಿ
Benjamin	ಬೆಂಜಮಿನ್
Spock	ಸ್ಪಾಕ್
Barpeta	ಬಾರ್ಪೇಟ
Hum	ಹಮ್
Hindustani	ಹಿಂದೂಸ್ತಾನೀ
Kartik	ಕಾರ್ತಿಕ್
Gerhardus	ಗೆರಾರ್ಡಸ್
Liebenberg	ಲೀಬೆನ್‌ಬರ್ಗ್
Tohoku	ತೊಹೊಕು
Electirc	ಎಲೆಕ್ಟ್ರಿಕ್
Power	ಪವರ್
Fort	ಫೋರ್ಟ್
bij	ಬಿಜ್
tienhoven	ಟಿನ್‌ಹೋವೆನ್
Abdul	ಅಬ್ದುಲ್
khabeer	ಖಬೀರ್
Dhumravarn	ಧುಮ್‌ರಾವರ್ನ್
Bozeman	ಬೋಜಿಮನ್
Sumanah	ಸುಮನಾ
Qutaylah	ಕುತೇಲಾ
Letitia	ಲೆಟಿಟಾ
Nazima	ನಜೀಮಾ
Garwa	ಗರ್ವಾ
Road	ರೋಡ್
Tavse	ತಾವ್ಸೆ
Baddhan	ಬದ್ಧಣ್
Backbone	ಬ್ಯಾಕ್‌ಬೋನ್
Addison	ಆಡಿಸನ್
Electronic	ಎಲೆಕ್ಟ್ರಾನಿಕ್
Data	ಡಾಟಾ
System	ಸಿಸ್ಟಮ್
Walter	ವಾಲ್ಟರ್
Coligny	ಕೊಲಿನಿ
Gracie	ಗ್ರೆಸೀ
Lakshmeekaant	ಲಕ್ಷ್ಮೀಕಾಂತ್
Lucrece	ಲ್ಯೂಕ್ರೀಸ್
Kolar	ಕೋಲಾರ
Hsbc	ಎಚ್ಎಸ್‌ಬಿಸಿ
Holdings	ಹೋಲ್ಡಿಂಗ್ಸ್
Won	ವೋನ್
Alpesh	ಅಲ್ಪೇಶ್
Vadher	ವಧೆರ್
Rajgeer	ರಾಜ್ ಗೀರ್
Al	ಅಲ್
Baharen	ಬಹಾರೇಂ
Phir	ಫಿರ್
Bhi	ಭೀ
Ayengi	ಆಯೆಂಗಿ
Pyar	ಪ್ಯಾರ್
Ki	ಕಿ
Raat	ರಾತ್
Bindra	ಬಿಂದರಾ
Pat	ಪ್ಯಾಟ್
Boon	ಬೂನ್
Dhaka	ಢಾಕಾ
Irai	ಇರಾಯ್
Riona	ರಿಯೋನಾ
Mehsaana	ಮೆಹ್ಸಾನಾ
Chris	ಕ್ರಿಸ್
Martin	ಮಾರ್ಟಿನ್
Abdullah	ಅಬ್ದುಲ್ಲಾ
Kail	ಕೈಲ್
El-nefous	ಅಲ್-ನೆಫಸ್
Citadelle	ಸಿಟಾಡೆಲ್
fort	ಫೋರ್ಟ್
Russo-Turkish	ರಸ್ಸೊ-ಟರ್ಕಿಶ್
War	ವಾರ್
Mountrail	ಮೌಂಟ್ರೇಲ್
Daryll	ಡೆರಿಲ್
Cullinan	ಕಲಿನನ್
Vajraabh	ವಜ್ರಾಭ್
Chitkala	ಚಿತ್‌ಕಲಾ
Filipina	ಫಿಲಿಪಿನಾ
Alger	ಆಲ್ಗರ್
Hiss	ಹಿಸ್
Induleksh	ಇಂದುಲೇಖ
Voltaire	ವೋಲ್ಟೇರ್
Ekalavya	ಏಕಲವ್ಯ
Aluabari	ಅಲೌಬಾರಿ
Road	ರೋಡ್
Ruby	ರೂಬಿ
American	ಅಮೆರಿಕನ್
International	ಇಂಟರ್ನ್ಯಾಷನಲ್
Building	ಬಿಲ್ಡಿಂಗ್
Shabib	ಶಬೀಬ್
Pixelplus	ಪಿಕ್ಸೆಲ್‌ಪ್ಲಸ್
Fort	ಫೋರ್ಟ್
william	ವಿಲಿಯಮ್
henry	ಹೆನ್ರಿ
Race	ರೇಸ್
Aaj	ಆಜ್
Ka	ಕಾ
Arjun	ಅರ್ಜುನ್
Harad	ಹರದ್
Sada	ಸದಾ
Suhagan	ಸುಹಾಗನ್
Pukaskwa	ಪುಕಾಸ್ಕ್ವಾ
Rod	ರಾಡ್
Serling	ಸೆರ್ಲಿಂಗ್
Baaran	ಬಾರನ್
Lubana	ಲುಬಾಣಾ
Maine	ಮೈ
Jeena	ಜೀನಾ
Seekh	ಸೀಖ್
Liya	ಲಿಯಾ
Zee	ಜೀ
Telefims	ಟೆಲಿಫಿಲಮ್ಸ್
Aakaankshaa	ಆಕರ್ಷಣಾ
Armand	ಅರ್ಮಾಂಡ್
Hammer	ಹ್ಯಾಮರ್
Oregon	ಓರೆಗಾನ್
Queen's	ಕ್ವೀನ್ಸ್
Scout	ಸ್ಕೌಟ್
Fort	ಫೋರ್ಟ್
scraesdon	ಸ್ಕ್ರಾಸ್‌ಡನ್
Abhimanyu	ಅಭಿಮನ್ಯು
Guj	ಗುಜ್
Ind	ಇಂಡ್
Power	ಪವರ್
Bhise	ಭಿಸೆ
Julien	ಜುಲಿಯನ್
Wiener	ವೀನರ್
Aap	ಆಪ್
Ki	ಕಿ
Kasam	ಕಸಮ್
Kalirai	ಕಲಿರಾಜ್
Manideepa	ಮಣಿದೀಪ
Peter	ಪೀಟರ್
Strasser	ಸ್ಟ್ರಾಸರ್
Baaligh	ಬಾಲಿಗ್
Colombia	ಕೊಲಂಬಿಯಾ
Murchison	ಮುರ್ಚಿಸನ್
Falls	ಫಾಲ್ಸ್
Marvin	ಮಾರ್ವಿನ್
H	ಹೆಚ್
McIntyre	ಮ್ಯಾಕ್‌ಇಂಟೈರಿ
Pimparikar	ಪಿಂಪಾರಿಕರ್
Khulaybah	ಖುಲೇಬಾ
Koi	ಕೋಯಿ
Jeeta	ಜೀತಾ
Koi	ಕೋಯಿ
Hara	ಹಾರಾ
Kora	ಕೊರಾ
Anchal	ಆಂಚಲ್
Vikram	ವಿಕ್ರಮ್
Rathour	ರಾಠೋರ್
Dhadhria	ಢಾಡ್ರಿಯಾ
Kothe	ಕೋಠೆ
Wade	ವೆಟಿ
Hababah	ಹಬಬಾ
Gumnaam	ಗುಮ್ನಾಮ್
Hai	ಹೈ
Koi	ಕೋಯಿ
Eskalis	ಎಸ್ಕಾಲಿಸ್
Arul	ಅರುಳ್
Sunset	ಸನ್‌ಸೆಟ್
Hills	ಹಿಲ್ಸ್
Chal	ಚಲ್
Chal	ಚಲ್
Re	ರೆ
Naujawan	ನಂಜಾವನ್
Glen	ಗ್ಲೆನ್
David	ಡೇವಿಡ್
Hookes	ಹೂಕ್ಸ್
Hamajoli	ಹಮಜೊಲಿ
Hawas	ಹವಸ್
Nicole	ನಿಕೋಲ್
Brown	ಬ್ರೌನ್
Simpson	ಸಿಂಪ್ಸನ್
Piratenpriset	ಪಿರಾಟೆನ್‌ಪ್ರಿಸೆಟ್
The	ದ
pioneer	ಪಯೊನೀರ್
(daily)	(ಡೈಲಿ)
Hammam	ಹಮಾಮ್
Randilyn	ರೇಂಡಿಲಿನ್
Baap	ಬಾಪ್
Numbari	ನಂಬರೀ
Beta	ಬೆಟಾ
Dus	ದಸ್
Numbari	ನಂಬರೀ
Venkateshwar	ವೆಂಕಟೇಶ್ವರ
Journey	ಜರ್ನಿ
Fellowship	ಫೆಲೋಶಿಪ್
Lou	ಲಾವೂ
Medak	ಮೇದಕ್
Suresh	ಸುರೇಶೆ
Perera	ಪೆರೇರಾ
Roshan	ರೋಶನ್
Jurangpathy	ಜುರಂಗಪತಿ
Pannalal	ಪನ್ನಾಲಾಲ್
Agrawal	ಅಗರ್‌ವಾಲ್
Aghwanpur	ಅಗ್ವಾನ್‌ಪುರ್
Meri	ಮೇರಿ
Awaaz	ಆವಾಜ್
Suno	ಸುನೋ
Saeed	ಸಯೀದ್
Bin	ಬಿನ್
Nasir	ನಾಸಿರ್
Tokantins	ಟೋಕಾಂಟಿನ್ಸ್
Bekhbar	ಬೆಖಬರ್
Pepsico	ಪೆಪ್ಸಿಕೋ
Saamna	ಸಾಮ್ನಾ
Supriti	ಸುಪ್ರೀತಿ
Keanu	ಕೀನು
Reeves	ರೀವ್ಸ್
Astra	ಆಸ್ಟ್ರಾ
Microwave	ಮೈಕ್ರೋವೇವ್
British	ಬ್ರಿಟಿಶ್
Nakesh	ನಕೇಶ್
Saamra	ಸಾಮರಾ
Abdus	ಅಬ್ದುಸ್
sameei	ಸಮೀ
Halaku	ಹಲಾಕೂ
Basmat	ಬಸಮತ್
Surfing	ಸರ್ಫಿಂಗ್
Blair	ಬ್ಲೇರ್
Hartland	ಹಾರ್ಟ್‌ಲ್ಯಾಂಡ್
Keefer	ಕೀಫರ್
Saint	ಸೆಂಟ್
Michael's	ಮೈಕೇಲ್
Academy,	ಅಕಾಡೆಮಿ,
Chennai	ಚೆನ್ನೈ
Aahladit	ಆಹ್ಲಾದಿತ್
Jai	ಜೈ
Ganesh	ಗಣೇಶ್
Muniya	ಮುನಿಯಾ
Kush	ಕುಶ
Havells	ಹ್ಯಾವೆಲ್ಸ್
India	ಇಂಡಿಯಾ
Zapata	ಜಪತಾ
Kemp	ಕೆಂಪ್
Ununquadium	ಯುನುನ್‌ಕ್ವಾಂಡಿಯಂ
Pinakin	ಪಿನಾಕಿನಿ
Kemijarvi	ಕೆಮಿಜರ್ವಿ
Wachhar	ವಚ್ಚರ್
Gourie	ಗೌರೀ
Mansukh	ಮನಸುಖ
Muhammad	ಮುಹಮ್ಮದ್
Ahmad	ಅಹಮದ್
Chirmiri	ಚಿರಮುರಿ
Balaraj	ಬಾಲರಾಜ್
Gourde	ಗಾರ್ಡಿ
Frank	ಫ್ರಾಂಕ್
furt	ಫರ್ಟ್
Max	ಮ್ಯಾಕ್ಸ್
India	ಇಂಡಿಯಾ
Mehandiratta	ಮೆಹಂದಿರತ್ತಾ
Illinois	ಇಲಿನಾಯ್ಸ್
Lindy	ಲಿಂಡಿ
hop	ಹಾಪ್
Vic	ವಿಕ್
Marks	ಮಾರ್ಕ್ಸ್
Priyamvada	ಪ್ರಿಯಂವದ
Adyan	ಆದ್ಯನ್
Ion	ಇಯೋನ್
Romeo	ರೋಮಿಯೊ
Abhibhav	ಅಭಿಭಾವ್
Humsaya	ಹಮ್ಸಾಯಾ
Nick	ನಿಕ್
Cook	ಕುಕ್
Muhannad	ಮುಹನ್ನದ
Dakha	ದಾಖಾ
Chitrawad	ಚಿತ್ರಾವದ್
San	ಸ್ಯಾನ್
Remo	ರೆಮೊ
Music	ಮ್ಯೂಸಿಕ್
Festival	ಫೆಸ್ಟಿವಲ್
Nirmayi	ನಿರ್ಮಯಿ
Usha	ಉಷಾ
Martin	ಮಾರ್ಟಿನ್
Gholam	ಘುಲಾಂ
Nousher	ನೌಶೆರ್
Friedland	ಫ್ರೆಡ್‌ಲ್ಯಾಂಡ್
Barbara	ಬರ್ಬರಾ
Sandhurst	ಸ್ಯಾಂಡರ್ಸ್ಟ್
Cox	ಕಾಕ್ಸ್
Sabihah	ಸಬೀಹಾ
Bass	ಬಾಸ್
Strait	ಸ್ಟ್ರೇಟ್
Vimohinee	ವಿಮೋಹಿನಿ
Altamaha	ಅಲ್ತಾಮಹಾ
Humam	ಹುಮಾಮ್
Nikhat	ನಿಖತ್
Bhagam	ಭಾಗಮ್
Bhag	ಭಾಗ್
Shahid-E-Mohabbat	ಶಾಹಿದ್-ಎ-ಮೊಹಬತ್
Jaidayal	ಜಯದಯಾಲ್
Bhilavdi	ಭಿಲಾವ್ಡಿ
Warwick	ವಾರ್‌ವಿಕ್
Daera	ದಾಯರಾ
Agent	ಏಜೆಂಟ್
Harvard	ಹಾರ್ವರ್ಡ್
University	ಯುನಿವರ್ಸಿಟಿ
Govindgarh	ಗೋವಿಂದಗಢ್
Malk	ಮಲ್ಕ್
Mitch	ಮಿಚ್
Lalana	ಲಲನಾ
Saadat	ಸಾದತ್
Nausherwan	ನೌಶೆರವಾನ್
E	ಎ
Adil	ಅದಿಲ್
Kismat	ಕಿಸ್ಮತ್
Ki	ಕಿ
Kasauti	ಕಸೌತಿ
Rupana	ರುಪಾಣಾ
Ahobilam	ಅಹೋಬಿಲಂ
Saas	ಸಾಸ್
Bhi	ಭೀ
Kabhi	ಕಭೀ
Bahu	ಬಹೂ
Thi	ಥಿ
Waqar	ವಕಾರ್
Younis	ಯೂನಿಸ್
Greenland	ಗ್ರೀನ್‌ಲ್ಯಾಂಡ್
Inkaar	ಇಂಕಾರ್
Tarantella	ಟಾರೆಂಟೆಲ್ಲಾ
Love	ಲವ್
In	ಇನ್
Tokyo	ಟೋಕ್ಯೋ
Anantaraam	ಅನಂತರಾಮ್
Balvir	ಬಲ್ವಿರ್
Radhesh	ರಾಧೇಶ
Maynard	ಮೇನಾರ್ಡ್
Hamari	ಹಮಾರಿ
Mazil	ಮಂನ್ಜಿಲ್
Fadl	ಫದಲ್
Heath	ಹೀತ್
Davis	ಡೇವಿಸ್
Divjot	ದಿವಜೋತ್
Mustafeed	ಮುಸ್ತಫೀದ್
Dumoga	ಡುಮೋಗಾ
Bone	ಬೋನ್
Hong Kong	ಹಾಂಗ್‌ಕಾಂಗ್
Andre	ಆಂದ್ರೆ
Adams	ಆದಮ್ಸ್
Dance	ಡಾನ್ಸ್
Dance	ಡಾನ್ಸ್
Pam	ಪಮ್
Abduh	ಅಬ್ದು
shahid	ಶಹೀದ್
Hero	ಹೀರೋ
of	ಆಫ್
Socialist	ಸೋಶಯಲಿಸ್ಟ್
Labour	ಲೇಬರ್
Dot	ಡಾಟ್
Kurt	ಕುರ್ಟ್
Kasam	ಕಸಮ್
Dhande	ಧಂಧೆ
Ki	ಕಿ
Sebastian	ಸೆಬಾಸ್ಟಿಯನ್
Bambai	ಬಂಬಾಯ್
Ki	ಕೀ
Billi	ಬಿಲ್ಲಿ
Hayah	ಹಯಾ
Protherics	ಪ್ರೋಥೆರಿಕ್ಸ್
Daaka	ಡಾಕಾ
Dighwara	ದಿಗವಾರಾ
Anuraadha	ಅನುರಾಧಾ
Balmer	ಬಾಲ್ಮೆರ್
Lawrie	ಲಾರೀ
Winston	ವಿನ್ಸ್‌ಟನ್
Churchill	ಚರ್ಚಿಲ್
Awara	ಆವಾರಾ ಅಬ್ದುಲ್ಲಾ
Ostroh	ಓಸ್ತ್ರೋ
Bristol	ಬ್ರಿಸ್ಟಲ್
channel	ಚಾನಲ್
fort	ಫೋರ್ಟ್
Neelanjana	ನೀಲಾಂಜನ
Kanch	ಕಾಂಚ್
Ki	ಕಿ
Gudiya	ಗುಡಿಯಾ
Hayat	ಹಯಾತ್
Dumbarton	ಡಂಬರ್ಟನ್
Sarabdev	ಸರಬ್‌ದೇವ್
Daleville	ದಲೆವಿಲ್
Baptist	ಬ್ಯಾಪ್ಟಿಸ್ಟ್
Djembe	ಜೆಂಬೆ
Meghalaya	ಮೇಘಾಲಯ
Goa	ಗೋವಾ
Menai	ಮೆನೈ
Raj	ರಾಜ್
Abdul	ಅಬ್ದುಲ್
majid	ಮಜೀದ್
Fox	ಫಾಕ್ಸ್
Baudhdh	ಬೌದ್ಧ
Rae	ರೇ
Ganga	ಗಂಗಾ
Tere	ತೇರೆ
Desh	ದೇಶ್
Mein	ಮೇ
Qabeel	ಕಬೀಲ್
Freedom	ಫ್ರೀಡಮ್
Award	ಅವಾರ್ಡ್
Molucca	ಮೊಲುಕಾ
Knoxville	ನಾಕ್ಸ್ ವಿಲ್ಲೆ
Hathon	ಹಾಥೋ
Ki	ಕೀ
Lakeer	ಲಕೀರ್
Fort	ಫೋರ್ಟ್
wentworth	ವೆಂಟ್‌ವರ್ತ್
Francis	ಫ್ರಾನ್ಸಿಸ್
Bacon	ಬೇಕಾನ್
Bharat	ಭಾರತ್
Arun	ಅರುಣ್
Scailex	ಸ್ಕೈಲೆಕ್ಸ್
Corporation	ಕಾರ್ಪೊರೇಶನ್
Lander	ಲಾಂಡರ್
Hujaymah	ಹುಜೇಮಾ
Ujung	ಉಜುಂಗ್
Kulon	ಕುಲೋನ್
John	ಜಾನ್
F.	ಎಫ್.
Kennedy	ಕೆನಡಿ
Chaure	ಚೌರೆ
Bazar	ಬಜಾರ್
Dacait	ಡಕಾಯ್ತ್
Mitsubishi	ಮಿತ್ಸುಬಿಷಿ
Motors	ಮೋಟರ್ಸ್
Shaadi	ಶಾದಿ
Ki	ಕಿ
Raat	ರಾತ್
Kovilar	ಕೋವಿಲರ್
Reservoir	ರಿಜರ್ವಾಯರ್
Mehal	ಮೆಹಲ್
Sinhgad	ಸಿಂಗದ್
Jennelle	ಜೆನ್ನೆಲ್ಲಿ
Shamel	ಶಮೆಲ್
Rahole	ರಹೋಲೆ
Tab	ತಾಬ್
Shri Mangal	ಶ್ರೀಮಂಗಳ
Owena	ಒವೆನಾ
Forbesganj	ಫೋರ್ಬ್ಸ್‌ಗಂಜ್
Uzma	ಉಜ್ಮಾ
Fort	ಫೋರ್ಟ್
barrancas	ಬಾರಂಕಾಸ್
Chhaya	ಛಾಯಾ
Baisakhi	ಬೈಸಾಖಿ
Enel	ಎನೆಲ್
Azraqee	ಅಜ್ರಾಕೀ
Franklin	ಫ್ರಾಂಕ್ಲಿನ್
Roosevelt	ರೂಸೆವೆಲ್ಟ್
Aakanksha	ಆಕಾಂಕ್ಷಾ
Hanash	ಹನಷ್
Jayantika	ಜಯಂತಿಕ
Bank	ಬ್ಯಾಂಕ್
Manager	ಮೇನೇಜರ್
Jawani	ಜವಾನಿ
Diwani	ದಿವಾನಿ
Vandanaa	ವಂದನಾ
Precious	ಪ್ರಿಶಿಯಸ್
Nafasat	ನಫಸತ್
Van	ವನ್
Rustom-E-Hind	ರುಸ್ತಮ್-ಎ-ಹಿಂದ್
Nanda	ನಂದಾ
Devi	ದೇವಿ
Charnon	ಚರಣೋಂ
Ki	ಕಿ
Dasi	ದಾಸಿ
Acharynandanaa	ಆಚಾರ್ಯನಂದನಾ
Trump	ಟ್ರಂಪ್
Gaye	ಗಾಯೆ
Beijing	ಬೀಜಿಂಗ್
Mansite	ಮ್ಯಾನ್‌ಸೈಟ್
Museum	ಮ್ಯೂಸಿಯಂ
Wind	ವಿಂಡ್
River	ರಿವರ್
Laylo	ಲಾಯ್ಲೋ
Nehar	ನಹರ್
Rockwell	ರಾಕ್‌ವೆಲ್
Duaba	ದುವಾಬಾ
Gale	ಗೇಲ್
Littlehampton	ಲಿಟಲ್‌ಹ್ಯಾಂಪ್ಟನ್
redoubt	ರಿಡೌಟ್
Arshaq	ಅರ್ಷಾಕ್
Saugandh	ಸೌಗಂಧ್
Pampa	ಪಂಪಾ
Award	ಅವಾರ್ಡ್
Baha	ಬಹಾ
al	ಅಲ್
din	ದೀನ್
Somalia	ಸೋಮಾಲಿಯಾ
Fort	ಫೋರ್ಟ್
battleford	ಬ್ಯಾಟಲ್‌ಫೋರ್ಡ್
Wisconsin	ವಿಸ್‌ಕಾನ್ಸಿಸ್
Jundub	ಜುನ್‌ದುಬ್
Gulabhganj	ಗುಲಾಭ್‌ಗಂಜ್
Police	ಪೊಲೀಸ್
Kishwar	ಕಿಶ್ವರ್
Achalesvara	ಅಚಲೇಶ್ವರ
Angus	ಆಂಗಸ್
Mackay	ಮೆಕೇ
Cooke	ಕೂಕ್
Acharyasuta	ಆಚಾರ್ಯಸುತ
Isleen	ಇಸ್ಲೀನ್
Savitaa	ಸವಿತಾ
Numair	ನುಮೈರ್
Aimee	ಏಮೀ
Do	ದೋ
Gulab	ಗುಲಾಬ್
Samant	ಸಮಂತ್
Safeway	ಸೇಫ್‌ವೇ
Grindwell	ಗ್ರೈಂಡ್‌ವೆಲ್
Norto	ನಾರ್ಟೊ
Desh	ದೇಶ್
Ke	ಕೆ
Dushmann	ದುಶ್ಮನ್
Schell	ಸ್ಕಿಲ್
Creek	ಕ್ರೀಕ್
Been	ಬೀನ್
Ka	ಕಾ
Jadu	ಜಾದೂ
Dundlod	ದುಂದಲೋದ್
Celeste	ಸೆಲೆಸ್ಟ್
Amarpura	ಅಮರಾಪುರ
Aphrodite	ಏಫ್ರಡೈಟ್
Saint	ಸೆಂಟ್
Fidelis	ಫಿಡೆಲಿಸ್
College,	ಕಾಲೇಜ್,
Lucknow	ಲಕ್ನೋ
Jasminder	ಜಸ್ಮಿಂದರ್
Imran	ಇಮ್ರಾನ್
Abbas	ಅಬ್ಬಾಸ್
Pyar	ಪ್ಯಾರ್
Ka	ಕಾ
Bandhan	ಬಂಧನ್
Veste	ವೆಸ್ಟೆ
rosenberg	ರೋಸೆನ್‌ಬರ್ಗ್
Brownlow	ಬ್ರೌನ್‌ಲೊ
Medal	ಮೆಡಲ್
Rhoda	ರೋಡಾ
Labopharm	ಲಾಬೋಫಾರ್ಮ್
samleshwar	ಸಾಮಲೇಶ್ವರ
Golanthra	ಗೋಲಂಥರಾ
Neemuch	ನೀಮಚ್
Palashranjan	ಪಲಶ್ರಂಜನ್
Maddock	ಮ್ಯಾಡಾಕ್
Shakirah	ಶಕೀರಾ
Tarannum	ತರನ್ನುಮ್
Koparkar	ಕೊಪರಕರ್
Gurudwara	ಗುರುದ್ವಾರ
Guru	ಗುರು
ke	ಕೇ
Wadali	ವಡಾಲೀ
Ann	ಆನ್
Landers	ಲ್ಯಾಂಡರ್ಸ್
Agni	ಅಗ್ನಿ
Rekha	ರೇಖಾ
Avani	ಅವನಿ
Alibagh	ಆಲಿಬಾಗ್
Fort	ಫೋರ್ಟ್
steuben	ಸ್ಟ್ಯೂಬೆನ್
Bhadan	ಭದಾನ್
National	ನ್ಯಾಶನಲ್
Musem	ಮ್ಯೂಸಿಯಂ
Of	ಆಫ್
Korea	ಕೊರಿಯಾ
Rankings	ರಾಂಕಿಂಗ್ಸ್
Chemin	ಚೆಮಿನ್
de	ಡಿ
fer	ಫೆರ್
fort	ಫೋರ್ಟ್
The	ದ
indian	ಇಂಡಿಯನ್
express	ಎಕ್ಸ್‌ಪ್ರೆಸ್
Dana	ದಾನಾ
Pani	ಪಾನಿ
Chowkidaar	ಚೌಕಿದಾರ್
Cleavon	ಕ್ಲೀವಾನ್
Kundra	ಕುಂದರಾ
Badal	ಬಾದಲ್
Aur	ಔರ್
Bijli	ಬಿಜಲಿ
Gujral	ಗುಜ್‌ರಾಲ್
Overland	ಓವರ್‌ಲ್ಯಾಂಡ್
Hills	ಹಿಲ್ಸ್
Siba	ಸಿಬಾ
United	ಯುನೈಟೆಡ್
America	ಅಮೆರಿಕಾ
Indemnity	ಇಂಡೆಮ್ನಿಟಿ
Morty	ಮೋರ್ಟಿ
Pir	ಪಿರ್
Ghaib	ಘಾಯಿಬ್
Ghara	ಘಾರಾ
No	ನ
1	1
Tower	ಟವರ್
Place	ಪ್ಲೇಸ್
Three	ತ್ರೀ
Field	ಫೀಲ್ಡ್
Sacred	ಸೇಕ್ರೆಡ್
Heart	ಹಾರ್ಟ್
Girls	ಗರ್ಲ್ಸ್
High	ಹೈ
School	ಸ್ಕೂಲ್
Aman	ಅಮನ್
Vadi	ವಾಡಿ
Kismat	ಕಿಸ್ಮತ್
Devastation	ಡೆವಾಸ್ಟೇಶನ್
Chilton	ಚಿಲ್ಟನ್
Viduthalai	ವಿಡುದಲೈ
Evan	ಇವಾನ್
Pramiti	ಪ್ರಮಿತಿ
Kerry	ಕೆರಿ
Jeremy	ಜೆರೆಮಿ
Nick	ನಿಕ್
Knight	ನೈಟ್
Risa	ರೀಜಾ
Karla	ಕಾರ್ಲಾ
Anpara	ಅಂಪರಾ
Oak	ಓಕ್
Hanste	ಹಂಸ್ತೇ
Zakhm	ಜಖ್ಮ್
Traci	ಟ್ರೇಸಿ
Lapalikar	ಲಾಪಾಲಿಕರ್
Ha	ಹಾ
Ha	ಹಾ
He	ಹಿ
He	ಹಿ
Ho	ಹು
Ho	ಹೂ
Gul-e-rana	ಗುಲ-ಎ-ರಾಣಾ
Roller	ರೋಲರ್
skating	ಸ್ಕೇಟಿಂಗ್
Gurudwara	ಗುರುದ್ವಾರ
Raada	ರಾಡಾ
Sahib	ಸಾಹಿಬ್
Ek	ಏಕ್
Dil	ದಿಲ್
Sau	ಸೌ
Afsane	ಅಫಸಾನೆ
Avent	ಅವೆಂಟ್
Holland	ಹಾಲಂಡ್
Chapel	ಚಾಪೆಲ್
Baptist	ಬ್ಯಾಪ್ಟಿಸ್ಟ್
Nan	ನನ್
Ekanga	ಏಕಾಂಗ
Popular	ಪಾಪ್ಯುಲರ್
Gratiana	ಗ್ರೆಟಿಯಾನಾ
Matthias	ಮಥ್ಯಿಯಾಸ್
Abington	ಅಬಿಂಗ್ಟನ್
Mark	ಮಾರ್ಕ್
Haslam	ಹಸ್ಲಾಂ
Gudur	ಗೂಡೂರ್
Junction	ಜಂಕ್ಷನ್
Eeckeren	ಎಚರೆನ್
Grey	ಗ್ರೇ
Cup	ಕಪ್
Jaipur	ಜೈಪುರ್
fort	ಫೋರ್ಟ್
Abdus	ಅಬ್ದುಸ್
sabur	ಸಬೂರ್
Cartoon	ಕಾರ್ಟೂನ್
Museum	ಮ್ಯೂಸಿಯಂ
Kantimoy	ಕಾಂತಿಮಯ್
Galaxy	ಗೆಲಾಕ್ಸಿ
Broom	ಬ್ರೂಮ್
ball	ಬಾಲ್
Bony	ಬೋನಿ
Blair	ಬ್ಲೇರ್
Wren	ರೆನ್
Northampton	ನಾರ್ಥಾಂಪ್ಟನ್
University	ಯುನಿವರ್ಸಿಟಿ
College	ಕಾಲೇಜ್
Mahaabaahu	ಮಹಾಬಾಹು
Jowai	ಜೋವೈ
Utsa	ಉತ್ಸಾ
Parimal	ಪರಿಮಳ್
Michael	ಮೈಖೇಲ್
Jackson	ಜಾಕ್ಸನ್
Bhola	ಭೋಲಾ
Bhala	ಭಾಲಾ
Chaudhvin	ಚೌದ್ವಿನ್
Ka	ಕಾ
Chand	ಚಂದ್
Krashn	ಕೃಷ್ಣ
Bharat	ಭಾರತ್
samachar	ಸಮಾಚಾರ್
Desmond	ಡೆಸ್ಮೊಂಡ್
Humrahi	ಹಮರಾಹ್
Bhuchchu	ಭುಚ್ಚು
Uda	ಉದಾ
Walawe	ವಲಾವೆ
Alamnagar	ಅಲಂನಗರ್
Dewas	ದೇವಾಸ್
Kamrup	ಕಾಮರೂಪ್
Patty	ಪ್ಯಾಟಿ
Duke	ಡ್ಯೂಕ್
Britannic	ಬ್ರಿಟಾನಿಕಾ
Devak	ದೇವಕ್
Sidhdheshvaree	ಸಿದ್ಧೇಶ್ವರೀ
Angarakshak	ಅಂಗರಕ್ಷಕ್
Rocco	ರೊಕೊ
James	ಜೇಮ್ಸ್
Ormond	ಒರ್ಮಾಂಡ್
Gurdev	ಗುರುದೇವ್
Brahmaputra	ಬ್ರಹ್ಮಪುತ್ರ
Manu	ಮನು
The	ದ
Great	ಗ್ರೇಟ್
Greece	ಗ್ರೀಸ್
Clare	ಕ್ಲೇರ್
Alleppey	ಅಲಪ್ಪೆ
Chelsea	ಚೆಲ್ಸಿಯಾ
Whistler	ವ್ಹಿಸ್ಲರ್
Chidambarnaar	ಚಿದಂಬರ್ ನಾರ್
Bad	ಬಾದ್
Rollo	ರೊಲ್ಲೊ
Fort	ಫೋರ್ಟ್
smith	ಸ್ಮಿತ್
Richie	ರಿಚಿ
Robinson	ರಾಬಿನ್ಸನ್
Iris	ಐರಿಸ್
Sanjukta	ಸಂಜುಕ್ತಾ
Ek	ಏಕ್
Tha	ಥಾ
Ladka	ಲಡಕಾ
Hida	ಹಿಡಾ
Max	ಮ್ಯಾಕ್ಸ್
Anaparti	ಅನಪರ್ತಿ
Queen	ಕ್ವೀನ್
Mary	ಮೇರಿ
Leopold	ಲಿಯೋಪೋಲ್ಡ್
Kellan	ಕೆಲ್ಲನ್
Pensioner	ಪೆಂಶನರ್
Junagarh	ಜುನಾಗರ್
Master	ಮಾಸ್ಟರ್
Man	ಮ್ಯಾನ್
Tarang	ತರಂಗ್
Banmanush	ಬನಮಾನುಶ್
Divya	ದಿವ್ಯ
Mawana	ಮವಾನಾ
Sugar	ಶುಗರ್
Premala	ಪ್ರೇಮಲಾ
Ahalya	ಅಹಲ್ಯಾ
Sherman	ಶೆರ್ಮನ್
Balchandra	ಬಾಲಚಂದ್ರ
Lakeeren	ಲಕೀರೇ
Gaushala	ಗೌಶಾಲಾ
Atifa	ಅತಿಫಾ
Mansoor	ಮನ್ಸೂರ್
Rana	ರಾಣಾ
Hamas	ಹಮಾಸ್
Shankar	ಶಂಕರ್
Shambhu	ಶಂಭೂ
Montagu	ಮಾಂಟೆಗೊ
Bedetti	ಬೀದೆತ್ತಿ
Ekatma	ಏಕಾತ್ಮ
Komatsu	ಕೊಮಾತ್ಸು
Jahdamah	ಜಾದ್ಮಾ
Lunglei	ಲುಂಗ್ಲೈ
Shelby	ಶೆಲ್ಬಿ
Raajesh	ರಾಜೇಶ್
Mendelevium	ಮೆಂಡಿಲೇವಿಯಂ
Las	ಲಾಸ್
Vegas	ವೇಗಸ್
Katak	ಕಟಕ್
Optimal	ಆಪ್ಟಿಮಲ್
Group	ಗ್ರೂಪ್
Door	ದೂರ್
Wadiyon	ವಾದಿಯೋ
Mein	ಮೇ
Kahin	ಕಹೀ
Kular	ಕುಲಾರ್
Pontiac's	ಪಾಂಟಕ್ಸ್
Rebellion	ರಿಬೆಲಿಯನ್
Clifford	ಕ್ಲಿಫರ್ಡ್
Aruna	ಅರುಣ
Gunawardene	ಗುಣವರ್ಧನೆ
Mitesh	ಮಿತೇಶ್
Kozhikode	ಕೋಯಿಕ್ಕೋಡ್
Courtney	ಕೋರ್ಟ್ನಿ
Browne	ಬ್ರೌನ್
Lita	ಲಿತಾ
Himachal	ಹಿಮಾಚಲ
Pradesh	ಪ್ರದೇಶ
Modesto	ಮಾಡೆಸ್ಟೋ
Panetti	ಪೆನೆಟ್ಟಿ
Prize	ಪ್ರೈಜ್
Saoirse	ಸೇಯರ್ಸ್
Anastasia	ಅನಸ್ತಾಸಿಯಾ
Minakshi	ಮೀನಾಕ್ಷಿ
Sundareshvara	ಸುಂದರೇಶ್ವರ
Colombo	ಕೊಲಂಬೊ
Jim	ಜಿಮ್
Stewart	ಸ್ಟೀವಾರ್ಟ್
Talwada	ತಲವಾಡಾ
Kumar	ಕುಮಾರ್
Saamy	ಸಾಮಿ
Gumtala	ಗುಮಟಾಲಾ
Kathua	ಕಥುವಾ
Lajwanti	ಲಾಜವಂತಿ
Adesh	ಆದೇಶ್
Mahendra	ಮಹೇಂದ್ರ
Nagamootoo	ನಂಗಮೂಟೂ
Gurudwara	ಗುರುದ್ವಾರ
Gaoo	ಗಾವೋ
Ghat	ಘಾಟ್
Severino	ಸೆವೆರಿನೊ
Madivan	ಮಾದಿವನ್
Aparados	ಅಪಾರಡೊಸ್
da	ಡಾ
Serra	ಸೆರಾ
Narsi	ನಾರಸೀ
Bhagat	ಭಗತ್
AudioCodes	ಆಡಿಯೋಕೋಡ್ಸ್
Pilibhit	ಪಿಲಿಬಿಟ್
Deepan	ದೀಪನ್
Gurudwara	ಗುರುದ್ವಾರ
Santokhsar	ಸಂತೋಖ್‌ಸರ್
Khubsurat	ಖೂಬಸೂರತ್
Duniya	ದುನಿಯಾ
Raahi	ರಾಹಿ
Badal	ಬದಲ್
Gaye	ಗಯೆ
Abdul	ಅಬ್ದುಲ್
maalik	ಮಾಲಿಕ್
Depalsar	ದೆಫಲಸರ್
Deutscher	ಡ್ಯೂಟ್ಸ್‌ಚೆರ್
Spiele	ಸ್ಪೈಲ್
Preis	ಪ್ರೆಯಿಸ್
Lecea	ಲೆಸಿಯಾ
Ameer	ಅಮೀರ್
Admi	ಆದ್ಮಿ
Garib	ಗರೀಬ್
Admi	ಆದ್ಮಿ
Banseelaal	ಬನ್ಸೀಲಾಲ್
Parinda	ಪರಿಂದಾ
Kaalkunja	ಕಾಲಕುಂಜ
Nirali	ನಿರಾಲೀ
Duniya	ದುನಿಯಾ
Curtin	ಕರ್ಟಿನ್
University	ಯುನಿವರ್ಸಿಟಿ
Shyam	ಶ್ಯಾಮ್
Telecom	ಟೆಲಿಕಾಮ್
Farishta	ಫರಿಶ್ತಾ
Ya	ಯಾ
Qatil	ಕಾತಿಲ್
Drupad	ದ್ರುಪದ್
Abdul	ಅಬ್ದುಲ್
khaaliq	ಖಾಲಿಕ್
Atre	ಅತ್ರೆ
Chalala	ಛಲಾಲಾ
Abodh	ಅಬೋಧ್
Allendale	ಅಲೆಂಡಾಲಿ
Ellesmere	ಎಲೆಸಮೆರಿ
Kumar	ಕುಮಾರ
Dharmasena	ಧರ್ಮಸೇನ
Thanedaar	ಥಾನೆದಾರ್
Chris	ಕ್ರಿಸ್
Smith	ಸ್ಮಿತ್
Rumesh	ರುಮೇಶ್
Ratnayake	ರತ್ನಾಯಕೆ
Perry	ಪೆರಿ
Ek	ಏಕ್
Chitthi	ಚಿಟ್ಠಿ
Pyar	ಪ್ಯಾರ್
Bhari	ಭರೀ
Landers	ಲಾಂಡ್ರೆಸ್
Ghanashyaam	ಘನಶ್ಯಾಮ್
Cassiar	ಕೆಸೈರ್
Monmouth's	ಮಾನ್‌ಮೌಥ್ಸ್
Rebellion	ರಿಬೆಲಿಯನ್
Ek	ಏಕ್
Saal	ಸಾಲ್
Fort	ಫೋರ್ಟ್
ross	ರೋಸ್
Arafat	ಅರಾಫತ್
Ashapurna	ಆಶಾಪೂರ್ಣ
Devi	ದೇವಿ
Shabnam	ಶಬನಮ್
Gudakesha	ಗುಡಾಕೆಶ್
Cira	ಸಿರಾ
Mohabbat	ಮೊಹಬ್ಬತ್
Ke	ಕೆ
Dushman	ದುಶ್ಮನ್
Mohabbat	ಮೊಹಬ್ಬತ್
Aur	ಔರ್
Jung	ಜಂಗ್
Kunal	ಕುನಾಲ್
Ingersoll	ಇಂಗರ್‌ಸೋಲ್
Rand	ರಾಂಡ್
Afafura	ಅಫಾಫುರಾ
Swaminath	ಸ್ವಾಮಿನಾಥ್
Corydon	ಕಾರಿಡಾನ್
Gail	ಗೇಲ್
Sheehy	ಶೀಹಿ
Kakadu	ಕಕಾಡು
Lancers	ಲ್ಯಾಂನ್ಸರ್
Fort	ಫೋರ್ಟ್
lawrence	ಲಾರೆನ್ಸ್
Kala	ಕಾಲಾ
Patthar	ಪತ್ಥರ್
Panthea	ಪಾಂಥಿಯಾ
Raj	ರಾಜ್
Mahal	ಮಹಲ್
Jhansiwale	ಝಾನ್ಸಿವಾಲೆ
Prix	ಪ್ರಿಕ್ಸ್
Decembre	ಡಿಸೆಂಬ್ರೆ
Hamim	ಹಮೀಮ್
Mita	ಮಿತಾ
Forrester	ಫಾರೆಸ್ಟರ್
Ashwatthama	ಅಶ್ವತ್ಥಾಮ
Mubashir	ಮುಬಾಶಿರ್
Bahia	ಬಹಿಯಾ
Sevillanas	ಸೆವಿಲ್ಲಾನಾಸ್
REEDSPORT	ರೀಡ್‌ಸ್ಪೋರ್ಟ್
CHRISTIAN	ಕ್ರಿಶ್ಚಿಯನ್
Faqirah	ಫಕೀರಾಹ್
Varthamanam	ವರ್ತಮಾನಮ್
Lady	ಲೇಡಿ
Godiva	ಗೋಡಿವಾ
Sharon	ಶರೋನ್
Stone	ಸ್ಟೋನ್
Summayyah	ಸುಮಯ್ಯಾ
Laxman	ಲಕ್ಷ್ಮಣ
Sivaramakrishnan	ಶಿವರಾಮಕೃಷ್ಣ
Ehsanul	ಎಹಸಾನುಲ್
Haque	ಹಕ್
Taurus	ಟಾರಸ್
Dore	ಡೊರಿ
Mudrikaa	ಮುದ್ರಿಕಾ
Monty	ಮಾಂಟಿ
Raigarh	ರಾಯಗರ್
Meri	ಮೇರಿ
Bhabhi	ಭಾಭಿ
Izhar	ಇಜಾರ್
Ian	ಇಯಾನ್
Blackwell	ಬ್ಲಾಕ್‌ವೆಲ್
Helsinki	ಹೆಲ್ಸಿಂಕಿ
Peter	ಪೀಟರ್
Martin	ಮಾರ್ಟಿನ್
Robin	ರಾಬಿನ್
Uthappa	ಉತ್ತಪ್ಪ
Ahzab	ಅಹ್ಜಾಬ್
Bihar	ಬಿಹಾರ್
Sharif	ಶರೀಫ್
Intercontinental	ಇಂಟರ್‌ಕಾಂಟಿನೆಂಟಲ್
Cup	ಕಪ್
Anainaduvu	ಅನೈನಡುವು
Reservoir	ರಿಜರ್ವಾಯರ್
Bheempura	ಭೀಮಾಪುರ
Shirlyn	ಶಿರ್ಲ್ಯಾನ್
Fort	ಫೋರ್ಟ್
gilkicker	ಗಿಲ್‌ಕಿಕರ್
Linus	ಲಿನಸ್
Samosir	ಸಮೊಸಿರ್
Bade	ಬಡೇ
Ghar	ಘರ್
Ki	ಕಿ
Beti	ಬೇಟಿ
Habibul	ಹಬೀಬುಲ್
Bashar	ಬಶರ್
Ek	ಏಕ್
Tha	ಥಾ
Raja	ರಾಜಾ
Kabuliwala	ಕಾಬುಲಿವಾಲಾ
Spencer	ಸ್ಪೆನ್ಸರ್
Museum	ಮ್ಯೂಸಿಯಂ
of	ಆಫ್
Arts	ಆರ್ಟ್ಸ್
Newcastle	ನ್ಯೂಕ್ಯಾಸಲ್
University	ಯುನಿವರ್ಸಿಟಿ
University	ಯುನಿವರ್ಸಿಟಿ
of	ಆಫ್
Glamorgan	ಗ್ಲಾಮರ್ಗನ್
Dil	ದಿಲ್
Ka	ಕಾ
Dada	ದಾದಾ
Vishal	ವಿಶಾಲ್
Aasman	ಆಸಮಾನ್
Se	ಸೆ
Gira	ಗಿರಾ
Archit	ಅರ್ಚಿತ್
Azaadeh	ಆಜಾದೇ
Frederick	ಫ್ರೆಡ್ರಿಕ್
Funston	ಫನ್‌ಸ್ಟನ್
Bilva	ಬಿಲ್ವಾ
Khot	ಖೋತ್
Atharvan	ಅಥರ್ವಣ್
Jazbaat	ಜಜ್‌ಬಾತ್
Dhindsa	ಧಿಂಡ್ಸಾ
Reshmi	ರೇಶಮೀ
Sari	ಸಾಡಿ
Laurens	ಲಾರೆನ್ಸ್
Yashoraj	ಯಶೋರಾಜ್
Gamma	ಗಾಮಾ
Christy	ಕ್ಲಿಸ್ಟೀ
Hefner	ಹೆಫ್ನರ್
Kelvingrove	ಕೆಲ್ವಿಂಗ್ರೋವ್
Art	ಆರ್ಟ್
Gallery	ಗ್ಯಾಲರಿ
and	ಅಂಡ್
Museum	ಮ್ಯೂಸಿಯಂ
Anandtandavpur	ಆನಂದ್‌ತಂಡಾವಪುರ್
Wajihah	ವಜೀಹ
Kardawiyah	ಕರ್ದವಿಯಾ
Medal	ಮೆಡಲ್
of	ಆಫ್
Suvorov	ಸುವೊರೊವ್
Organ	ಒರ್ಗಾನ್
Vrandaavaneshvaree	ವೃಂದಾವನೇಶ್ವರಿ
Yousuf	ಯೂಸುಫ್
Youhana	ಯೋಹಾನಾ
Gurjit	ಗುರಜಿತ್
Jason	ಜೇಸನ್
Raagini	ರಾಗಿನಿ
Bristol	ಬ್ರಿಸ್ಟಲ್
Channel	ಚಾನಲ್
Lawrence	ಲಾರೆನ್ಸ್
Abdus	ಅಬ್ದುಸ್
shakur	ಶಕೂರ್
Hamara	ಹಮಾರಾ
Haj	ಹಜ್
Fort	ಫೋರ್ಟ್
mcnab	ಮ್ಯಾಕ್‌ನಬ್
Yahan	ಯಹಾ
Wahan	ವಹಾ
Pingale	ಪಿಂಗಾಲೆ
Wreck	ರೆಕ್
Deere	ಡೀರಿ
Atari	ಅತಾರಿ
Pingala	ಪಿಂಗಳ
Aacharyasuta	ಆಚಾರ್ಯಸುತ
Indushekhar	ಇಂದುಶೇಖರ್
Ogle	ಓಗ್ಲೆ
Order	ಆರ್ಡರ್
of	ಆಫ್
Honour	ಆನರ್
Greg	ಗ್ರೆಗ್
Ritchie	ರಿಚಿ
Gemplus	ಜೆಮ್‌ಪ್ಲಸ್
International	ಇಂಟರ್ನ್ಯಾಷನಲ್
Teledata	ಟೆಲಿಡೇಟಾ
Shams-ul-haq	ಶಮ್ಸ್-ಉಲ್-ಹಕ್
Chiraag	ಚಿರಾಗ್
Kahan	ಕಹಾ
Roshni	ರೋಶನಿ
Kahan	ಕಹಾ
Arav	ಆರವ್
Ghag	ಘಾಗ್
Emirates	ಎಮಿರೇಟ್ಸ್
tower	ಟವರ್
Two	ಟು
Dungar	ದುಂಗರ್
Junction	ಜಂಕ್ಷನ್
Narragansett	ನರಾಗನ್ಸೆಟ್
Bangalore	ಬೆಂಗಳೂರು
Cantonment	ಕಂಟೋನ್ಮೆಂಟ್
Kamla	ಕಮಲಾ
Ede	ಎಡಿ
Weymark	ವೇಮಾರ್ಕ್
Erzherzog	ಎಜರ್‌ಜೋಗ್
Friedrich	ಫ್ರೆಡ್ರಿಚ್
Badrudin	ಬದ್ರುದ್ದಿನ್
Klarika	ಕ್ಲಾರಿಕಾ
Devarsi	ದೇವರ್ಶೀ
Marconi	ಮಾರ್ಕೊನಿ
Prize	ಪ್ರೈಜ್
Lalitpur	ಲಲಿತಪುರ್
Chamba	ಚಂಬಾ
Beete	ಬೀತೆ
Din	ದಿನ್
Padmapati	ಪದ್ಮಪತಿ
Tierney	ಟಿಯರ್ನಿ
Saambhi	ಸಾಂಭೀ
Saath	ಸಾತ್
Saath	ಸಾತ್
Naveena	ನವೀನಾ
Pandit	ಪಂಡಿತ್
Aur	ಔರ್
Pathan	ಪಠಾನ್
Valterra	ವೆಲ್ಟೆರಾ
Damien	ಡಾಮಿಯನ್
Martyn	ಮಾರ್ಟಿನ್
Sawan	ಸಾವನ್
Aya	ಆಯಾ
Re	ರೆ
Ajwaad	ಅಜ್ವಾಡ್
Paras	ಪರಸ್
Mhambrey	ಮಹಂಬ್ರೆ
Poushali	ಪೌಶಾಲಿ
Chandrashekhar	ಚಂದ್ರಶೇಖರ
Rafting	ರಾಫ್ಟಿಂಗ್
Abdur	ಅಬ್ದುರ್
rauf	ರವೂಫ್
Vivek	ವಿವೇಕ್
Razdan	ರಜದಾನ್
Amogh	ಅಮೋಘ
Chittesh	ಚಿತ್ತೇಶ್
Masters	ಮಾಸ್ಟರ್ಸ್
Ajeeb	ಅಜೀಬ್
Ittefaq	ಇತ್ತೆಫಾಕ್
Alibaug	ಅಲಿಬಾಗ್
fort	ಫೋರ್ಟ್
Chandanika	ಚಾಂದನಿಕಾ
Bazar	ಬಾಜಾರ್
Band	ಬಂದ್
Karo	ಕರೋ
Leader	ಲೀಡರ್
Bhale	ಭಾಲೆ
Lal	ಲಾಲ್
Pari	ಪರಿ
Zulfa	ಜುಲ್ಫಾ
Shambhu	ಶಂಭೂ
Albela	ಅಲ್ಬೇಲಾ
Brisbon	ಬ್ರಿಸ್ಬನ್
Fort	ಫೋರ್ಟ್
halifax	ಹ್ಯಾಲಿಫ್ಯಾಕ್ಸ್
Carnatic	ಕಾರ್ನಾಟಿಕ್
War	ವಾರ್
Ahsan	ಅಹ್ಸಾನ್
Prithviraj	ಪೃಥ್ವಿರಾಜ್
Sayogita	ಸಯೋಗಿತಾ
Samasya	ಸಮಸ್ಯಾ
Thar	ಥಾರ್
Rakhi	ರಾಖೀ
Catholic	ಕೆಥೋಲಿಕ್
Syrian	ಸಿರಿಯನ್
Bank	ಬ್ಯಾಂಕ್
Gypsy	ಜಿಪ್ಸೀ
Flying	ಫ್ಲೈಯಿಂಗ್
Circus	ಸರ್ಕಸ್
Amagi	ಅಮಾಗಿ
Ben	ಬೆನ್
Aucre	ಔಕ್ರೀ
Major	ಮೇಜರ್
League	ಲೀಗ್
Lacrosse	ಲಾಕ್ರೊಸ್
Coach	ಕೋಚ್
of	ಆಫ್
the	ದ
Year	ಈಯರ್
Award	ಅವಾರ್ಡ್
Briscoe	ಬ್ರಿಸ್ಕೊ
Chaitan	ಚೈತನ್
Bahadur	ಬಹಾದೂರ್
Pratap	ಪ್ರತಾಪ್
Asif	ಆಸಿಫ್
Mujtaba	ಮುಜ್ತಬಾ
Baazi	ಬಾಜೀ
Naag	ನಾಗ್
Panchami	ಪಂಚಮಿ
William	ವಿಲಿಯಂ
nagar	ನಗರ್
National	ನ್ಯಾಶನಲ್
Palace	ಪ್ಯಾಲೇಸ್
Museum	ಮ್ಯೂಸಿಯಂ
Pfizer	ಫಿಜರ್
Paramjeet	ಪರಮಜೀತ್
Shaheed-E-Azam	ಶಹೀದ್-ಎ-ಆಜಮ್
Bhagat	ಭಗತ್
Singh	ಸಿಂಗ್
Port	ಪೋರ್ಟ್
Elizabeth	ಎಲಿಜಬೆತ್
Gumthal	ಗುಮಥಲ್
Keith	ಕೀತ್
Kabhi	ಕಭೀ
Ajnabi	ಅಜನಬಿ
The	ಥಿ
Bhat	ಭಟ್
Gahiree	ಗಹಿರಿ
Bhagwantroop	ಭಗವಂತ್‌ರೂಪ
Akalmand	ಅಕಲ್ಮಂದ್
Ikabaal	ಇಕಬಾಲ್
Rocket	ರಾಕೆಟ್
Girl	ಗರ್ಲ್
Medal	ಮೆಡಲ್
of	ಆಫ್
Heroism,	ಹೀರೋಯಿಸಮ್,
Military	ಮಿಲಿಟರಿ
Rajmahal	ರಾಜ್‌ಮಹಲ್
Insaaf	ಇನ್ಸಾಫ್
Ki	ಕಿ
Jung	ಜಂಗ್
Larissa	ಲಾರಿಸ್ಸಾ
Thalia	ಥಾಲಿಯಾ
Aachaarynandanaa	ಆಚಾರ್ಯನಂದನಾ
Raakh	ರಾಖ್
Queen	ಕ್ವೀನ್
Victoria	ವಿಕ್ಟೋರಿಯಾ
Redoute	ರೆಡೌಟ್
de	ಡಿ
tallaert	ಟಲಾರ್ಟ್
Bajaj	ಬಜಾಜ್
Hindustan	ಹಿಂದೂಸ್ತಾನ್
Lakshmidhar	ಲಕ್ಷ್ಮಿಧರ್
Vuntut	ವುನ್‌ಟುಟ್
Juliette	ಚೂಲಿಯಟ್
Binoche	ಬಿನೋಕ್
Kilakilaa	ಕಿಲಾಕಿಲ
Leighton	ಲಿಗಟನ್
Rane	ರಾಣೆ
Brake	ಬ್ರೇಕ್
Nicosia	ನಿಕೋಸಿಯಾ
Vidisha	ವಿದಿಶಾ
Liverpool	ಲಿವರ್‌ಪೂಲ್
Community	ಕಮ್ಯುನಿಟಿ
Surjot	ಸುರ್ಜೋತ್
Gandak	ಗಂದಕ್
Aakhri	ಆಖಿರೀ
Ghulam	ಗುಲಾಮ್
University	ಯುನಿವರ್ಸಿಟಿ
of	ಆಫ್
Huddersfield	ಹಡರ್ಸ್‌ಫೀಲ್ಡ್
Nazeefah	ನಜೀಫಾ
Aap	ಆಪ್
Ki	ಕಿ
Maarzi	ಮರ್ಝೀ
Winfield	ವಿನ್‌ಫೀಲ್ಡ್
Dimaia	ಡಿಮಾಯ್
Mingan	ಮಿಂಗನ್
Archipelago	ಆರ್ಕಿಪಿಲಾಗೊ
Shubhada	ಶುಭದಾ
Ghoradongri	ಘೋರಡೋಂಗ್ರಿ
Dhondi	ಧೋಂಡಿ
Hessen	ಹೆಸ್ಸನ್
Ahwas	ಅಹ್ವಾಸ್
Sej	ಸೆಜ್
Piya	ಪಿಯಾ
Ki	ಕಿ
Jhabua	ಜಬುವಾ
Terra	ಟೆರ್ರಾ
Nova	ನೋವಾ
Bhadkamkar	ಭಡಕಾಮ್ಕರ್
Kellyn	ಕೆಲ್ಲಿನ್
Basabi	ಬಾಸಬಿ
Puskara	ಪುಷ್ಕರ
Shrimat	ಶ್ರೀಮತ್
Kansas	ಕನ್ಸಾಸ್
Kalaa	ಕಲಾ
Paramesh	ಪರಮೇಶ
Yograj	ಯೋಗರಾಜ್
Singh	ಸಿಂಗ್
Ravinandan	ರವಿನಂದನ್
Rupee	ರುಪೀ
Gaurika	ಗೌರಿಕಾ
Adhokshaj	ಅಧೋಕ್ಷಜ
Barbados	ಬಾರ್ಬಡೋಸ್
Medera	ಮೆಡೇರಾ
Sandesh	ಸಂದೇಶ್
Disco	ಡಿಸ್ಕೊ
Dancer	ಡ್ಯಾನ್ಸರ್
Prabhat	ಪ್ರಭಾತ್
khabar	ಖಬರ್
Dawlah	ದೌಲಾ
Zahirah	ಜಹೀರಾ
Goodlass	ಗುಡ್‌ಲ್ಯಾಸ್
Nerolac	ನೆರೋಲ್ಯಾಕ್
Dullewal	ದುಲ್ಲೆವಾಲ್
Prabhas	ಪ್ರಭಾಸ್
