Hajgiri	ஹாஜ்கிரி
Helgoland	ஹெல்கோலாண்ட்
Chekov	செகாவ்
Spingarn	ஸ்பின்கார்ன்
Medal	மெடல்
Basere	பசேரே
Ki	கி
Hoor	ஹூர்
Rugby	ரக்பி
Shirin	ஷிரின்
Tridev	டிரைதேவ்
Ackland	ஆக்லாண்ட்
Art	ஆர்ட்
Museum	மியூஸியம்
Kamalesh	கமலேஷ்
Essam	எஸ்ஸாம்
Sidney	சிட்னி
Ekachakra	எகாசக்ரா
Cleavant	கிளீவண்ட்
Madihah	மதிஹா
Tibor	திபோர்
Banno	பன்னோ
Aaditya	ஆதித்யா
Ahlam	அஹ்லாம்
Wilton	வில்டன்
Gurudwara	குருத்வாரா
Betma	பேட்மா
Sahib	சாஹிப்
Kolhapur	கொல்ஹாபூர்
Tarzan	டார்ஸன்
And	அண்ட்
Cobra	கோப்ரா
Raahi	ராஹி
Agori	அகோரி
Khas	காஸ்
Fort	ஃப்போர்ட்
vancouver	வான்காவர்
Virginia	வெரிஜீனியா
reel	ரீல்
Maati	மாட்டி
Maange	மாங்கெ
Khoon	கூன்
Pannalal	பன்னாலால்
Ghosh	கோஷ்
Chameli	சமேலி
Memsaab	மேம்சாப்
Dick	டிக்
Bucharest	புகரெஸ்ட்
Aoife	ஐஓஃப்
Bull	புல்
riding	ரைடிங்
Meijer	மெய்ஜர்
Thayer	தயேர்
Kaun	கோன்
Hai	ஹை
Woh	வோ
Suhaymah	சுஹைமா
Tony	டோனி
Aakhri	ஆக்ரி
Adalat	அதாலத்
Jaisal	ஜேய்சல்
Mere	மேரெ
Humsafar	ஹம்சாஃப்பர்
Pyar	பியார்
Ki	கி
Baazi	பாஸி
Kanak	கனக்
Mohammad	மொஹம்மத்
Abul	அபுல்
Kalam	கலாம்
Azad	ஆசாத்
Bundesverdienstkreuz	புண்டஸ்வெர்டீன்ஸ்ட்க்ரூஸ்
Anatomy	அனாடாமி
Gemplus	கெம்பிளஸ்
International	இன்டர்நெஷனல்
Santa	சான்டா
Susana	சூசன்னா
Esmak	அஸ்மாக்
Baton	பதோன்
Baton	பதோன்
Mein	மெயின்
Hamari	ஹமாரி
Kismat	கிஸ்மத்
Bindki	பிண்ட்கி
Road	ரோட்
CavinKare	கெவின் கேர்
Ghaare	காரே
Perin	பெரின்
over	ஓவர்
Mevaaraam	மேவாராம்
Gwinett's	க்வினெட்ஸ்
Family	பேமிலி
Madura	மதுரா
Garments	கர்மெண்ட்ஸ்
University	யூனிவர்சிட்டி
of	ஆஃப்
Dundee	டுண்டீ
Vishvaroop	விஷ்வரூப்
Mark	மார்க்
Butcher	பட்சர்
Natesh	நடேஷ்
Prahlaad	பிரஹலாத்
Raghu	ரகு
Muraina	முரைனா
Shikarpuri	ஷிகார்புரி
Bajarangabalee	பஜ்ரங்பாலி
Mahadev	மஹாதேவ்
Verma	வர்மா
Gudivada	குடிவாடா
Junction	ஜங்ஷன்
Abqurah	அப்குரா
Susie	சுஸி
Bishmillah	பிஸ்மில்லா
Ki	கி
Barkat	பர்கத்
Adair	அடைய்ர்
Douglas	டக்ளஸ்
Hondo	ஹோண்டோ
Antarnaad	அந்தர்நாத்
Valley	வேலி
Forge	ஃப்பார்ஜ்
Sevier	செவியர்
Marianne	மரியேன்
Williamson	வில்லியம்சன்
Walt	வால்ட்
Disney	டிஸ்னி
Belgium	பெல்ஜியம்
Gerry	ஜெரி
Charles	சார்லஸ்
Coventry	கொவெண்ட்ரி
Dulip	துலீப்
Liyanage	லியனாகே
Hencoate	ஹென்கோயாட்
Balaveer	பலவீர்
Jagat	ஜகத்
Mohini	மோகினி
Akhand	அகந்த்
Saubhagyawati	சௌபாக்யவதி
Pinquillo	பின்குயில்லோ
Abdul	அப்துல்
zaleel	ஸாலீல்
Order	ஆர்டர்
of	ஆஃப்
Christ	க்றைஸ்ட்
Khoums	கௌம்ஸ்
Basimah	பஸீமா
Raffaello	ரஃபேலோ
Protactinium	பிரோடாக்டினியம்
Achintya	அச்சின்டியா
Amaanat	அமாநாத்
Nityapriya	நித்யப்ரியா
Debashish	டெபாஷிஷ்
National	நேஷனல்
Museum	மியூஸியம்
of	ஆஃப்
Taiwanese	தாய்வானீஸ்
Literature	லிட்டரெச்சர்
The	த
Doon	டூன்
School,	ஸ்கூல்,
Dehradun	டெஹ்ராடூன்
Kaushik	கெளஷிக்
Mark	மார்க்
Richardson	ரிச்சட்சன்
Fatehnagar	ஃபதேஹ்நகர்
Ghazalan	கஜாலன்
Asiya	அஸியா
Waqt	வக்த்
Ki	கி
Deewar	தீவார்
Zahid	ஜாஹித்
Fazal	ஃபாசல்
Bombay	பாம்பே
Masjid	மஸ்ஜித்
Order	ஆர்டர்
of	ஆஃப்
National	நேஷனல்
Redevelopment	ரீடெவலப்மெண்ட்
Merit	மெரிட்
Preet	ப்ரீத்
Na	நா
Jane	ஜானே
Reet	ரீத்
Gellert	ஜெல்லர்ட்
Venugopal	வேனுகோபால்
Rao	ராவ்
Golden	கோல்டன்
gate	கேட்
San	சான்
Gabriel	கேப்ரியல்
Salif	சலிஃப்
Jhinuk	ஜீனக்
Jody	ஜோடி
Kuntee	குன்ட்டி
Keena	கீணா
Madhuchanda	மதுசந்தா
MetLife	மெட்லைப்
Carioca	காரியோகா
Alif	ஆலிஃப்
Laila	லைலா
Jawab	ஜவாப்
Minarwa	மினர்வா
Matilda	மட்டில்டா
Wahban	வஹ்பன்
Kathleen	கேத்லீன்
Kaviraj	கவிராஜ்
Hans	ஹான்ஸ்
Christian	க்றிஸ்டியன்
Andersen	ஆண்டர்சன்
Award	அவார்ட்
Black	பிளாக்
Kisan	கிஸான்
Aur	அவுர்
Bhagwan	பாக்வான்
Hughes	ஹ்யூக்ஸ்
Medal	மெடல்
Hare	ஹரே
Kanch	கன்ச்
Ki	கி
Churiyan	சுரியான்
Zandra	ஜாண்ட்ரா
Padma	பத்ம
Shri	ஸ்ரீ
Kananbala	கானான்பாலா
Juma'	ஜுமா
Sudrashan	சுதர்ஷன்
University	யூனிவர்சிட்டி
of	ஆஃப்
London	லண்டன்
Marvel	மார்வெல்
Man	மேன்
Danny	டானி
Morrison	மோரிஸன்
Gurudwara	குருத்வாரா
Tibbi	டிப்பி
Sahib	சாஹிப்
Minati	மினாதி
Sant	சன்த்
Tulsidas	துல்சிதாஸ்
Nivriti	நிவ்ரிதி
Ricky	ரிக்கி
Ponting	பாண்டிங்
Rufiyaa	ருஃபியா
Alipur	அலிபூர்
Duar	டுவார்
Hatyara	ஹத்யாரா
Badawi	பதாவி
The	த
Goulandris	கெளலான்டிரிஸ்
Museum	மியூஸியம்
of	ஆஃப்
Natural	நேச்சுரல்
History	ஹிஸ்டரி
Aalingan	ஆலிங்கன்
Lal	லால்
Bangla	பாங்லா
Nithar	நிதார்
Karambelkar	கரம்பெல்கர்
Raghavendra	ராகவேந்திரா
Naatu	நாது
Sun	சன்
Pharma	ஃபார்மா
Terry	டெர்ரி
Duffin	டஃப்பின்
Vidrumalataa	வித்ருமலதா
Nehra	நெஹ்ரா
Express	எக்ஸ்பிரஸ்
Scripts	ஸ்கிரிப்ட்ஸ்
Pico	பீகோ
de	டீ
Tancítaro	டான்சிடாரோ
Rick	ரிக்
Darling	டார்லிங்
Naata	நாதா
Sundram	சுந்தரம்
Albert	ஆல்பர்ட்
Einstein	ஐன்ஸ்டின்
Floriane	ஃப்ளோரியேன்
Hemaraaj	ஹேமராஜ்
Piastres	பயாஸ்டிரெஸ்
International	இன்டர்நெஷனல்
Paper	பேப்பர்
Ashrafi	அஷ்ராஃப்பி
Miya	மியா
Kichocha	கிசோசா
Sharif	ஷாரிஃப்
Jet	ஜெட்
Airways	ஏர்வேஸ்
Gujjar	குஜ்ஜார்
Dharuna	தருணா
Bahamas	பஹாமாஸ்
Hasina	ஹசினா
Maan	மான்
Jayegi	ஜாயேகி
Desiree	டெசிரீ
Naresh	நரேஷ்
Boordhi-Zaffer	பூர்தி-ஸாஃப்பர்
Aansoo	ஆன்சூ
Ban	பன்
Gaye	கயே
Phool	பூல்
Paanch	பான்ச்
Ratan	ராதன்
Wright	ரைட்
Awards	அவார்ட்ஸ்
Kurde	குர்தே
Do	தோ
Ankhen	ஆங்கேன்
Anise	அனிஸ்
Samjhauta	சம்ஜோதா
Vaahid	வாஹித்
Banda	பாண்டா
Junction	ஜங்ஷன்
Robert	ராபர்ட்
Williams	வில்லியம்ஸ்
Franklyn	ஃப்ராங்க்ளின்
Rose	ரோஸ்
Resurrection	ரிசரக்ஷன்
Lutheran	லுதெரன்
Shan	ஷான்
E	இ
Hatim	ஹாதிம்
Vaasavey	வாசவி
Emele	எமிலி
abo	அபோ
Vijendra	விஜேந்திரா
Brooke	புரூக்
Walker	வாக்கர்
Shubhang	ஷுபாங்
Albert	ஆல்பர்ட்
Gore	கோர்
Jack	ஜாக்
Nicholson	நிகோல்சன்
Cody	கோடி
Biraj	பிரஜ்
Bahu	பாஹு
Vrahadeekaran	விராஹதீகரன்
Elita	எலிட்டா
Umapati	உமாபதி
Daniel	டேனியல்
Erasmus	இராஸ்மஸ்
Bates	பேட்ஸ்
Bhubaneswar	புவனேஸ்வர்
McPhail	மெக்பைல்
Bosporus	போஸ்போரஸ்
Tinu	டினு
Yohannan	யோஹன்னன்
Amareek	அமாரீக்
Seedha	சீதா
Raasta	ராஸ்தா
Izzat	இஸ்ஸாத்
Aabroo	ஆப்ரூ
El	எல்
Sabinal	சாபினல்
Thais	தாயிஸ்
Aftab	அஃப்தப்
Ahmed	அஹ்மெத்
Vedikaa	வேதிகா
Gary	கேரி
Brent	ப்ரெண்ட்
Reon	ரியோன்
King	கிங்
Nalayak	நாலாயக்
Awen	அவேன்
Hannan	ஹன்னான்
Sarkar	சர்கார்
Kolina	கோலினா
Indrakarman	இந்திராகர்மன்
University	யூனிவர்சிட்டி
of	ஆஃப்
Portsmouth	போர்ட்ஸ்மௌத்
Arunachaleshwar	அருணாசலேஸ்வர்
Bindiya	பிந்தியா
Meghamala	மேகமாலா
Sarfarosh	சரஃப்பரோஷ்
Sarkari	சர்க்காரி
Mehman	மெஹ்மான்
Pacific	பஸிஃபிக்
Rim	ரிம்
Aduz	அதூஸ்
zahir	ஸாஹிர்
Vinson	வின்சன்
Bhadresh	பத்ரீஷ்
Jimmy	ஜிம்மி
Cook	குக்
Hillcrest	ஹில்கிரேஸ்ட்
Baptist	பேப்டிஸ்ட்
Willie	வில்லி
Watson	வாட்சன்
Vishvaatmaa	விஷ்வாத்மா
Nathdwara	நத்வாரா
Temple	டெம்பிள்
Ciara	சியார்ரா
Jahura	ஜாஹூரா
Khara	கர
Khota	கோதா
Katelynn	கேட்லின்
Pearlie	பேர்லி
Gramophone	கிராமஃபோன்
Singer	சிங்கர்
Brucklay	பிரக்லே
Cutter	கட்டர்
Ganagapur	கனகாபூர்
Road	ரோட்
Pujari	பூஜாரி
Suvarchalaa	சுவர்ச்சலா
Easter	ஈஸ்டர்
Shukti	ஷுக்தி
Philana	ஃபிலானா
Aerona	ஏரோனா
Amani	அமானி
Rio	ரியோ
Negro	நீக்ரோ
Afeef	அஃபீஃப்
Baidehi	பைதேஹி
Prasanna	பிரசன்னா
Addis	அதிஸ்
Ababa	அபேப
Stuart	ஸ்டூவர்ட்
Williams	வில்லியம்ஸ்
Bhadrachalam	பத்ராசலம்
Kalelkar	கலேகர்
Aojla	ஓஜ்லா
Groupe	குரூப்
Caisse	கைசே
Dépargme	டீபார்க்மே
Amu	அமு
Darya	தார்யா
Fort	ஃப்போர்ட்
san	சான்
felipe	ஃப்பெலிப்
del	டெல்
morro	மோரோ
Gardenia	கார்ட்னீயா
Funtoosh	ஃபன்டூஷ்
Saeed	சயீத்
Azad	ஆசாத்
Averoff	அவெராஃப்
Gallery	கேலரி
Steve	ஸ்டீவ்
Wonder	ஓண்டர்
Nazar	நஸார்
Ka	கா
Shikar	ஷிகார்
Graeme	கிரேமெ
Beard	பியர்ட்
Caterpillar	கேட்டர்பில்லர்
Shriram	ஸ்ரீராம்
TransFi	ட்ரான்ஸ்ஃபி
Boomps-a-daisy	பூம்ப்ஸ்-ஆ-டெய்ஸி
Amravati	அமராவதி
TOP	டாப்
Tankers	டேங்கர்ஸ்
Shumaysah	ஷுமைஷா
Dabholkar	தபோல்கர்
Beesvi	பீஸ்வி
Sadi	சாதி
Pulastya	புலாஸ்தயா
Balee	பாலீ
Welspun	வெல்ஸ்பன்
Guj	குஜ்
Malik	மலிக்
Kaalaj	காலாஜ்
Bruce	ப்ரூஸ்
Medal	மெடல்
Jareer	ஜரீர்
Elsass	எல்சாஸ்
Chizarira	சிஜாரிரா
Dermatology	டெர்மெட்டாலஜி
Chakra	சக்ரா
Sarhaddi	சர்ஹாதி
Chakia	சக்கியா
Teesta	தீஸ்தா
Firozpur	ஃபிரோஸ்பூர்
City	சிட்டி
Jimuta	ஜிமுதா
Nisal	நிசால்
Fernando	ஃபெர்னாண்டோ
Quitaiplas	க்விடாய்ப்லாஸ்
Ginata	ஜீனாதா
Galena	கலேனா
Narayani	நாராயணி
Sanjh	சன்ஜ்
Ki	கி
Bela	பேலா
Sean	சீன்
Pan	பான்
Nikita	நிகிதா
Khrushchev	க்ருஷேவ்
Elisa	எலிஸா
Amit	அமித்
Mishra	மிஷரா
Kurt	கர்ட்
Wilkinson	வில்கின்சன்
Zahed	ஸாஹெத்
Gilani	கிலானி
Abhinanda	அபினான்தா
Manik	மாணிக்
Shahida	ஷாஹிதா
Bari	பாரி
Brahman	ப்ராஹ்மன்
Ganadhyaksha	கானாத்யாக்ஷா
Museum	மியூஸியம்
of	ஆஃப்
Makpo	மாக்போ
University	யூனிவர்ஸிட்டி
Safiyy	சஃபிய்
Barabanki	பராபங்கி
Baheej	பஹீஜ்
Somnath	சோம்நாத்
Jyotirlinga	ஜோதிர்லிங்க
Bishani	பிஷானி
Danzon	டான்ஸன்
Jamnagar	ஜம்நகர்
Meri	மேரி
Izzat	இஸ்ஸாத்
Bachao	பச்சாஓ
Namak	நமக்
Haram	ஹராம்
Maldives	மால்டீவ்ஸ்
Absaroka	அப்சரோகோ
Olsen	ஓல்சென்
Absi	அப்ஸி
Amalsad	அமல்சாத்
Pushpita	புஷ்பிதா
Delhi	டெல்ஹி
Public	பப்ளிக்
School	ஸ்கூல்
Indirapuram	இந்திரபுரம்
Percell	பெர்செல்
Mohammad	மொஹம்மத்
Ashraful	அஷ்ராஃப்புல்
Chiraagh	சிராக்
Jo	ஜோ
Huwa	ஹுவா
So	சோ
Bhool	பூல்
Ja	ஜா
Mashhud	மஷூத்
Jhanjhar	ஜஞ்சார்
Mount	மவுண்ட்
Olympus	ஒலிம்பஸ்
Jadui	ஜாடுய்
Angoothi	அங்கூதி
Freed	ஃப்ரீட்
Sitara	சிதாரா
Tabalah	தபலா
El-marees	எல்-மாரீஸ்
Abdul	அப்துல்
rabb	ராப்
Vakil	வாகில்
Babu	பாபு
Martin	மார்ட்டின்
Kent	கென்ட்
Tymon	டைமன்
Sukriti	சுக்ரிதி
Shumaylah	ஷுமைலா
Robert	ராபர்ட்
Anderson	ஆன்டர்சன்
Naples	நேப்பல்ஸ்
Videocon	வீடியோகான்
American	அமெரிக்கன்
Intl	இன்டல்
Group	குரூப்
Patrick	பேட்ரிக்
Stewart	ஸ்டூவர்ட்
Nanowalia	நானோவாலியா
Baharia	பஹாரியா
Levana	லெவனா
Ullas	ஊல்லாஸ்
Nevina	நெவினா
Yamashiro	யாமாஷிரோ
Maru	மாரு
Jamuna	ஜமுனா
Fort	ஃப்போர்ட்
ord	ஆர்ட்
Nippon	நிப்பான்
Mining	மைனிங்
Holdings	ஹோல்டிங்ஸ்
Zamrud	ஜம்ருத்
Kumudini	குமுதினி
Millimes	மில்லிமெஸ்
Ridley	ரிட்லி
Jacobs	ஜேக்கப்ஸ்
Atahar	அதாஹார்
Motocross	மோட்டோக்ராஸ்
Champa	சம்பா
Kali	காளி
Jubilant	ஜுபிலண்ட்
Brendon	ப்ரெண்டன்
Kuruppu	குருப்பு
Ek	ஏக்
Naav	நாவ்
Kinare	கினாரே
Do	தோ
Srivilliputtur	ஸ்ரீவில்லிபுத்தூர்
Uttar	உத்தர்
Dakshin	தக்ஷின்
Celebration	செலிபிரேஷன்
Community	கம்யுனிட்டி
Jack	ஜாக்
Benny	பென்னி
Silver	சில்வர்
Standard	ஸ்டான்டர்ட்
Resources	ரிசோசர்ஸ்
Jabir	ஜபீர்
Glen	கிளென்
Chapple	சாப்பிள்
Angulimal	அங்குலிமல்
Jovita	ஜோவிதா
Yogee^dr	யோகீதர்
Badel	பாதல்
Camilla	காமில்லா
Baden	பாடென்
Auraiya	ஒளரையா
Kannauj	கனவ்ஜ்
Elroy	எல்ராய்
Indianapolis	இன்டியானாபோலிஸ்
Kolhatkar	கொல்ஹத்கர்
Vishven_dr	விஷ்வேந்தர்
Pyase	பியாஸெ
Panchhi	பன்ச்சி
Teva	டெவா
Pharmaceutical	பார்மாசெட்டிக்கல்
Industries	இண்டஸ்டிரீஸ்
Limited	லிமிடெட்
Raleigh	ராலெய்க்
Eshwar	இஷ்வர்
Rakeeb	ரகீப்
Bukit	புகித்
Tiga	டீகா
Puluh	புலு
Shajee'ah	ஷாஜீயா
Aslana	அஸ்லானா
Adityaa	அதித்யா
Imtihal	இம்டிஹால்
Albert	ஆல்பெர்ட்
Pinto	பின்டோ
Ko	கோ
Gussa	குஸ்ஸா
Kyon	கியோன்
Ata	அதா
Hai	ஹை
Deven_dr	தேவேந்தர்
Honeywell	ஹனிவெல்
Darlita	டார்லிதா
Shrinath	ஸ்ரீநாத்
Dharma	தர்மா
Mosquitos	மஸ்கிடோஸ்
Shahi	ஷாஹி
Farman	ஃப்பர்மான்
Hanover	ஹானோவர்
Shree	ஸ்ரீ
Krishna	கிருஷ்னா
Leela	லீலா
Vaaknis	வாக்னிஸ்
Kaziranga	காஜிரங்கா
Janan	ஜேனன்
Deepak	தீபக்
Chopra	சோப்ரா
Janak	ஜனக்
Tom	டாம்
Riz	ரிஸ்
Dainik	டைனிக்
agradoot	அக்ராதூத்
Mera	மேரா
Qasoor	கஸூர்
Kya	கியா
Hai	ஹை
Vishwendra	விஷ்வேந்திரா
Parni	பர்ணி
Franklin	ஃப்பிரான்க்லின்
D.	டி.
Roosevelt	ரூஸெவெல்ட்
Open	ஓபன்
Door	டோர்
Baptist	பேப்டிஸ்ட்
Vinothen	வினோதன்
John	ஜான்
Vair	வெயிர்
Two	டு
Prudential	புருடென்ஷியல்
Plaza	பிளாஸா
John	ஜான்
Lanen	லேனன்
Nirjharee	நிர்ஜரீ
Prajavani	பிரஜாவானி
Valeria	வலேரியா
Hashim	ஹஷிம்
Puri	பூரி
Grayson	கிரேஸன்
Buhayyah	புஹாய்யா
Hanuman	ஹனுமன்
Janm	ஜன்ம்
Descartes	டெஸ்காட்ஸ்
Systems	ஸிஸ்டெம்ஸ்
Group	குரூப்
Gaon	காவோன்
Hamara	ஹமாரா
Shehar	ஷெஹர்
Tumhara	துமாரா
Sharla	ஷர்லா
Sharma	சர்மா
Badriprasad	பத்ரிபிரசாத்
Ramu	ராமு
Dada	தாதா
Arva	அர்வா
Dharam	தரம்
Veer	வீர்
Baat	பாத்
Ek	ஏக்
Raat	ராத்
Ke	கே
Saujan_y	சௌஜன்ய்
Kirloskar	கிர்லோஸ்கர்
Ferro	ஃபெர்ரோ
Prix	ப்ரிக்ஸ்
Renaudot	ரெனாடட்
Prabhat	பிரபாத்
Kannamangai	கண்ணமங்கை
Cendant	சென்டன்ட்
Bahadur	பஹதுர்
Jeevan	ஜீவன்
Dobry	டாப்ரி
Nakesh	நாகேஷ்
Apne	அப்னே
Paraye	பராயே
Hum	ஹம்
Shakal	ஷகல்
Paul	பால்
Downton	டவுன்டவுன்
Ahlaadit	அஹ்லாதித்
Hamzah	ஹாம்ஸா
Fansuri	ஃப்பான்சுரி
Yogeshvaree	யோகேஷ்வரீ
Ladaaku	லாடாகு
Tom	டாம்
Hanks	ஹாங்க்ஸ்
Dozakh	தோஸாக்
King	கிங்
Hussein	ஹுசேன்
Natasha	நடாஷா
Lucky	லக்கி
Number	நம்பர்ஸ்
Ibthaj	இப்தாஜ்
Kenny	கென்னி
Benjamin	பெஞ்சமின்
Dhansukh	தன்சுக்
Etalan	எடாலன்
de	டி
Yennenga	என்னேங்கா
Manju	மஞ்சு
Kapoor	கபூர்
Sada	சதா
Suhagan	சுஹாகான்
Cornerstone	கார்னர்ஸ்டோன்
Aya	அயா
Sawan	சாவன்
Jhoom	ஜூம்
Ke	கே
International	இண்டர்நேஷனல்
Grandmasters	க்ராண்ட்மாஸ்டர்ஸ்
Rajatim	ரஜதிம்
Fort	ஃப்போர்ட்
pepperrell	பெப்பரெல்
Donna	டோனா
Agni	அக்னி
Prem	பிரேம்
Aabheer	ஆபீர்
Whyeth	வையத்
Ballabgarh	பல்லாப்கார்
Wahibah	வஹிபா
Deogan	டியோகன்
Road	ரோட்
Maine	மேய்ன்
Maina	மைனா
Ulfah	ஊல்ஃபா
Datia	டாதியா
Kishore	கிஷோர்
Ian	ஐயான்
Healy	ஹேலி
Shahajaadee	ஷஹஜாதீ
Pamir	பாமிர்
Kabuli	கபுலி
Khan	கான்
Sadak	சதக்
Chhap	சாப்
Bhadraaksha	பாத்ராக்ஷா
Power	பவர்
Corp	கார்ப்
Of	ஆப்
Canada	கேனடா
Qasoomah	காசூமா
Tyrone	டைரோன்
Shaan_ti	ஷாந்தி
Esme	எஸ்மே
Templeton	டெம்பிள்டன்
Prize	ப்ரைஸ்
Fed	ஃபெட்
Cup	கப்
Shail	ஷைல்
sutaa	சுதா
National	நேஷனல்
Australia	ஆஸ்ட்ரேலியா
Bank	பேங்க்
Janardan	ஜனார்தன்
Qalandar	காலாந்தர்
Baba	பாபா
Auliya	ஆலியா
Eent	ஈன்ட்
Ka	கா
Jawab	ஜவாப்
Patthar	பதார்
Mike	மைக்
Denness	டென்னெஸ்
Foziah	ஃபோஸியா
Kamalaj	காமாலாஜ்
Kmart	கேமார்ட்
Holding	ஹோல்டிங்
Omar	ஓமர்
Khayyam	காய்யம்
McCulloch	மெக்குலோஷ்
Imtiyaz	இம்டியாஸ்
Eldon	எல்டோன்
Vishishat	விஷிஷத்
Hind	ஹிந்த்
Ka	கா
Lal	லால்
Shishiraant	ஷிஷிராந்த்
koch	கோச்
industries	இண்டஸ்டிரீஸ்
Quade	குவேத்
Nestlé	நெஸ்லே
Philips	ஃபிலிப்ஸ்
India	இந்தியா
Queen	குயின்
Elizabeth	எலிசபத்
I	I
Geratpur	கெராட்பூர்
Cybille	சிபில்
Mehfil	மெஹஃப்பில்
Anar	அனர்
Bala	பாலா
Dreadnought	டிரெட்னாட்
Daag	தாக்
Bainchi	பாயிஞ்சி
Whitby	விட்பி
Peabody	பீபாடி
Award	அவார்ட்
Taj	தாஜ்
GVK	ஜிவிகே
Hotels	ஹோட்டல்ஸ்
Love	லவ்
And	அண்ட்
Murder	மர்டர்
Firozpur	ஃபிரோஸ்பூர்
Sayf	சயிஃப்
Collingsworth	காலிங்க்ஸ்வர்த்
Gounaropoulos	கோனாரோபவுலோஸ்
Museum	மியூஸியம்
of	ஆஃப்
the	த
Municipality	முனிசிப்பாலிட்டி
of	ஆஃப்
Zografou	ஸோகிராஃப்போ
Kigali	கிகலி
Abdul	அப்துல்
muqsit	முக்சித்
Tiffany	டிஃப்பானி
Rahul	ராஹுல்
Dravid	டிராவிட்
Chitrarekha	சித்ராரேகா
Kazantzakis	கஸான்ட்ஸாகிஸ்
Museum	மியூஸியம்
Paul	பால்
Adams	ஆடம்ஸ்
Oriental	ஓரியண்டல்
Bank	பேங்க்
of	ஆஃப்
Commerce	காமர்ஸ்
Georgian	ஜார்ஜியன்
Bay	பே
Chandana	சந்தனா
Naag	நாக்
Mani	மணி
Sandra	சாண்ட்ரா
Day	டே
O'connor	ஓ'கானர்
Pritish	ப்ரிடிஷ்
Nandy	நந்தி
Communications	கம்யூனிகேஷன்ஸ்
Sachche	ஸச்சே
Ka	கா
Bolbala	போல்பலா
Walgreen	வால்கிரீன்
Manali	மனாஸ்வி
Adilakshman	ஆதிலக்ஷ்மன்
Qurbani	குர்பானி
Nixie	நிக்ஸி
Ek	ஏக்
Do	தோ
Teen	தீன்
Shridula	ஸ்ரீதுலா
Dafiyah	டாஃபியா
Dharmadhikari	தர்மதிகாரி
Sharad	ஷரத்
Kaduthuruthi	காடுதுருத்தி
Dhondi	தோண்டி
Kufra	குஃப்ரா
Veeravrat	வீரவ்ரத்
Muzaffer	முஸ்ஸாஃப்ஃபெர்
Ozak	ஓஸாக்
Leann	லீன்
Chandrashekhar	சந்திரசேகர்
Azad	ஆஸாத்
Eshana	இஷானா
Aaj	ஆஜ்
Ka	கா
Gundaraj	குண்டாராஜ்
Rajneesh	ரஜ்னீஷ்
India	இந்தியா
Chakdayala	சக்தயாளா
Pran	ப்ராண்
Genero	ஜெனிரோ
Sahani	சஹானி
Robert	ராபர்ட்
Redford	ரெட்ஃபோர்ட்
Bahr	பாஹர்
Chitchor	சிட்சோர்
Bakr	பாகர்
North	நார்த்
Dakota	டாகோடா
Elvin	எல்வின்
Antoinette	ஆன்டனியோட்
Penney	பென்னி
Badr	பாதர்
Ratan	ரதன்
Manjari	மஞ்சாரி
Talisma	தலிஸ்மா
Snorkeling	ஸ்னோர்கெலிங்
Noyes	நாயெஸ்
House	ஹவுஸ்
Museum	மியூஸியம்
Sabz	சப்ஸ்
Baag	பாக்
Bihar	பீஹார்
Beguine	பெகுயின்
Caitlin	கைட்லின்
Raghuveer	ரகுவீர்
Abdul	அப்துல்
wajeed	வாஜீத்
Fauladi	ஃபௌலதி
Mukka	முக்கா
Kangan	கன்கன்
Requin	ரிகுயின்
Osmium	ஓஸ்மியம்
Murshida	முர்ஷிதா
Angaraaj	அங்கராஜ்
Padmapati	பத்மபதி
Darritola	தாரிடோலா
Allen	அல்லன்
Sohni	சோஹ்னி
Adrienne	அட்ரியான்
Veinticinco	வெய்ன்டிசின்கோ
de	டி
Mayo	மாயோ
Neil	நீல்
Johnson	ஜான்சன்
Graeme	கிரேமெ
Watson	வாட்சன்
Dhandari	தண்டாரி
Kalan	காலன்
Ratna	ரத்னா
Lutari	லுதாரி
Luton	லூட்டன்
Meridian	மெரிடியன்
School	ஸ்கூல்
Rait	ரயித்
South	சௌத்
Korea	கொரியா
Trillium	ட்ரில்லியம்
Award	அவார்ட்
Shyamari	ஷியாமாரி
Padma	பத்ம
Vibhushan	விபூஷன்
Mobile	மொபைல்
Bhooshit	பூஷித்
Charlot	சார்லட்
National	நேஷனல்
Museum	மியூஸியம்
of	ஆஃப்
Denmark	டென்மார்க்
Abdul	அப்துல்
maajid	மாஜித்
Gautam	கெளதம்
Ituran	இதுரான்
Location	லோக்கேஷன்
and	அண்ட்
Control	கன்டிரோல்
Irfan	இர்ஃபான்
Museum	மியூஸியம்
of	ஆஃப்
Television	டெலிவிஷன்
and	அண்ட்
Radio	ரேடியோ
Murti	மூர்த்தி
Daryl	டாரில்
Tuffey	டாஃப்பே
Kaanade	கானதே
China	சீனா
National	நேஷனல்
Petroleum	பெட்ரோலியம்
Ghiyath	கியாத்
Fort	ஃப்போர்ட்
stanwix	ஸ்டான்விக்ஸ்
Liberace	லிபரேஸ்
Harbhajan	ஹர்பஜன்
Singh	சிங்
Hashan	ஹஷன்
Tillakaratne	திலகரத்னே
Gurinder	குரிந்தர்
Essar	எஸ்ஸார்
Steel	ஸ்டீல்
Kaveri	காவேரி
Khaled	காலெத்
Mahmud	மாஹ்முத்
ClickSoftware	கிளிக்சாப்ட்வேர்
Technologies	டெக்னாலஜீஸ்
Love	லவ்
Marriage	மேரேஜ்
Roop	ரூப்
Lekha	லேகா
Elsie	எல்சி
Sereno	செரினோ
Athmah	அத்மா
Tum	தும்
Mere	மேரே
Ho	ஹோ
Magenta	மெஜந்தா
Nationawide	நேஷனாவைட்
Bruce	ப்ரூஸ்
Willis	வில்லிஸ்
Sayfiyy	சய்ஃபி
University	யூனிவர்சிட்டி
of	ஆஃப்
Teeside	டீசைட்
Glenmark	க்ளென்மார்க்
Pharmaceuticals	பார்மாசிட்டிக்கல்ஸ்
Wallece	வாலெஸ்
Collection	கலெக்ஷன்
Matwani	மாட்வானி
Aachaarysuta	ஆசார்யாசுதா
El-arabia	எல்-அரேபியா
Tristram	ட்ரிஸ்ட்ராம்
Steiner	ஸ்டேன்ன்ர்
Leisure	லீஷர்
Limited	லிமிடெட்
Clegg	கிளெக்
Sampriti	சம்பிரிதி
Gwyn	கைன்
Cerelia	செரிலியா
Caroline	காரோலின்
Krishna	கிருஷ்ண
Raja	ராஜா
Sagar	சாகர்
Dam	டேம்
Bhana	பானா
Periyar	பெரியார்
Armen	அர்மன்
Scottish	ஸ்காட்டிஷ்
Church	சர்ச்
College,	காலேஜ்,
Calcutta	கல்கட்டா
The	த
Folklore	ஃப்போக்லோர்
Museum	மியூஸியம்
of	ஆஃப்
Kymi	கைமி
Lohou	லோஹோ
Pope	போப்
John	ஜான்
Paul	பால்
II	II
Cottle	காட்டில்
Pyaasa	பியாஸா
Sawan	ஸாவன்
Dharm	தர்ம
Putra	புத்ரா
Amir	அமிர்
Kabir	கபிர்
Dam	டேம்
Cross	க்ராஸ்
Country	கண்ட்ரி
Roger	ரோஜர்
Telemachus	டெலிமேக்கஸ்
Bheede	பீடே
Fayyadh	ஃபையத்
Girwar	கிர்வார்
Cobra	கோப்ரா
Girl	கேர்ள்
Vinod	வினோத்
Waqt	வக்த்
Ke	கே
Shahzade	ஷாஹ்ஸாதே
Northwestern	நார்த்வெஸ்டர்ன்
Mutual	ம்யூச்சுவல்
Urshita	ஊர்ஷிதா
Styles	ஸ்டைல்ஸ்
Doodh	தூத்
Ka	கா
Karz	கர்ஸ்
Dreama	ட்ரீமா
Mitti	மிட்டி
Ka	கா
Putla	புட்லா
Nabhan	நபன்
Alibaba	அலிபாபா
Paranjape	பரஞ்பே
University	யூனிவர்சிட்டி
of	ஆஃப்
Missouri	மிசோரி
Baladev	பாலதேவ்
Aangan	ஆன்கன்
Ki	கி
Kali	காளி
Anandmayi	ஆனந்தமாயி
National	நேஷனல்
Gallery	கேலரி
of	ஆஃப்
Cannada	கேனடா
Inayat	இனாயாத்
Khan	கான்
Bankebihaari	பாங்கேபிஹாரி
Anjanaa	அஞ்சனா
Murdoch	முர்டோச்
University	யூனிவர்சிட்டி
Jim	ஜிம்
Morrison	மாரிசன்
Andha	அந்தா
Yudh	யுத்
Andrea	அன்டிரியா
Doria	டோரியா
Magda	மேக்டா
Thalassa	தலாஸா
Aachaaryanandanaa	ஆசார்யானான்தனா
Chhote	சோட்டே
Nawab	நவாப்
Jadu	ஜாடு
Tona	டோனா
Mckile	மெக்கிலெ
Tristana	ட்ரிஸ்டானா
Fuji	ஃப்புஜி
Chamkee	சம்கீ
Aaditynandan	ஆதித்யானன்தன்
Constellation	கான்ஸ்டெல்லேஷ்ன்
Energy	எனர்ஜி
Washington	வாஷிங்டன்
Mutual	ம்யூச்சுவல்
Aalha	ஆல்ஹா
Udal	உதல்
Azamat	அஸாமத்
Uran	யூரன்
Zafirah	ஜஃபீரா
Naache	நாச்சே
Nagin	நாகின்
Gali	காலி
Gali	காலி
Canadian	கனடியன்
Poets	பொயட்ஸ்
Award	அவார்ட்
Fort	ஃப்போர்ட்
amherst	ஆம்ஹெர்ஸ்ட்
Nain	நைன்
Mile	மைல்
Chain	சைன்
Kahan	கஹான்
Shindi	ஷிந்தி
Zinna	ஜின்னா
Zona	ஜோனா
Democratie	டெமோகிரேடி
Freestyle	ஃப்ரீஸ்டைல்
Zagiri	ஜகிரி
Sakhi	சகி
Robin	ராபின்
Granite	கிரானைட்
Hyde	ஹைட்
Ab	அப்
To	தோ
Jeene	ஜீனே
Do	தோ
Omaprakaash	ஓமாபிரகாஷ்
Aadat	ஆதாத்
Se	சே
Majboor	மஜ்பூர்
Majaal	மாஜால்
Verrill	வெர்ரில்
Anandmayee	ஆனந்தமாயீ
Ghazi	காஸி
Neil	நீல்
Semon	சேமன்
Karouli	கரவ்ளி
Bruce	புரூஸ்
Yardley	யார்ட்லீ
Taqdeer	தாக்தீர்
Ka	கா
Tamasha	தமாஷா
Boogie	பூகி
woogie	வூகி
Lakshmipathy	லக்ஷ்மிபதி
Balaji	பாலாஜி
Museum	மியூஸியம்
of	ஆஃப்
Scotland	ஸ்காட்லாண்ட்
Hokkaido	ஹோக்கைடோ
Kotwal	கோத்வால்
Aachaarynandan	ஆசார்யனான்தன்
Guglani	குக்லானி
Mohabbat	மொஹபத்
Isko	இஸ்கோ
Kehte	கெஹ்தே
Hain	ஹைன்
Albie	அல்பீ
Morkel	மோர்கெல்
Kyne	கைன்
Favian	ஃபாவியன்
Gurudwara	குருத்வாரா
Badi	படீ
Sangat	சாஹிப்
Ram	ராம்
Tere	தேரா
Kitne	கித்னே
Naam	நாம்
Grahan	கிரஹன்
Deepika	தீபிகா
Danga	டங்கா
Fasad	ஃபசாத்
Tictoria	டிக்டோரியா
Karsen	கார்ஸன்
Raste	ராஸ்தே
Aur	அவுர்
Rishte	ரிஷ்டே
Munsif	முன்சிஃப்
daily	டெய்லி
Phir	பிர்
Bhi	பி
Apna	அப்னா
Hai	ஹை
Muslih	முஸ்லிஹ்
George	ஜார்ஜ்
Bernard	பெர்னாட்
Shaw	ஷா
Shriranjan	ஸ்ரீரஞ்சன்
James	ஜேம்ஸ்
Franklin	ஃப்பிரான்க்லின்
Fort	ஃப்போர்ட்
mchenry	மெக்ஹென்ரி
Everest	எவரஸ்ட்
Ind	இண்ட்
Peter	பீட்டர்
Kirsten	கிர்ஸ்டன்
Asharaf	அஷாரஃப்
Tadhg	டேட்
Mabel	மாபெல்
Anagh	அனாக்
Dhoble	தோப்லே
Odyssey	ஓடிஸ்ஸீ
Banseelal	பன்ஸீலால்
Padmalaya	பத்மாலயா
Danish	தானிஷ்
Kaneria	கனேரியா
Order	ஆர்டர்
of	ஆஃப்
Agricultural,	அக்ரிகல்சுரல்,
Commercial	கமர்ஷியல்
or	ஆர்
Industrial	இண்டஸ்ட்ரியல்
Merit	மெரிட்
Jaheel	ஜஹீல்
Casper	காஸ்பர்
Luxor	லக்சர்
Nakshatra	நக்ஷத்ரா
Block	பிளாக்
Island	ஐலாண்ட்
University	யூனிவர்சிட்டி
of	ஆஃப்
Birmingham	பிர்மிங்காம்
Aadmi	ஆத்மி
Apna	அப்னா
Desh	தேஷ்
Paraye	பராயே
Log	லோக்
The	தி
Meredith	மெரெடித்
Cup	கப்
Wicklow	விக்லோ
Bahira	பாஹிரா
Gurudwara	குருத்வாரா
Imali	இமலி
Shib	சாஹிப்
Eryk	எரிக்
Anil	அனில்
Kumble	கும்பிளே
Abdul	அப்துல்
ganee	கானீ
Mufti	முஃப்தி
Shuchita	ஷுச்சிதா
Harda	ஹர்தா
Delhi	டெல்லி
Kishanganj	கிஷன்கஞ்ச்
Banjare	பஞ்சரே
First	ஃபர்ஸ்ட்
Southern	சதர்ன்
Baptist	பேப்டிஸ்ட்
Zimmedaar	ஸிம்மேதார்
University	யூனிவர்சிட்டி
of	ஆஃப்
Kent	கென்ட்
Order	ஆர்டர்
of	ஆஃப்
the	தி
Estonian	எஸ்டோனியன்
Red	ரெட்
Cross	க்ராஸ்
Hashid	ஹஷித்
Lucas	லுகாஸ்
Salim	சலிம்
Rakh	ராக்
Aur	அவுர்
Chingari	சிங்காரி
Gangrar	கங்ரார்
Aankhon	ஆன்கோன்
Dekhi	தேக்கி
Peak	பீக்
District	டிஸ்ட்ரிக்ட்
Mahaaraajasinh	மஹாராஜாசிங்
China	சீனா
Mobile	மொபைல்
Communications	கம்யூனிக்கேஷன்ஸ்
Keshihan	கேஷிஹான்
Jeevan	ஜீவன்
Prabhat	பிரபாத்
Gelsey	கெல்சீ
Clarendon	கிளாரென்டன்
Pattharon	பத்தாரோன்
Ka	கா
Saudagar	சவுதாகர்
Khidki	கித்கி
Soma	சோமா
Navios	நேவியோஸ்
Maritime	மாரிடைம்
Holdings	ஹோல்டிங்க்ஸ்
Jawharah	ஜவாரா
Modern	மாடர்ன்
Matriculation	மெட்ரிகுலேஷன்
School,	ஸ்கூல்,
Cholvaram	சோல்வரம்
Nagar	நகர்
Dinkar	தினகர்
Qalat	கலாத்
al	அல்
bahrain	பஹ்ரெயின்
Moorat	மூரத்
Jaani	ஜானி
Dost	தோஸ்த்
Lumps	லம்ப்ஸ்
fort	ஃப்போர்ட்
South	சௌத்
China	சைனா
Hawshab	ஹவ்ஷாப்
Watan	வாதன்
Ke	கே
Rakhwale	தாக்வாலே
Rajeshwari	ராஜேஷ்வரி
Marconi	மார்கோனி
Prize	ப்ரைஸ்
Dalasi	தலாசி
Mark	மார்க்
Twain	ட்வெய்ன்
Aabirah	ஆபிரா
Ram	ராம்
Rajya	ராஜ்யா
Family	பேமிலி
Balajee	பாலாஜி
Pallavini	பல்லவினி
Ken	கென்
Rutherford	ருதர்ஃப்போர்ட்
Baijayanthi	பைஜெயந்தி
Rosa	ரோஸா
Hip	ஹிப்
Hip	ஹிப்
Hurrey	ஹுரே
Cape	கேப்
Breton	ப்ரேடன்
Noopur	நூபுர்
National	நேஷனல்
Book	புக்
Critics	க்ரிட்டிக்ஸ்
Circle	சர்கிள்
Award	அவார்ட்
Faith	பெயித்
Missionary	மிஸனரி
Baptist	பேப்டிஸ்ட்
Warren	வாரன்
Community	கம்யுனிட்டி
Mount	மவுண்ட்
Revelstoke	ரெவல்ஸ்டோக்
Tsiolkovsky	ட்ஸியோல்கோவ்ஸ்கி
Pravin	பிரவீன்
Amre	ஆம்ரே
Fort	ஃப்போர்ட்
nelson	நெல்ஸன்
Pendharkar	பெந்தர்கர்
Bhagam	பகம்
Bhag	பாக்
Fort	ஃப்போர்ட்
macon	மாக்கான்
Lajja	லஜ்ஜா
Khalaf	காலாஃப்
Isa	இசா
Guenevere	குய்னெவெர்
Sarmad	சர்மத்
Ghar	கர்
Ka	கா
Sukh	சுக்
Nripinder	ந்ரிபிந்தர்
Stan	ஸ்டன்
Kerry	கெர்ரி
Walmsley	வால்ம்ஸ்லே
Musafir	முஸாஃப்பிர்
Khana	கன்னா
Gilliam	கில்லியம்
Alok	ஆலோக்
Fatehabad	ஃபதேஹாபாத்
Junction	ஜங்ஷன்
Penelope	பெனிலோப்
Rangeela	ரங்கீலா
Arun	அருண்
Jimbo	ஜிம்போ
Andros	ஆன்டிரோஸ்
Museum	மியூஸியம்
of	ஆஃப்
Modern	மாடர்ன்
Art	ஆர்ட்
Chandragupta	சந்திரகுப்தா
Dalsingh	தால்சிங்
Sarai	சராய்
Trishna	த்ரிஷ்னா
Shivnarine	ஷிவ்நாராய்ண்
Chanderpaul	சந்தர்பால்
Jwalamukhi	ஜ்வாலமுகி
Mufeed	முஃபீத்
Bakaalkar	பகால்கர்
Sasural	சாஸுரல்
Adhiwar	அதிவார்
Shane	ஷேன்
Lee	லீ
Azimganj	அஸீம்கஞ்ச்
Junction	ஜங்ஷன்
Aggie	அக்கி
Muslim	முஸ்லிம்
Reddys	ரெட்டிஸ்
Labs	லேப்ஸ்
Fort	ஃப்போர்ட்
bokar	பூகர்
Pyar	பியார்
Ki	கி
Maar	மார்
Modern	மாடர்ன்
Youth	யோத்
Truda	ட்ரூடா
East	ஈஸ்ட்
Siberian	சைபீரியன்
Acaryatanaya	அகார்யாதனாயா
Meri	மேரி
Asha	ஆஷா
Mogadishu	மொகாதிஷு
Saini	சைனி
Meet	மீட்
One	ஒன்
Greet	கிரேட்
One	ஒன்
Mujaffarnagar	முஜ்ஜாபர்நகர்
Kalinjar	கலிங்கார்
Rajput	ராஜ்புட்
Peking	பெகிங்
University	யூனிவர்சிட்டி
Mahindra	மஹிந்த்ரா
Gesco	கெஸ்கோ
Developers	டெவலப்பர்ஸ்
Sonipat	சோனிபத்
Chhupa	சுபா
Chhupee	சுபீ
Giuseppe	கியூஸெப்பே
Miraglia	மிராக்லியா
Kartar	கார்டர்
Iria	இரியா
Brijesh	ப்ரிஜேஷ்
Jagajeet	ஜகாஜீத்
Thirukkulunkunram	திருக்கழுகுன்றம்
Fort	ஃப்போர்ட்
necessity	நெஸஸ்ஸிட்டி
Do	தோ
Hawaldar	ஹவல்தார்
Connley	கோன்லி
Jeanne	ஜீனீ
Zakhami	ஸாக்காமி
Insaan	இன்சான்
Tom	டாம்
Cruise	க்ரூஸ்
Cheryl	சேரில்
Saat	சாத்
Sawal	சவால்
Peter	பீட்டர்
Willey	வில்லி
Smriti	ஸ்மிரிதி
Maa	மா
Ka	கா
Anchal	அன்சல்
Anuradhaa	அனுராதா
Chidaksh	சிடாக்ஷ்
Hum	ஹம்
Diwane	திவானே
Barclays	பார்கிளேஸ்
Khush	குஷ்
Naseeb	நஸீப்
Steve	ஸ்டீவ்
Wozniak	ஓஸ்னியாக்
Arulchelvan	அருள்செல்வன்
Whoopi	ஊஃப்பி
Goldberg	கோல்ட்பர்க்
Wimborn	விம்பார்ன்
Mera	மேரா
Ghar	கர்
Mere	மேரெ
Bachche	பச்சே
Infosys	இனஃபோசிஸ்
Technologies	டெக்காலஜிஸ்
Sultanpuria	சுல்தான்பூரியா
Sagheer	சகீர்
Taranekar	தாரனேகர்
Indrani	இந்திரானி
Burrows	பர்ரோஸ்
Janaki	ஜானகி
Nasha	நஷா
Manchester	மான்செஸ்டர்
Goonj	கூன்ஜ்
Meharbani	மெஹர்பானி
Ishita	ஐஷிதா
Babboo	பாபு
Jet-skiing	ஜெட்-ஸ்கையிங்
Tayke	தாய்கே
Gokul	கோகுல்
Ka	கா
Raja	ராஜா
Darpana	தர்பணா
Lainey	லைனே
Prag	பிராக்
Ova	ஓவா
Baje	பஜே
Ghunghru	குங்ரு
Mukti	முக்தி
Beshaque	பெஷாக்
Zakir	ஜாக்கிர்
Khan	கான்
Mukta	முக்தா
Aakhri	ஆக்ரி
Raasta	ராஸ்தா
Chhoti	சோட்டி
Bahu	பாஹு
Dharamsheel	தரம்ஷீல்
Varadraja	வரதராஜ
Perumal	பெருமாள்
Nam	நாம்
Non	நான்
Raste	ராஸ்தே
Aur	அவுர்
Manzil	மன்ஸில்
Kariba	கரிபா
Dam	டேம்
Lola	லோலா
Chandu	சாந்து
Inigo	இனிகோ
Amareesh	அமாரீஷ்
Bhanuprasad	பானுபிரசாத்
Strait	ஸ்டிரெயிட்
of	ஆப்
Dover	டோவர்
Eyre	ஐரி
Lihir	லிஹிர்
Gold,	கோல்டு,
Limited	லிமிடெட்
Shiv	ஷிவ்
Sunder	சுந்தர்
Das	தாஸ்
Badshahnagar	பாத்ஷாநகர்
Dolti	டோல்தி
Naiya	நய்யா
Antony	ஆண்டனி
Hopkins	ஹாப்கின்ஸ்
Aahwaanit	ஆஹ்வானித்
Bhai	பாய்
Bahen	பஹேன்
Oona	ஊனா
Shambhu	சாம்பு
Maharaj	மஹராஜ்
Shashiprabhaa	ஷஷிபிரபா
Jingo	ஜிங்கோ
Abdus	அப்துஸ்
saboor	சாபூர்
Hemang	ஹேமங்
Badani	பதானி
Louis	லூயிஸ்
Fisher	ஃபிஷர்
Gurr	குர்
Arya	ஆர்யா
Kudrat	குத்ராத்
Joanna	ஜோன்னா
Sartaj	சர்தாஜ்
Meliora	மெலியோரா
Hindalco	ஹிண்டால்கோ
Saamri	சாம்ரி
Razia	ராஸியா
Sultana	சுல்தானா
Congo	காங்கோ
Sanne	சான்னே
Ek	ஏக்
Shriman	ஸ்ரீமன்
Ek	ஏக்
Shrimati	ஸ்ரீமதி
Shilpee	ஷில்பீ
Naomi	நாவோமி
Awards	அவார்ட்ஸ்
Zaheerah	ஜஹீரா
Norah	நோராஹ்
Central	சென்ட்ரல்
America	அமெரிக்கா
Maya	மாயா
Prayashchit	பிராயாஸ்சித்
Urdu	உருது
Batwara	பத்வாரா
Calliope	காலியோப்
Tarunika	தருணிகா
President	பிரெஸிடெண்ட்
Jackson	ஜாக்ஸன்
Pulaski	புலஸ்கி
Heights	ஹைட்ஸ்
United	யுனைட்டெட்
Methodist	மெதோடிஸ்ட்
Ashish	அஷீஷ்
Aparajita	அபராஜித்தா
Jeevan	ஜீவன்
Naiya	நயா
Hud	ஹுத்
Tiptree	டிப்ட்ரீ
award	அவார்ட்
Emanuele	இமானுவேல்
Krebs	க்ரெப்ஸ்
Biochem	பயோகெம்
Enterprise	என்டர்பிரைஸ்
Derek	டெரெக்
Randall	ரான்டால்
Rangila	ரங்கிலா
Rajasthan	ராஜஸ்தான்
Manpower	மேன் பவர்
Sene	செனெ
Dhavle	தாவ்லே
Tata	டாடா
Metaliks	மெட்டலிக்ஸ்
Mirari	மிராரி
Potemkin	போடெம்கின்
Robin	ராபின்
Singh	சிங்
Fort	ஃப்போர்ட்
pickens	பிக்கன்ஸ்
Mareechi	மரீச்சி
Gauna	கௌனா
Psaltery	ப்சால்டெரி
The	தி
Trump	டிரம்ப்
building	பில்டிங்
Dhampur	தாம்பூர்
Sugar	சுகர்
Jalianwala	ஜாலியன்வாலா
Bagh	பாக்
Ki	கி
Jyoti	ஜோதி
Aitana	ஐடானா
Beohari	பியோஹரி
Road	ரோட்
To	டூ
Sikkim	சிக்கிம்
Merrimack	மெர்ரிமாக்
Seamus	சிமஸ்
Harris	ஹாரிஸ்
Order	ஆர்டர்
of	ஆஃப்
the	தி
Rising	ரைசிங்
Sun	சன்
Turnbull	டர்ன்புல்
Cassie	காஸி
Karnama	கர்நமா
Erma	எர்மா
Meri	மேரி
Lalkaar	லால்கர்
Abhijit	அபிஜித்
Kale	கேல்
Tanushri	தனுஸ்ரீ
Gynaecology	கைனக்காலஜி
Marika	மாரிகா
Kotopouli	கோடோபவ்லி
Museum	மியூஸியம்
Centimos	சென்டிமோஸ்
Chris	கிரிஸ்
Tavare	டாவாரெ
Colin	காலின்
Croft	க்ராஃப்ட்
Marriage	மேரேஜ்
Bureau	பியோரே
Jaali	ஜாலி
Note	நோட்
Yateem	யதீம்
Lagan	லகான்
Awaara	ஆவாரா
Abdullah	அப்துல்லா
Mangalore	மங்களூர்
Chem	கெம்
Groucho	க்ரூச்சோ
Marcs	மார்க்ஸ்
Ur-itreesh	உர்-இட்ரீஷ்
Palm	பாம்
Springs	ஸ்பிரிங்ஸ்
Pearson	பியர்சன்
Medal	மெடல்
of	ஆஃப்
Peace	பீஸ்
Aadinaath	ஆதினாத்
Sudesh	சுதேஷ்
Mragayaa	ம்ரகயா
Kaya	கயா
Palat	பலட்
Two	டு
International	இன்டர்நேஷனல்
Finance	ஃபினான்ஸ்
Centre	சென்டர்
Andrew	ஆன்ட்ரூ
Flintoff	ஃப்பிளின்டாஃப்
Ritu	ரிது
Ina	இனா
Kolthekar	கொல்தேகர்
Bharat	பாரத்
Elec	எலக்ட்ரிகல்ஸ்
Vedagy	வேதகி
Adeel	அதீல்
Purkar	புர்கார்
Theophilus	தியோஃபிலஸ்
Bansuri	பன்ஸுரி
Layar	லாயர்
Slow	ஸ்லோ
Pitch	பிச்
softball	சாஃப்ட்பால்
Wylie	வய்லி
Michelin	மைக்கேலின்
Polhawn	பால்ஹான்
fort	ஃப்போர்ட்
Shabari	ஷபரி
Guy	கய்
Whittall	விட்டல்
Impero	இம்பெரோ
Gangian	காங்கியன்
Flores	புளோர்ஸ்
Raajit	ராஜித்
Hind	ஹிந்த்
Motors	மோட்டார்ஸ்
Corporation	கார்ப்பரேஷன்
Bank	பேங்க்
Cadbury's	கேட்பரிஸ்
Savannah	சவன்னா
Hishaam	ஹிஷாம்
Syed	சயத்
Kirmani	கிர்மானி
Siddheshwari	சித்தேஷ்வரி
Bhatinda	பாட்டின்டா
Steve	ஸ்டீவ்
Rixon	ரிக்ஸன்
Millicent	மில்லிசெண்ட்
Yashodha	யசோதா
Bandula	பந்துலா
Warnapura	வர்ணபூரா
Glide	கிலைட்
Raajapaal	ராஜபால்
Milan	மிலன்
Aankhon	ஆன்கோன்
Annkhon	ஆன்கோன்
Mein	மெயின்
Tokyo	டோக்யோ
Electric	எலக்டிரிக்
Power	பவர்
Rozalia	ரோஸலியா
Dakaniya	தக்கானியா
Talav	தலாவ்
Phoebe	ஃபோபே
Bhim	பீம்
Garjana	கர்ஜனா
Aamer	ஆமீர்
Malik	மாலிக்
Santoor	சந்தூர்
Jack	ஜாக்
Richards	ரிச்சர்ட்ஸ்
Suzuki	சுசூக்கி
Motor	மோட்டார்
Leonardo	லியோனார்டோ
Devdharkar	தேவ்தர்கர்
Tha'labah	தலாபா
Adhikar	அதிகார்
Oakland	ஓக்லேண்ட்
University	யூனிவர்சிட்டி
Gyanda	ஞானந்தா
Nachiyar	நாச்சியார்
Koil	கோவில்
Soolagiri	சூலகிரி
chinnar	சின்னார்
Reservoir	ரிசர்வாயர்
Age	ஆகே
Badho	படோ
Abhayaprad	அபயாபிராத்
DryShips	டிரைஷிப்ஸ்
Ronna	ரோன்னா
Char	சார்
Din	தின்
Arasur	அரசூர்
I^diyaa	இந்தியா
Kelkar	கேல்கர்
Zizi	ஜீஜீ
Jeeval	ஜீவல்
Eenadu	ஈயனாடு
Dahej	தஹேஜ்
Yokomitsu	யோகோமிட்ஸு
Prize	ப்ரைஸ்
Principe	பிரின்சிபி
di	டி
Carignano	காரிக்னானோ
Sarwate	சர்வதே
Atithee	அதிதீ
Shabah	ஷபா
Ramaakaant	ரமாகந்த்
Alpine	அல்பைன்
Fort	ஃப்போர்ட்
tregantle	டிரேகான்ட்ல்
Chinna	சின்ன
Ganjam	கஞ்சாம்
Girija	கிரிஜா
Bhadrak	பாத்ராக்
Bhadran	பத்ரான்
Yavalkar	யவல்கர்
Jackie	ஜாக்கி
Republique	ரிப்பப்ளிக்
Bansipur	பன்ஸிபூர்
Giller	கில்லர்
Prize	ப்ரைஸ்
Kismat	கிஸ்மத்
Fort	ஃப்போர்ட்
calgary	கால்காரி
Sainte	செயிண்ட்
marie	மேரி
Simon	சைமன்
Pearce	பியர்ஸ்
Gourde	கோர்டே
Lele	லேலே
Akele	அகேலே
Hum	ஹம்
Akele	அகேலே
Tum	தும்
Hindustaanee	ஹிந்துஸ்தானீ
Guy	கை
Doug	டவுக்
Walters	வால்ட்டர்ஸ்
Afasanaa	அஃபாஸானா
Cronos	குரோனோஸ்
Group	குரூப்
Linda	லிண்டா
Ronstadt	ரோன்ஸ்டாத்
Brecon	ப்ரேக்கன்
Beacons	பீக்கன்ஸ்
Rajkumar	ராஜ்குமார்
Gus	கஸ்
Shungare	ஷுன்கரே
Charango	சராங்கோ
Veenapani	வீணாபானி
Stone	ஸ்டோன்
Avanindar	அவனின்தர்
Arishtut	அரிஷ்டுத்
Omar	ஒமர்
Khaiyyam	கையம்
Padosi	படோசி
Haath	ஹாத்
Ki	கி
Safai	சஃபாய்
Andy	ஆண்டி
Flower	ஃப்ளவர்
Girl	கேர்ள்
Friend	ஃபிரண்ட்
Taysir	தய்ஸிர்
Museum	மியூஸியம்
of	ஆஃப்
London	லண்டன்
Slone	ஸ்லோன்
Kottayam	கோட்டயம்
Irawati	இராவத்தி
Maxima	மாக்ஸிமா
Alan	அலன்
Knott	நாட்
Narottam	நரோட்டம்
Hind	ஹிந்த்
Lahak	லஹக்
Sandhi	சந்தி
Lake	லேக்
Mburo	மிபூரோ
Marsabit	மார்சாபிட்
and	அண்ட்
Reserve	ரிசர்வ்
Kabhi	கபி
Ajnabi	அஜ்னபி
The	தே
Fort	ஃப்போர்ட்
warren	வார்ரென்
EuroTrust	யூரோடிரஸ்ட்
Banyard	பான்யார்ட்
Janardan	ஜனார்தன்
Thakur	தாகுர்
Radio	ரேடியோ
Academy	அகாடமி
Awards	அவார்ட்
Bhayanak	பயானக்
Judson	ஜூட்ஸன்
Cape	கேப்
Cod	காட்
Chandrapura	சந்திராபூரா
Chandia	சண்டியா
Road	ரோட்
Muqabala	முக்காபலா
Bharat	பாரத்
Kup	குப்
Vidya	வித்யா
Vardhaka	வர்தாகா
Sangha	சங்கா
High	ஹை
School,	ஸ்கூல்,
Bangalore	பெங்களூர்
Woodlands	உட்லாண்ட்ஸ்
fort	ஃப்போர்ட்
Jurrat	ஜுர்ரத்
Shaheen	ஷாஹீன்
Sailing	செய்லிங்
Dhamua	தாமுவா
John	ஜான்
Crawley	கிராலே
Adam	ஆடம்
Dale	டேல்
Jaisudha	ஜெய்சுதா
Goshen	கோஷென்
Ayushman	அயுஷ்மான்
Dream	டிரீம்
Girl	கேர்ள்
Greg	கிரெக்
Miyan	மியான்
Biwi	பீவி
Razi	ராஸி
Doctor	டாக்டர்
Shaitan	ஷைதான்
Zoltin	ஜோல்டின்
Times	டைம்ஸ்
Multimedia	மல்டிமீடியா
Allaudin	அலாவுதின்
Ka	கா
Chirag	சிராக்
Tilottama	திலோத்தமா
London	லண்டன்
Metropolitan	மெட்ரோபாலிட்டன்
University	யூனிவர்சிட்டி
Oak	ஓக்
Hills	ஹில்ஸ்
Presbyterian	பிரஸ்படேரியன்
Doosri	தூஸ்ரி
Dulhan	துல்ஹன்
University	யூனிவர்சிட்டி
of	ஆஃப்
Surrey	சர்ரே
Aswan	அஸ்வன்
Dams	டேம்ஸ்
Ameeri	அமீரி
Gareebi	கரீபி
Rajiv	ராஜிவ்
Utah	உட்டாஹ்
Satna	சட்னா
Triborough	டிரைபோரெள
Bombay	பாம்பே
Ka	கா
Maharaja	மஹராஜா
Castelfidardo	காஸ்டல்பஃப்பிடார்டோ
Centurion	சென்சுரியன்
Bank	பேங்க்
Nastik	நஸ்திக்
Guru	குரு
Dakshina	தக்ஷிணா
Brazosport	பிராஸோஸ்போர்ட்
Christian	கிறிஸ்டியன்
Center	சென்டர்
Draper	டிரேபர்
Scottish	ஸ்காட்டிஷ்
Football	ஃப்பூட்பால்
Museum	மியூஸியம்
Swain	ஸ்வைன்
Hasan	ஹசன்
Jamil	ஜமில்
Takle	தக்லே
Haitian	ஹைதியன்
merengue	மெரென்க்யூ
Saheb	சாஹெப்
Husnaraa	ஹுஸ்னரா
Anneliese	ஆன்னலியேசி
Veolia	வியோலியா
Environnement	என்விரான்மெண்ட்
Bada	படா
Aadmi	ஆத்மி
Leeds	லீட்ஸ்
Bradford	பிராட்போர்ட்
Balveer	பல்வீர்
Bongaigaon	பொங்கைகான்
Ref	ரிஃபைனரிஸ்
Yaajak	யாஜக்
Sarolkar	சரோல்கர்
Ahindra	அஹிந்திரா
Manna	மன்னா
Christian	கிறிஸ்டியன்
Fellowship	பெல்லோஷிப்
Chocolate	சாக்கலேட்
Fatehgarh	ஃபதேகார்
La	லா
Salle	சேல்
Spiro	ஸ்பைரோ
Severino	செவெரினோ
Mithun	மிதிலேஷ்
Gujhandi	குஜ்ஹண்டி
Somendra	சோமேந்திரா
Glenys	கிலெனிஸ்
Aayega	ஆயேகே
Aanewala	ஆனீவாலா
Zocha	ஜோச்சா
Kesava	கேசவ
Patanga	பதங்கா
Renguzar	ரெங்குஸார்
Gene	ஜேனி
Khuda	குதா
Kasam	காஸம்
Tamber	டேம்பர்
Maurilio	மௌரிலியோ
Ahladit	அஹ்லாதித்
Fatih	ஃபதீஹ்
Somerset	சோமர்செட்
Mom	மாம்
Ibtihal	இப்டிஹால்
Jolie	ஜோலி
Dwight	த்வைட்
Ramiz	ரமிஸ்
Saatvik	சாத்விக்
Dayton	டேட்டன்
art	ஆர்ட்
Institute	இன்ஸ்டிடியூட்
Beerasinh	பீராசிங்
Ananyaa	அனன்யா
Giolla	கியோலா
Greg	கிரெக்
Chappell	சாப்பல்
Ananyaj	அனன்யாஜ்
Sanaubar	சனௌபார்
Irvine	இர்வைன்
Shillingford	ஷில்லிங்ஃபோர்ட்
Bonso	பான்ஸ்கோ
Electronics	எலக்டிரானிக்ஸ்
International	இன்டர்நேஷனல்
Bankebihaaree	பாங்கேபிஹாரி
Ludhiana	லூதியானா
American	அமெரிக்கன்
Express	எக்ஸ்பிரஸ்
Pritikana	ப்ரீத்திகானா
Vico	விகோ
Annis	அனிஸ்
Barakah	பராகா
Durga	துர்கா
Guj	குஜ்
State	ஸ்டேட்
Petro	பெட்ரோ
Himaalay	ஹிமாலய்
Emerson	எமெர்சென்
Electric	எலக்டிரிக்
Faiqah	ஃபையிக்கா
Aao	ஆவோ
Pyar	பியார்
Karen	கரேன்
Marlon	மர்லான்
Kephart	கெபர்ட்
United	யுனைட்டெட்
Methodist	மெதோடிஸ்ட்
Colusa	கொலுஸா
Catrin	கேட்ரின்
Kamilia	காமிலியா
Chinese	சைனீஸ்
Petroleum	பெட்ரோலியம்
Texas	டெக்ஸாஸ்
Kruger	க்ரூகர்
Fort	ஃப்போர்ட்
san	சான்
cristobal	கிரிஸ்டோபால்
Andolan	அந்தோலன்
Ekachitt	எகாசித்
Deeptendu	தீப்தேந்து
Jin	ஜின்
Mao	மாவோ
Building	பில்டிங்
Gora	கோரா
Ghuma	குமா
Ichhita	இச்சித்தா
Ibtisam	இப்டிசாம்
Rabit	ரபித்
Emily	எமிலி
Harris	ஹாரில்
Banajit	பனஜித்
John	ஜான்
Hampshire	ஹாம்ப்ஷைர்
Mera	மேரா
Salaam	ஸலாம்
General	ஜெனரல்
John	ஜான்
Strong	ஸ்டிராங்
Museum	மியூஸியம்
Manjeer	மஞ்சீர்
Godaavaree	கோதாவரீ
Amarap	அமர்ராப்
Fort	ஃப்போர்ட்
cumberland	கம்பர்லாண்ட்
Vijayavargeey	விஜயவர்கீ
Jassi	ஜாஸ்ஸி
Shriman	ஸ்ரீமான்
Shrimati	ஸ்ரீமதி
Necia	நெஸியா
Dhul	துல்
fiqar	ஃபிகார்
Barabhum	பராபம்
Nirupama	நிருபமா
Curry	கரி
Dipak	தீபக்
Tista	டிஸ்தா
Ashish	ஆஷிஷ்
Nehra	நெஹ்ரா
Dabolim	தாபோலிம்
Ayyoob	அய்யூப்
Anmol	அன்மோல்
Moti	மோட்டி
Brett	பிரெட்
Lee	லீ
Akmal	அக்மல்
Balmohan	பால்மோகன்
Nazuk	நாஜுக்
Alfred	அல்ஃபிரட்
Bacardi-Martini	பக்கார்டி-மார்ட்டினி
India	இந்தியா
Keith	கீத்
Dabengwa	டபேங்க்வா
Vijay	விஜய்
Dahiya	தாஹியா
Lachak	லாசக்
Basra	பஸ்ரா
Mass	மாஸ்
Mutual	ம்யூச்சுவல்
Life	லைப்
Leena	லீனா
Na	நா
Mumkin	மும்கின்
Fort	ஃப்போர்ட்
aan	ஆன்
de	டி
biltstraat	பில்ட்ஸ்ட்ராட்
Rangeen	ரங்கீன்
Kahani	கஹானி
Soorat	சூரத்
Vaijayanti	வைஜெயந்தி
Param	பரம்
Dharam	தரம்
Dashehra	தஷேரா
Eleanor	எலியனார்
Bill	பில்
Gates	கேட்ஸ்
Atishbaaz	ஆதிஷ்பாஸ்
Bashir	பஷீர்
Horeshoes	ஹார்ஷூஸ்
Jihan	ஜிஹான்
Rukmani	ருக்மனி
Haran	ஹரன்
Inflexible	இன்ஃபிளெக்ஸிபிள்
George	ஜார்ஜ்
Van	வான்
Biesbroeck	பீஸ்ப்ரோயக்
Prize	ப்ரைஸ்
Do	தோ
Bahadur	பஹதுர்
Kabul	காபுல்
Mallika	மல்லிகா
Ek	ஏக்
Phool	பூல்
Ek	ஏக்
Bhool	பூல்
Girijaa	கிரிஜா
Mahira	மஹிரா
Gates	கேட்ஸ்
Rangnath	ரங்கநாத்
Leona	லியோனா
Sumayrah	சுமய்ரா
Gold	கோல்ட்
Medal	மெடல்
Wisconsin	விஸ்கான்ஸின்
Prashant	பிரஷாந்த்
Vaidya	வைத்யா
Lalitmohan	லலித்மோகன்
Brijal	பிரிஜால்
Patel	பட்டேல்
Ian	ஐயன்
Botham	போதம்
Aloysius	அலோய்சியஸ்
Richard	ரிச்சர்ட்
de	டி
Groen	கிரோயென்
Anastacia	அனஸ்தஷியா
Anou	அனவ்
Boussouil	பெளஸோயில்
Farid	ஃபரீத்
Anjali	அஞ்சலி
Punar	பூனர்
Milan	மிலன்
Chinchore	சின்கோர்
Arthur	ஆர்தர்
conan	கோனன்
doyle	டாய்ல்
Leane	லியான்
Shreekrashn	ஸ்ரீகிரஷண்
Shane	ஷேன்
Bond	பாண்ட்
Mahatma	மஹாத்மா
Gandhi	காந்தி
Sainbi	சைனபி
Raajiv	ராஜிவ்
Aurat	ஔரத்
Ki	கி
Zindagi	ஜின்தகி
Vaheedan	வஹீதன்
Faqih	ஃபகீஹ்
Prithvi	பிரித்வி
Putra	புத்ரா
Hamari	ஹமாரி
Bahu	பாஹு
Alka	அல்கா
Gary	காரி
Troup	ட்ரூப்
Kesoram	கேசோராம்
Gonda	கோண்டா
Junction	ஜங்ஷன்
Credit	கிரெடிட்
Susse	சூசே
Gulbarga	குல்பர்கா
Paricutin	பரிகுடின்
Andha	அந்தா
Kanoon	கானூன்
Reshmi	ரேஷ்மி
Rumal	ருமால்
Sawan	சாவன்
Ke	கே
Geet	கீத்
Husni	ஹுஸ்னி
Thakkar	தக்கார்
Farid	ஃப்பரீத்
al-Din	அல்-தின்
Attar	அத்தர்
Antares	அன்டாரெஸ்
Gokarna	கோகர்ண
Kautilya	கௌடில்யா
Fahim	ஃபாஹிம்
Constitution	கான்ஸ்டிட்யூஷன்
Kartavya	கர்தவ்யா
Ukulele	உக்குலேலே
Zeilin	ஸெய்லின்
Sledding	ஸ்லெட்டிங்
Abisso	அபிஸோ
Abri	அப்ரி
Terah	டேரா
Mimi	மிமி
Ramu	ராமு
Ustad	உஸ்தத்
Changuna	சங்குனா
Nirdosh	நிர்தோஷ்
Robert	ராபர்ட்
Croft	கிராஃப்ட்
Dirt	டேர்ட்
Racing	ரேசிங்
Kamalapati	கமலாபதி
Janyu	ஜன்யு
Khirash	கிராஷ்
Ek	ஏக்
Number	நம்பர்
Ka	கா
Chor	சோர்
Kelton	கெல்டன்
Bagri	பாக்ரி
Nagar	நகர்
Rajani	ரஜனி
Shor	ஷோர்
Walker	வாக்கர்
Kshanika	ஷானிகா
Gizi	கிஸ்ஸி
Encana	என்கானா
Devjeet	தேவ்ஜீத்
Safwan	சஃப்வன்
Whirlpool	வேர்ல்பூல்
ShotPut	ஷாட்புட்
Sati	சதி
Bal	பால்
Yogi	யோகி
Gigi	கிக்கி
Kanwal	கான்வல்
Neelmani	நீல்மணி
Manmukhani	மன்முக்கானி
Teams	டீம்ஸ்
John	ஜான்
Emburey	எம்புரே
Duncan	டன்கன்
Fifi	ஃபிஃபி
Abhirup	அபிருப்
Strontium	ஸ்டிரான்டியம்
Zameelah	ஜமீலா
Galen	கேலன்
Venture	வென்சுர்
Christian	கிறிஸ்டியன்
Albukerk	அல்பூகெர்க்
Kathputli	கத்புத்லி
Winston	வின்ஸ்டன்
Benjamin	பெஞ்சமின்
Anaadyant	அனாத்யன்ட்
Rochan	ரோசன்
Antarctica	அண்டார்டிகா
Araafaat	அராஃபாத்
Bhavanisagar	பவானிசாகர்
Reservoir	ரிசர்வாயர்
Pierre	பியரி
Rukma	ருக்மா
Thar	தார்
Gupte	குப்தே
Fakih	ஃபகீஹ்
Aap	ஆப்
Beeti	பேட்டி
Khandani	காந்தானி
Bhilavdi	பிலாவ்டி
Gerald	ஜெரால்ட்
Lampert	லேம்பர்ட்
Award	அவார்ட்
Kamyab	கம்யாப்
Falna	ஃபால்னா
Everett	எவரெட்
Stavros	ஸ்டவ்ரோஸ்
Gajakarna	காஜாகர்ணா
Kanoon	கானூன்
Aur	ஔர்
Mujrim	முஜ்ரிம்
Shafiek	ஷஃபீக்
Abrahams	ஆப்ரஹாம்ஸ்
Mukhtaar	முக்தார்
Main	மேன்
Suhagan	சுஹாகான்
Hoon	ஹூன்
Suhayl	சுஹயில்
Seema	சீமா
Magoffin	மாகோஃப்பின்
Cullen	குளேன்
Sarbajit	சர்பஜித்
David	டேவிட்
Bernard	பெர்னார்ட்
Maharani	மஹாரானி
Jhansi	ஜான்ஸி
Catriona	கேட்டியோனா
Frances	ஃப்ரான்சிஸ்
Oberth	ஓபெர்த்
Auyuittuq	ஆயிட்டுக்
Khoon	கூன்
Ki	கி
Takkar	டக்கர்
Balaram	பலராம்
Chharodi	சரோடி
Suketu	சுகேது
Pival	பிவல்
Ramco	ராம்கோ
System	சிஸ்டம்
Bir	பிர்
Bikrom	பிக்ரம்
Shadyanta	ஷாதியன்தா
Pramsu	ப்ரம்ஸு
Bamra	பாம்ரா
Duncan	டன்கன்
Fletcher	ஃப்ளெட்சர்
Salam	சலாம்
Bombay	பாம்பே
Aakhri	ஆக்ரி
Goli	கோலி
Vanadevee	வனதேவீ
Lakhimpur	லக்கிம்பூர்
Grammy	க்ராம்மி
Hall	ஹால்
of	ஆஃப்
Fame	ஃபேம்
Award	அவார்ட்
Gregory	கிரிகரி
Keely	கீலி
Hisham	ஹிஷம்
Anaadi	அனாதி
Husnaa	ஹுஸ்னா
Anahitaa	அனஹித்தா
Sawaal	சாவால்
Neeraf	நீரஃப்
Hadi	ஹதி
Jacinda	ஜெசிந்தா
Davina	டாவினா
Virender	விரேந்தர்
Sehwag	சேவாக்
Isi	இசி
Ka	கா
Naam	நாம்
Duniya	துனியா
Hai	ஹை
Subaru	ஸுபாரு
Prize	ப்ரைஸ்
for	ஃபார்
Literature	லிட்ரேச்சர்
Musta'eenah	முஸ்தாயீனா
Nickel	நிக்கல்
Archon	அர்சான்
Rodd	ராட்
Matilde	மட்டில்டே
Kargam	கர்காம்
Pratigya	பிராதிக்யா
Key	கீ
Tower	டவர்
Graphite	க்ராஃபைட்
India	இந்தியா
Ashley	ஆஷ்லி
Mallett	மால்லெட்
Albeli	அல்பேலி
Ronia	ரோனியா
Juthamah	ஜுதாமா
Dayita	தயிதா
Andreas	ஆன்டிரியாஸ்
Alboran	அல்போரன்
University	யூனிவர்சிட்டி
of	ஆஃப்
Salford	சல்ஃபோர்ட்
Santa	சான்டா
Lucia	லூசியா
Vajhe	வாஜ்ஹே
Siddhamalli	சித்தாமல்லி
Reservoir	ரிசர்வாயர்
Woorkeri	வூர்கெரி
Raman	ராமன்
South	சௌத்
Ind	இந்தியன்
Bk	பேங்க்
Mu'awiyah	முவாவியா
Dauram	தௌரம்
Madhpura	மத்பூரா
Carissa	காரிஸா
Baari	பாரி
Juliet	ஜூலியட்
Asahi	அசாஹி
Neagle	நியாகில்
Mashooqa	மாஷூகா
Lakshmibanta	லக்ஷ்மிபந்தா
Garcha	கார்ச்சா
Alpha	ஆல்ஃபா
Matriculation	மெட்ரிகுலேஷன்
Higher	ஹையர்
Secondary	செகண்டரி
School,	ஸ்கூல்,
Chennai	சென்னை
Babooji	பாபூஜி
Usamah	உசாமா
Bindusar	பிந்துசர்
Chopan	சோப்பன்
Kratz	கிராட்ஸ்
Bajwa	பாஜ்வா
Kasal	கசல்
Anandamayee	ஆனந்தமாயீ
Barasat	பாராசாட்
Consolidated	கன்சாலிடேட்டட்
Water	வாட்டர்
Linganamakki	லின்கனமக்கி
Dam	டேம்
Basti	பஸ்தி
Ibrahim	இப்ராஹிம்
Sachai	ஸசாயி
Ki	கி
Taqat	தாகாத்
Saymukta	சய்முக்தா
karnataka	கர்னாட்டக்கா
Champabati	சம்பாபாதி
Basta	பாஸ்டா
Silas	சிலாஸ்
Scotia	ஸ்கோதியா
Plaza	பிளாஸா
Progressive	புரோகிரெஸிவ்
Baptist	பேப்டிஸ்ட்
Vivekaa	விவேகா
Ferrol	ஃபெரோல்
David	டேவிட்
Heyn	ஹெய்ன்
Rochak	ரோசக்
Gurudwara	குருத்வாரா
Tahliana	டஹ்லியானா
Sahib	சாஹிப்
Mahavira	மஹாவீரா
Cactoctin	காக்டோக்டின்
Fort	ஃப்போர்ட்
worden	வோர்டென்
Sati	சதி
Pariksha	பரிக்ஷா
Ek	ஏக்
Bechara	பேச்சரா
Vaibhav	வைபவ்
Order	ஆர்டர்
of	ஆஃப்
Zhoukov	ஸுவோகோவ்
Shekel	ஷேக்கல்
Jacques	ஜாக்ஸ்
Kallis	காலிஸ்
Quintin	குன்டின்
Jalsa	ஜல்சா
Gurudwara	குருத்வாரா
Fatihgarh	ஃபதீகர்
Sahib	சாஹிப்
Dahleez	தஹ்லீஸ்
Motor	மோட்டார்
cycling	சைக்கிளிங்
Daliya	டாலியா
Altaaf	அல்டாஃப்
Turley	டர்லே
Omari	ஒமாரி
Banks	பேங்க்ஸ்
Baap	பாப்
Beti	பெடி
Budalur	புடால்பூர்
Nigel	நிகெல்
Sulwyn	சுல்வின்
Hubaab	ஹுபாப்
Anokhi	அன்கி
Ada	அடா
Dalila	டலிலா
Arishtahan	அரிஷ்டாஹான்
Mike	மைக்
Whitney	விட்னி
Prateek	ப்ரதீக்
Dhatri	தத்ரி
Hoad	ஹோட்
Precision	பிரெசிஷன்
Valley	வாலி
Corvette	கார்வெட்
Museum	மியூஸியம்
War	வார்
of	ஆப்
the	த
Second	செக்கண்ட்
Coalition	கோயாலிஷன்
Altessa	அல்டெஸ்ஸா
La	லா
Trobe	ட்ரோப்
University	யூனிவர்சிட்டி
Azraqee	அஸ்ராக்கி
Robert	ராபர்ட்
Wagner	வாக்னர்
Viadhar	வியாதர்
Teri	தேரி
Kasam	கஸம்
Kddi	கட்டி
Nivedita	நிவேதிதா
Nishani	நிஷானி
Ray	ரே
Bright	பிரைட்
Ansoo	அன்சூ
Ban	பன்
Gaye	கயே
Phool	பூல்
Paley	பாலே
Khan	காந-
Vembakottai	வெம்பகோட்டை
Reservoir	ரிசர்வாயர்
Dumraon	தும்ராவுன்
Chawapall	சவாபால்
Nebraska	நெபிராஸ்கா
Ethan	ஏதன்
Allen	அல்லன்
Homestead	ஹோம்ஸ்டெட்
Museum	மியூஸியம்
Compass	காம்பஸ்
Group	குரூப்
Shah	ஷா
E	இ
Iran	ஈரான்
Janelle	ஜனேல்
Limaye	லிமாயே
Mike	மைக்
Powell	போவெல்
Angaarey	அங்காரே
Andy	ஆன்டி
Lloyd	லாய்ட்
Zion	ஸியோன்
United	யுனைடெட்
Bahubali	பாஹுபாலி
Paise	பைசெ
Ki	கி
Gudiya	குடியா
Amitabh	அமிதாப்
Hindah	ஹிந்தா
Pulwama	புல்வாமா
Sinan	சினன்
Aaj	ஆஜ்
Ki	கி
Duniya	துனியா
Sinai	சினாய்
Hydrogenics	ஹைடிரோஜீனிக்ஸ்
Corporation	கார்ப்பரேஷன்
Raja	ராஜா
Gopichand	கோபிசந்த்
Chilo	சிலோ
Hopwood	ஹாப்வுட்
Award	அவார்ட்
Moore	மூர்
Reno	ரேனோ
Big	பிக்
apple	ஆப்பிள்
Balram	பல்ராம்
Banff	பான்ஃப்
Roza	ரோஸா
Natco	நேட்கோ
Pharma	ஃபார்மா
Bindiya	பிந்தியா
Aur	ஔர்
Bandook	பேண்டூக்
Bijoor	பிஜூர்
Mahijuba	மஹிஜுபா
Evelien	இவ்லியன்
Tum	தும்
Par	பர்
Hum	ஹம்
Quarban	குர்பன்
Bhalerao	பலேராவ்
Museum	மியூஸியம்
of	ஆஃப்
Cretan	கிரெட்டன்
Ethnology	எத்னாலஜி
Julius	ஜூலியஸ்
Cognos	கோக்னாஸ்
Incorporated	இன்கார்பரேடட்
Shaitan	ஷைத்தான்
Ka	கா
Pash	பாஷ்
Agaton	அகாடன்
fort	ஃப்போர்ட்
Amala	அமலா
Orrick	ஓரிக்
Ariadnah	அரியட்னா
Abhichandr	அபிசந்தர்
Mera	மேரா
Naseeb	நஸீப்
Ernest	எர்னஸ்ட்
Hemingway	ஹெமிங்வே
Satish	சதிஷ்
Gujral	குஜ்ரால்
Deen	தீன்
Aur	ஔர்
Iman	இமான்
Bhilad	பிலாத்
Samarth	சமர்த்
Farmaish	ஃபர்மாயிஷ்
Nottingham	நாட்டிங்கம்
East	ஈஸ்ட்
Midlands	மிட்லேண்ட்ஸ்
Bandhu	பந்து
Maar	மார்
Dhaad	தாத்
Rinella	ரினெல்லா
battery	பேட்டரி
Ghunayn	குனய்ன்
Matt	மாட்
Horne	ஹார்ன்
Fort	ஃப்போர்ட்
carroll	கேரோல்
GAIL	ஜிஏஐஎல்
Disha	திஷா
Jaclyn	ஜாக்லின்
Elders	எல்டர்ஸ்
Fort	ஃப்போர்ட்
aan	ஆன்
de	டி
klop	க்ளாப்
Hasmukh	ஹஸ்முக்
Anadoluhisar	அனாடொலுஹிசார்
fort	ஃப்போர்ட்
Gufic	கூஃபிக்
Bio	பயோ
BiJunctionor	பிஜங்ஷனோர்
Hindustan	ஹிந்துஸ்தான்
Motors	மோட்டார்ஸ்
Kotnis	கோத்னிஸ்
Yogen_dar	யோகேந்தர்
Bhabhar	பாப்பார்
Questa	குவெஸ்டா
Phaedra	ஃபேத்ரா
Do	தோ
Badan	பாதன்
Mansurah	மன்சூரா
Abdul	அப்துல்
wadood	வாதூத்
Dhirera	திரேரா
Kochhad	கோச்சாத்
Edalene	எட்டாலீன்
Sati	சதி
Vaishalini	வைஷாலினி
Sati	சதி
Renuka	ரேனுகா
Nari	நரி
Raaj	ராஜ்
Ricardo	ரிக்கார்டோ
Powell	பாவெல்
Mascon	மாஸ்கான்
Global	க்ளோபல்
Indra	இந்திர
Leela	லீலா
Aarif	ஆரிஃப்
Sampatti	சம்பதி
Richapaal	ரிச்சாபால்
Shivangi	ஷிவங்கி
Mitten	மிட்டன்
Cognizant	கோக்னிசன்ட்
McCawley	மெக்காலே
Yugoslavia	ஸாம்பியா
Jhabal	ஜாபால்
Matsya	மாத்ஸ்யா
Gandha	காந்தா
Maputo	மபுடோ
Jism	ஜிஸம்
Ka	கா
Rishtaa	ரிஷ்டா
Darabaar	தர்பார்
Daurala	தௌராலா
Ghusun	குசுன்
Fateh	ஃபதேஹ்
Carpathian	கார்பாதியன்
Kota	கோட்டா
Venus	வீனஸ்
King	கிங்
Of	ஆஃப்
Carnival	கார்னிவல்
Jason	ஜேஸன்
Aatik	ஆதிக்
Conroy	கோராய்
Mawahib	மஹாவிப்
Sadhna	சாத்னா
Bleach	பிளீச்
Samudragupta	சமுத்ரகுப்தா
Ruchi	ருச்சி
Soya	சோயா
Manzil	மன்ஸில்
Manzil	மன்ஸில்
Bade	படே
Bhaiya	பைய்யா
Aage	ஆகே
Ki	கி
Soch	சோச்
Naitonal	நேஷனல்
Grid	கிரிட்
Tansco	டான்ஸ்கோ
Leanne	லியன்
Fort	ஃப்போர்ட்
widley	விட்லே
British	ப்ரிட்டிஷ்
Book	புக்
Awards	அவார்ட்ஸ்
Mithilesh	மிதில்
Willie	வில்லி
Brown	பிரவுன்
Keefe	கீஃப்
Sathanur	சாத்தனூர்
Reservoir	ரிசர்வாயர்
Munkadir	முன்காதிர்
Madine	மதினெ
Ki	கி
Galiyan	காலியான்
Lovie	லோவி
Pathak	பதக்
Pooja	பூஜா
Ke	கே
Phool	ஃப்பூள்
Prabhmeet	ப்ரப்மீத்
Chitrakot	சித்ரகோட்
Pratul	ப்ரதுல்
Anglo-French	ஆங்கிளோ-ஃப்பிரெஞ்சு
War	வார்
Fayruz	ஃபேரஸ்
Kanoon	கானூன்
Ki	கி
Awaaz	ஆவாஸ்
Ratnaparkhi	ரத்னாபர்கி
Renault	ரினால்ட்
Edgar	எட்கர்
Casey	கேஸி
Ujas	உஜாஸ்
Hameed	ஹமீத்
Madliena	மாட்லியேனா
tower	டவர்
fort	ஃப்போர்ட்
Raamaveer	ராமவீர்
Bornhem	பார்ன்ஹெம்
fort	ஃப்போர்ட்
Giran	கிரன்
Wellington	வெல்லிங்டன்
Supaul	சுபால்
Giraj	கிரஜ்
Dharmabad	தர்மாபாத்
Fort	ஃப்போர்ட்
stark	ஸ்டார்க்
Rutgers	ரட்கர்ஸ்
Kaustav	கெளஸ்தவ்
Rapughan	ரபுகன்
Amar	அமர்
Shaheed	ஷஹீத்
Ek	ஏக்
Baar	பார்
Phir	பிர்
Batala	பட்டாலா
Junction	ஜங்ஷன்
Damascus	டமஸ்கஸ்
Abhinath	அபினாத்
Lokapaal	லோக்பால்
Jo	ஜோ
Angel	ஏஞ்சல்
Sati	சதி
Nagkanaya	நாக்கனாயா
Aadmi	ஆத்மி
Sadak	சதக்
Ka	கா
Ros	ரோஸ்
Cordelia	கார்டெலியா
Dazai	தசாய்
Osamu	ஒசாமு
Prize	ப்ரைஸ்
Gajare	கஜாரே
Agni	அக்னி
Sakshi	சாக்ஷி
Ishtiyaq	இஷ்தியாக்
Gurbhagat	குர்பாகாத்
Salima	சலிமா
Salila	சலிலா
Vikram	விக்ரம்
Vetal	வேதாள்
Randall	ராண்டல்
Yameen	யமீன்
Humare	ஹமாரே
Tumhare	துமாரே
Lataaparn	லதாபர்ன்
Vijay	விஜய்
Bharadwaj	பரத்வாஜ்
Madra	மத்ரா
Frank	ஃப்ராங்க்
Loyad	லோயாத்
Right	ரைட்
Cindy	சிண்டி
Hindustan	ஹிந்துஸ்தான்
Hamara	ஹமாரா
Samita	சமிதா
Karamgati	கரம்கடி
Louie	லுயி
Shankar	ஷங்கர்
Khan	கான்
Kevin	கெவின்
Costner	காஸ்ட்னர்
Ashokaari	அஷோகாரி
Wade	வேட்
Seccombe	செக்கோம்ப்
Kajwadkar	கஜ்வாத்கர்
Lorelei	லோரிலி
Dhriti	த்ரித்தி
Order	ஆர்டர்
of	ஆஃப்
Courage	கரேஜ்
James	ஜேம்ஸ்
Hopes	ஹோப்ஸ்
Anura	அனுரா
Tennekoon	டென்னிகூன்
Urmila	ஊர்மிளா
McDougal	மெக்டோகல்
Pal	பால்
Do	தோ
Pal	பால்
Ka	கா
Sath	ஸாத்
Shamisen	ஷமிசென்
Jumanah	ஜுமனா
Shree	ஸ்ரீ
Ram	ராம்
Avtar	அவ்தார்
Prashant	பிரஷாந்த்
Morocco	மொரோக்கோ
Craig	கிரேய்க்
Cumming	கம்மிங்
Nagar	நாகர்
Ardara	அர்தாரா
Orange	ஆரஞ்ச்
Prize	ப்ரைஸ்
for	ஃபார்
Fiction	ஃபிக்‌ஷன்
Melvina	மெல்வினா
Annice	அனைஸ்
Race	ரேஸ்
Kahani	கஹானி
Ek	ஏக்
Chor	சோர்
Ki	கி
Rafe	ரஃபே
War	வார்
of	ஆப்
Jenkins'	ஜென்கின்ஸ்
Ear	இயர்
Insaaf	இன்சாஃப்
Ki	கி
Pukar	புகார்
Philomena	ஃபிலோமினா
Bageshwar	பாகேஷ்வர்
John	ஜான்
Tash	டாஷ்
Intel	இன்டெல்
Faoud	ஃபவுத்
Bacchus	பாக்கஸ்
Prem	பிரேம்
Sangeet	சங்கீத்
Maati	மாட்டி
Balidan	பாலிதன்
Ki	கி
Neeta	நீதா
Amerada	அமெராதா
Hess	ஹெஸ்
Wajid	வாஜித்
Nasim	நஸீம்
San	சன்
Pablo	பாப்லோ
Bay	பே
Yadu	யது
Gaddar	கத்தார்
Siddhi	சித்தி
Osaka	ஒசாகா
World	வேர்ல்ட்
Trade	டிரேட்
Center	சென்டர்
Do	தோ
Musafir	முசாஃபிர்
Mahaabodhi	மஹாபூதி
Doda	டோடா
Agartala	அகர்டாலா
Tiple	டிபில்
Mazda	மாஸ்த
Motor	மோட்டார்
Ranjini	ரஞ்சனி
Hawalat	ஹவாலத்
Massimo	மஸ்ஸிமோ
Gopa	கோபா
Deepak	தீபக்
Fert	ஃபெர்ட்
Gora	கோரா
Mark	மார்க்
Alleyne	அலேன்
Kaanchanee	கான்சனீ
Khalda	கால்டா
Poland	போலாந்து
Thomas	தாமஸ்
Paine	பேய்ன்
Fort	ஃப்போர்ட்
gorges	ஜார்ஜஸ்
Sajjad	சஜ்ஜத்
Akbar	அக்பர்
Pankaj	பங்கஜ்
Dharmani	தர்மானி
Suhayr	சுஹயிர்
River	ரிவர்
of	ஆப்
Life	லைப்
Family	பேமிலி
Gharwali	கர்வாலி
Baharwali	பஹர்வாலி
Waste	வேஸ்ட்
Management	மேனேஜ்மெண்ட்
Geraint	ஜெரைண்ட்
Jones	ஜோன்ஸ்
Macedonian	மாக்சீடோனியன்
Museum	மியூஸியம்
of	ஆஃப்
Contemporary	கான்டெம்போரரி
Art	ஆர்ட்
of	ஆஃப்
Thessaloniki	தெஸ்ஸாலோனிகி
Meghachand	மேகசந்த்
Zindagani	ஸிந்தகானி
Vaagdevee	வாக்தேவீ
Strom	ஸ்டிரோம்
Order	ஆர்டர்
of	ஆஃப்
Vytis	வைடிஸ்
Financial	ஃப்பினான்ஷியல்
express	எக்ஸ்பிரஸ்
Boliviano	போலிவியானோ
Freestone	ஃப்ரீஸ்டோன்
Mahaaraajaa	மஹாராஜா
Naag	நாக்
Nagin	நாகின்
Sudakshima	சுதக்ஷிமா
Ruwayfi	ருவாய்ஃபி
Kiley	கிலே
Maayaaraam	மாயாராம்
Gualtier	கெளல்ஷியர்
Baaran	பாரன்
Kudrat	குத்ராத்
Ka	கா
Kanoon	கானூன்
Afif	அஃபீஃப்
Great	கிரேட்
Show	ஷோ
Of	ஆஃப்
India	இந்தியா
Maili	மயிலி
Bhildi	பில்டி
Jeene	ஜீனே
Ki	கி
Raah	ராஹ்
Red	ரெட்
Signal	சிக்னல்
Apradhi	அப்ராதி
Sharmeeli	ஷர்மீலி
Willingdon	வில்லிங்டன்
Reservoir	ரிசர்வாயர்
Saranya	சரண்யா
Magic	மேஜிக்
Johnson	ஜான்சன்
Aloarakh	அலோராக்
Kapish	கபிஷ்
Aaina	ஆய்னா
Basketball	பேஸ்கட்பால்
Hall	ஹால்
of	ஆஃப்
Fame	ஃபேம்
Sofon	சோஃபோன்
Suphapong	சுஃபாபோங்
Elkhart	எல்கார்ட்
Aag	ஆக்
Ka	கா
Gola	கோலா
Shaddi	ஷாத்தி
Ka	கா
Mamla	மாம்லா
Allan	ஆல்லன்
Border	பார்டர்
World	வோர்ல்ட்
Championships	சாம்பியன்ஷிப்ஸ்
in	இன்
Biathlon	பயாத்லான்
Jeanine	ஜீனைன்
Wimco	விம்கோ
Dappar	தப்பார்
Rapti	ரப்தி
Martyn	மார்டின்
Ball	பால்
Metro	மெட்ரோ
Riddhiman	ரித்திமான்
Bhojo	போஜோ
Naram	நரம்
Garam	கரம்
Talib	தாலிப்
Anuyaayita	அனுயாயிதா
Richard	ரிச்சர்ட்
Webb	வெப்
Ian	இயன்
Bradshaw	ப்ராட்ஷா
Koranne	கோரனே
Aparnesh	அபர்னேஷ்
Mauna	மௌனா
Loa	லோவ
Anthony	ஆண்டனி
Ireland	அயர்லேண்ட்
Jenaya	ஜெனாயா
Siwan	சிவன்
Vidya	வித்யா
Balkrishna	பால்கிருஷ்ணா
Sachdeva	சாச்தேவா
Public	பப்ளிக்
School	ஸ்கூல்
Pitampura	பிதாம்புரா
Ranade	ரனடே
Manjushree	மஞ்சுஸ்ரீ
Ashley	ஆஷ்லி
de	டி
Silva	சில்வா
Biwi	பிவி
Aur	ஔர்
Makan	மக்கன்
Bahaudin	பஹாவுதின்
Bethlehem	பெத்லஹம்
Lutheran	லுதெரன்
Elkhorn	எல்க்ஹார்ன்
Mil	மில்
Gai	கயி
Manzil	மன்ஜில்
Mujhe	முஜே
Thawab	தவாப்
Marwah	மார்வா
Gola	கோலா
Barood	பரூத்
Narayana	நாராயணா
Lav	லாவ்
Kush	குஷ்
Nutzotin	நுட்ஜோடின்
Sahirah	சஹிரா
Eliot	எலியட்
Vasbert	வாஸ்பர்ட்
Drakes	ட்ரேக்ஸ்
Peter	பீட்டர்
Ueberroth	உபேராத்
Steve	ஸ்டீவ்
Federal	ஃபெடரல்
Bank	பேங்க்
Maire	மேரி
Robert	ராபர்ட்
Laughlin	லாஃப்லின்
Duganpur	துகான்பூர்
Kathirah	கதிரா
Aadishvar	ஆதிஷ்வர்
Dhana	தனா
Kherli	கேர்லி
Naman	நமன்
Alice	அலீஸ்
Koro	கொரோ
Abhihit	அபிஹித்
Kannanur	கன்னனூர்
Order	ஆர்டர்
of	ஆஃப்
the	தி
Phoenix	ஃபீனிக்ஸ்
Barrow	பார்ரோ
Szent	ஸ்ஸெண்ட்
Istvan	இஸ்ட்வான்
Mere	மேரெ
Jeevan	ஜூவன்
Saathi	ஸாதி
Danniell	டேனியல்
Bahadur	பஹதூர்
Singh	சிங்
Bade	படே
Ghar	கர்
Ki	கி
Bahu	பாஹு
English	இங்கிலிஷ்
tango	டாங்கோ
Ganesh	கணேஷ்
Jamshedpur	ஜம்ஷெத்பூர்
Pandhari	பண்டரி
Asama	அஸமா
Himalay	ஹிமாலய்
Ki	கி
God	காட்
Mein	மெயின்
Bharath	பரத்
Reddy	ரெட்டி
Amay	அமே
Khurasiya	குராஸியா
Madhunisha	மதுனிஷா
Claudette	கிளாடெட்
Mumin	முமின்
Amritlal	அம்ரித்லால்
nagar	நகர்
Okinoshima	ஓகினோஷிமா
Honey	ஹனி
Dayamayee	தயாமயி
Chris	கிரிஸ்
Tremlett	டிரெம்லெட்
Derek	டெரெக்
Pringle	பிரிஞ்கிள்
Chajli	சஜ்லி
Ansar	அன்ஸார்
Pragun	ப்ரகுன்
Francesco	ஃப்பிரான்செஸ்கோ
Caracciolo	காராகியோலோ
Anand	ஆனந்த்
Bhavan	பவன்
Mick	மைக்
Lewis	லூயிஸ்
Dina	தினா
Nagar	நகர்
Antah	அன்டா
Manamohak	மனாமோஹக்
Garima	காரிமா
Tudd	துத்
Anaum	அனவும்
Greg	கிரெக்
Thomas	தாமஸ்
Dudwindi	துத்விண்டி
University	யூனிவர்சிட்டி
of	ஆஃப்
Miami	மியாமி
Akasha	அகாஷா
Ganapati	கானாபதி
State	ஸ்டேட்
Tower	டவர்
Alameda	அலமேதா
Andrew	ஆன்ட்ரூ
Jones	ஜோன்ஸ்
Yaminee	யாமினீ
Gopal	கோபால்
Sharma	ஷர்மா
Tekli	டேக்லி
Ek	ஏக்
Nari	நாரி
Ek	ஏக்
Brahmachari	பிரம்மச்சாரி
Bob	பாப்
Woolmer	வுல்மெர்
Raven	ரவேன்
The	தி
humber	ஹம்பர்
forts	ஃப்போர்ட்ஸ்
Neera	நீரா
Aur	அவுர்
Nanda	நந்தா
Gary	கேரி
Crocker	க்ராக்கர்
Maulaanaa	மௌலானா
Vairaaj	வைராஜ்
Pathanamthitta	பத்தனம்திட்டா
Abdul	அப்துல்
muhaasin	முஹாசின்
Abdul	அப்துல்
wali	வாலி
ViryaNet	விர்யநெட்
Nafis	நஃபீஸ்
Kalyani	கல்யானி
Malwa	மால்வா
Raaj	ராஜ்
Saat	சாத்
Samunder	சமுந்தர்
Paar	பார்
Nartaki	நர்தாகி
Chitra	சித்ரா
Tamil	தமிழ்
Fox	ஃபாக்ஸ்
Polish-Turkish	போலிஷ்-டர்க்கிஷ்
War	வார்
Rallis	ரேலிஸ்
India	இந்தியா
Nazeer	நஸீர்
Avantikaa	அவன்திக்கா
Shabbeer	ஷப்பீர்
Qaisar	கைஸர்
Feruman	ஃப்பெருமான்
Gummidipundi	கும்மிடிப்பூண்டி
Hopman	ஹாப்மேன்
Cup	கப்
Bhuvaneswari	புவனேஸ்வரி
Hindu	ஹிண்டு
Yudhishthir	யுதிஷ்திர்
Yaagyik	யாக்யிக்
Halwani	ஹல்வானி
Chunneelaal	சுனீலால்
Nayyab	நய்யப்
Pranav	ப்ரனவ்
Mistah	மிஸ்தா
Allahabad	அலஹாபாத்
City	சிட்டி
Punjabi	பஜ்சாபி
Shivakumaar	ஷிவகுமார்
Sindhur	சிந்துர்
Wrestling	ரெஸ்ட்லிங்
Fahmida	ஃபாமிதா
Raajwade	ராஜ்வாதே
Order	ஆர்டர்
of	ஆஃப்
the	தி
Golden	கோல்டன்
Fleece	ஃப்ளீஸ்
Choudhary	செளதரி
Homer	ஹோமர்
Sunandini	சுனந்தினி
Rakhda	ரகதா
Sarwari	சர்வாரி
Andy	ஆண்டி
Blignaut	ப்ளிக்னாட்
University	யுனிவர்சிட்டி
of	ஆஃப்
Aberdeen	அபர்தீன்
Myrilla	மிரில்லா
Kopargaonkar	கோபர்கோன்கர்
Ichha	இச்சா
Gallia	கேலியா
Pujit	புஜித்
Joan	ஜோன்
Baze	பேஸ்
Apache	அபாச்சே
Saint	செயிண்ட்
Louis	லூயிஸ்
Wurttemburg	வுர்ட்டெம்பர்க்
Chittor	சித்தூர்
Vijay	விஜய்
Mranaal	ம்ரனால்
Kapindra	கபீன்தர்
Abdul	அப்துல்
mughaanee	முகானீ
Bhai	பாய்
Jaan	ஜான்
Vinaya	வினயா
Rockingham	ராக்கிங்காம்
Kuvaleshay	குவாலேஷே
James	ஜேம்ஸ்
Kamande	காமான்டெ
Dougal	டாகல்
Kashmira	காஷ்மிரா
Puja	பூஜா
Gurudwara	குருத்வாரா
Thanda	டண்டா
Burj	புர்ஜ்
Anjar	அஞ்சார்
Solange	சோலங்கே
Salaam	சலாம்
Memsaab	மெம்சாப்
Vellari	வெல்லாரி
Hera	ஹீரா
Pheri	பேரி
Pura	புரா
Phiroza	ஃபிரோஸா
Kudremukh	குட்ரிமுக்
Atlas	அட்லஸ்
Copco	காப்கோ
John	ஜான்
Aubuchon	ஆபுச்சோன்
Freedom	ஃப்ரீடம்
Gareth	கேரத்
Breese	ப்ரீஸ்
Sula	சுலா
Daku	தாக்கு
Mansoor	மன்சூர்
Ghorpuri	கோர்பூரி
Phir	பிர்
Janam	ஜனம்
Lenge	லெங்கே
Hum	ஹம்
Castle	கேஸ்டில்
Rock	ராக்
Sonya	சோன்யா
Azmat	அஸ்மத்
Rana	ரானா
Gadra	கட்ரா
Road	ரோட்
Jwar	ஜ்வார்
Bhata	பாதா
Gangaadhar	கங்காதர்
Charita	சரிதா
Bipin	பிபின்
Ruma	ருமா
Paula	பௌலா
New	நியு
Beginnings	பிகினிங்ஸ்
Christian	கிறிஸ்டியன்
Satah	சதஹ்
Se	செ
Uthata	உதாடா
Adami	அதாமி
Punia	புனியா
Aflatoon	அஃப்லதூன்
Amitrasah	அமித்ராசா
Nusa	நுஸா
Christine	கிரிஸ்டின்
Sitka	ஸிட்கா
The	த
Dahesh	டாஹெஷ்
Museum	மியூஸியம்
Babu	பாபு
Jannah	ஜன்னா
Conley	கோன்லி
Shaili	ஷைலி
Bryan	ப்ரையன்
Strang	ஸ்ட்ராங்
Sachin	சச்சின்
Tendulkar	டெண்டுல்கர்
Capital	கேபிடல்
Tower	டவர்
Ayatollah	அயாதோலா
Khomeini	கொமெய்னி
Fort	ஃப்போர்ட்
victoria	விக்டோரியா
Jagadanbaa	ஜகதான்பா
Fort	ஃப்போர்ட்
ethan	எதன்
allen	ஆல்லன்
Prem	பிரேம்
Pujari	புஜாரி
Katelin	கேட்லின்
Landguard	லேண்ட்கார்ட்
fort	ஃப்போர்ட்
Kennice	கென்னிஸ்
Afra	அஃப்ரா
Oceana	ஓஷியானா
Danapur	தானாபூர்
Margo	மார்கோ
Caribe	காரிப்
Ramdoot	ராம்தூத்
Viviana	விவியன்னா
Borivali	போரிவாலி
Anumati	அனுமதி
Kutte	குட்டெ
Ki	கி
Kahani	கஹானி
Rakesh	ராகேஷ்
Jajj	ஜாஜ்
Ek	ஏக்
Paheli	பஹேலி
Abdus	அப்துஸ்
sami	சமி
Nibodh	நிபோத்
Rahila	ரஹிலா
The	த
British	பிரிட்டிஷ்
School,	ஸ்கூல்,
New	நியூ
Delhi	டெல்லி
Lethia	லெதியா
Nripesh	ந்ரிபேஷ்
Akalmand	அகல்மந்த்
Jungle	ஜங்கிள்
King	கிங்
Bholi	போலி
Nan	நன்
Rahat	ரஹத்
Swaraj	ஸ்வராஜ்
Engines	இன்ஜின்ஸ்
Mangla	மங்கல
Gauri	கௌரி
Anisur	அனிசுர்
Rahman	ரஹ்மான்
Meri	மேரி
Bhool	பூள்
Rijuta	ரிஜ்ஜூதா
Radium	ரேடியம்
Dujanah	டுஜானா
Jogging	ஜாக்கிங்
Haytham	ஹய்தம்
Zaporizhian	ஸாபோரிஸியான்
sich	ஸிச்
Chars	சார்ஸ்
Yusra	யுஸ்ரா
Khamosh	காமோஷ்
Sipahi	சிபாஹி
Mudra	முத்ரா
Prasad	பிரசாத்
Timila	திமிலா
Aag	ஆக்
Aur	அவுர்
Shola	ஷோலா
Laheri	லஹெரி
Lala	லாலா
Osaka	ஒசாக்கா
Burmah	பர்மா
Road	ரோட்
George	ஜார்ஜ்
Lucas	லூகாஸ்
Keoladeo	கியோலாடியோ
Ghana	கானா
Anbar	அன்பர்
Eltek	எல்டெக்
Akhtiyar	அக்தியர்
Carmel	கார்மெல்
Convent	கான்வெண்ட்
School,	ஸ்கூல்,
Chandigarh	சண்டிகர்
Jainarayan	ஜெய்நாராயண்
Danske	டான்ஸ்கே
Bank	பேங்க்
Group	குரூப்
Malaga	மலாகா
Ipsa	இப்ஸா
Abdul	அப்துல்
gaffar	காஃபார்
Abdur	அப்துர்
Razzak	ராஸ்ஸாக்
Rayban	ரேபேன்
Sun	சன்
Madurai	மதுரை
Kuhada	குஹாதா
Chanda	சந்தா
Fort	ஃபோர்ட்
Makhdoom	மாக்தூம்
Yahya	யாஹ்யா
Maneri	மனெரி
Carl	கார்ல்
Cachopa	காச்சோபா
Gujarati	குஜ்ராத்தி
hora	ஹோரா
Dauphin	டாப்பின்
Ranesh	ரனேஷ்
Jura	ஜூரா
Annigeri	அன்னிகேரி
Randhir	ரந்திர்
Singh	சிங்
Mahaavat	மஹாவத்
Anandi	ஆனந்தி
Wacoal	வாகோல்
Holdings	ஹோல்டிங்க்ஸ்
Corporation	கார்ப்பரேஷன்
Brandenburg	பிரான்டென்பர்க்
Audrey	ஆத்ரே
Raja	ராஜா
Rani	ராணி
Gaetane	கேதானெ
Amrataa	அம்ராதா
Himalay	ஹிமாலய்
Ki	கி
Beti	பேட்டி
Gurudwara	குருத்வாரா
Doot-talai	தூத்தலாய்
Ramesh	ரமேஷ்
Richard	ரிச்சர்ட்
Austin	ஆஸ்டின்
Manager	மானேஜர்
Bahhath	பஹ்ஹத்
Carl	கார்ல்
Tuckett	டக்கெட்
Ian	ஐயன்
Smith	ஸ்மித்
Galaxidi	காலாக்ஸிடி
Maritime	மேரிடைம்
Museum	மியூஸியம்
Lamya	லம்யா
Balaghat	பாலாகாட்
Das	டாஸ்
Subarna	சுபர்னா
Kiana	கியானா
Anitej	அனிதேஜ்
Advaakee	அத்வாகீ
Prakash	பிரகாஷ்
Electricite	எலக்டிரிசிட்டி
De	டி
France	ஃபிரான்ஸ்
Diyodar	தியோதர்
Hua	ஹுவா
Savera	சவேரா
Ali	அலி
Shah	ஷா
Fort	ஃப்போர்ட்
crown	கிரவுன்
point	பாயிண்ட்
Fort	ஃப்போர்ட்
oswego	ஆஸ்வேகோ
Jalan	ஜலன்
Singla	சிங்லா
Sharifah	ஷரீஃபா
Fuad	ஃபாட்
Mandir	மன்திர்
London	லண்டன்
Gatwick	காட்விக்
Kayo	கயோ
Chirag	சிராக்
Jwaharlal	ஜவஹர்லால்
nehru	நேரு
University	யூனிவர்சிட்டி
india	இந்தியா
Qaysar	கேஸர்
Apurv	அபூர்வ்
Laboni	லபோனி
Abdul	அப்துல்
hadi	ஹாதி
Sinharaja	சின்னராஜா
Forest	ஃபாரஸ்ட்
Reserve	ரிசர்வ்
Augustus	அகஸ்டஸ்
Abdul	அப்துல்
tawwaab	தாவ்வாப்
Nordea	நார்டியா
Bank	பேங்க்
Elden	எல்டென்
Desmond	டெஸ்மண்ட்
Haynes	ஹெய்ன்ஸ்
Dalpatpur	தல்பத்பூர்
Dadahur	டாடாஹுர்
Star	ஸ்டார்
of	ஆஃப்
mysore	மைசூர்
Emerald	எமெரால்ட்
Bible	பைபிள்
Novamerican	நோவாமெரிக்கன்
Steel	ஸ்டீல்
Prabhrup	பிரப்ரூப்
Rituparan	ரிதுபாரன்
Poornayogee	பூர்ணயோகி
Avi	அவி
Vipasha	விபாஷா
Aberdeen	அபெர்டீன்
Bachhrawan	பச்ராவன்
Ram	ராம்
Teri	தேரி
Ganga	கங்கா
Maili	மைலி
Justin	ஜஸ்டின்
Langer	லாங்கெர்
Bahiru	பாஹிரு
Idd	ஈத்
Mubarak	முபாரக்
Fort	ஃப்போர்ட்
townsend	டவுன்சென்ட்
Gurudwara	குருத்வாரா
Chubachha	சுபச்சா
Sahib	சாஹிப்
Palace	பேலஸ்
Museum	மியூஸியம்
Khoon	கூன்
Kharaba	கராபா
Kahani	கஹானி
Hum	ஹம்
Sab	சாப்
Ki	கி
Gulzarbagh	குல்ஜர்பாக்
Ian	இயன்
Bishop	பிஷப்
Hambada	ஹம்பாதா
Mizmar	மிஜ்மார்
Varthamanam	வர்த்தமானம்
Fort	ஃப்போர்ட்
de	டி
russy	ருஸ்ஸி
Arivumani	அரிவுமனி
Shaw	ஷா
Prize	ப்ரைஸ்
Ram	ராம்
Kasam	காஸம்
Ethnographical	எத்னோகிராப்பிக்கல்
Historical	ஹிஸ்டாரிக்கல்
Museum	மியூஸியம்
of	ஆஃப்
Larissa	லாரிஸ்ஸா
Geometric	ஜியாமெட்ரிக்
Software	சாஃப்ட்வேர்
Solutions	சொல்யூஷன்ஸ்
Lambeth	லம்பெத்
walk	வாக்
Hafsah	ஹஃப்ஸா
Bharatkund	பாரத்குந்த்
Maltese	மால்டெஸ்ஸே
Shatrudaman	ஷத்ருதமன்
Thabit	தாபித்
Guadeloupe	குவாடெலோப்
Dadri	தாத்ரி
Gadulka	கடுல்கா
Medal	மெடல்
of	ஆஃப்
Valour	வேலர்
Dharmpal	தரம்பால்
Mohammad	மொஹ்ஹம்மத்
Zahid	ஜாஹித்
Nebula	நெபுலா
Jerauld	ஜெரால்ட்
Bishr	பிஷ்ர்
al-Hafi	அல்-ஹாஃப்பி
Chitt	சித்
Mehtab	மேஹ்தாப்
Chhina	சின்னா
Allahabad	அலஹாபாத்
Fort	ஃப்போர்ட்
independence	இன்டிபென்டென்ஸ்
Kishori	கிஷோரி
Anurag	அனுராக்
Ladies	லேடீஸ்
Tailor	டெய்லர்
Faulad	ஃபௌலத்
Abdul	அப்துல்
nafi	நாஃபி
Iago	ஐகோ
Faseeh	ஃபஸீஹ்
Greg	கிரெக்
Ritchie	ரிட்ச்சீ
Metallophone	மெடல்லோஃபோன்
Gary	கேரி
Kirsten	கிர்ஸ்டன்
Shamir	ஷமிர்
Optical	ஆப்டிக்கல்
Industry	இண்டஸ்டிரி
Ardh	அர்த்
Satya	சத்யா
Turner	டர்னர்
Prize	ப்ரைஸ்
Barkandi	பர்கன்டி
Pramilaa	பிரமிளா
Chunar	சுனார்
Pratibha	பிரதிபா
Helsinki-Vantaa	ஹெல்சின்கி-வன்ட்டா
Raghubir	ரகுபிர்
Masoom	மாஸூம்
Laasya	லாஸ்யா
Abdur	அப்துர்
rahman	ரஹ்மான்
Navratri	நவ்ராத்ரி
Brahma	ப்ரம்மா
Guma	குமா
Faqeeh	ஃபகீஹ்
Soryu	ஸோர்யு
Bahadur	பஹதுர்
Daku	தாகு
kullu	குளு
Dick	டிக்
Clark	க்ளார்க்
Clarissa	கிளாரிஸா
Antarktika	அன்டாக்டிக்கா
Order	ஆர்டர்
of	ஆஃப்
National	நேஷனல்
Security	செக்யூரிட்டி
Merit	மெரிட்
Moterwali	மோடர்வாலி
Rivaaj	ரிவாஜ்
Wamil	வாமில்
Elron	எல்ரான்
Electronic	எலக்டிரானிக்
Industries	இண்டஸ்டிரீஸ்
Madanapaal	மதனபால்
Harachand	ஹரசந்த்
Pearse	பியர்ஸ்
Brossnan	ப்ராஸ்னன்
Mark	மார்க்
Bailey	பைலே
Laksha	லக்ஷா
Songadra	சோங்காத்ரா
Pan	பான்
American	அமெரிக்கன்
Silver	சில்வர்
Murari	முராரி
Veerana	வீரானா
Mayo	மாயோ
Kael	காயேல்
Aphrodite	அப்ரோடைட்
Melissan	மெல்லிசன்
Chhora	சோரா
Chhori	சோரி
Fort	ஃப்போர்ட்
meigs	மேயிக்ஸ்
Maha	மஹா
Shaktimaan	ஷக்திமான்
National	நேஷனல்
Art	ஆர்ட்
Gallery	கேலரி
and	அண்ட்
Alexandros	அலெக்ஸான்டிரோஸ்
Soutzos	செளட்ஸாஸ்
Museum	மியூஸியம்
Priestley	ப்ரீஸ்ட்லி
Medal	மெடல்
Shinda	ஷிந்தா
Bhudev	பூதேவ்
Aapas	ஆபாஸ்
Ki	கி
Baat	பாத்
Ravivanshee	ரவிவன்ஷீ
Door	தூர்
Gagan	ககன்
Ki	கி
Chhaon	சஹோன்
Mein	மெயின்
Ghugus	கூகஸ்
Bhojipura	போஜிபூரா
Junction	ஜங்ஷன்
Christ	கிறிஸ்ட்
the	தி
King	கிங்
Lutheran	லுதெரன்
Aur	ஔர்
Pyar	பியார்
Ho	ஹோ
Gaya	கயா
Everton	எவர்டன்
Mattis	மாட்டிஸ்
Baaz	பாஸ்
Bahadur	பஹதுர்
Alamatti	அலமாட்டி
Dam	டேம்
Atyachar	அத்யசார்
Anoop	அனூப்
Sheroo	ஷெரூ
Kalahandi	கலாஜான்டி
Greg	க்ரெக்
Lamb	லேம்ப்
Wahid	வஹித்
Bahlul	பாஹலுல்
Nihang	நிஹாங்
Sri	ஸ்ரீ
Thendayuthapani	தண்டாயுதபாணி
Tim	டிம்
Allan	ஆலன்
Brunel	ப்ரூனல்
University	யூனிவர்சிட்டி
Narhari	நரஹரி
Mushfiq	முஷ்ஃபிக்
Kyros	கைரோஸ்
Sawa	சவா
Bharat	பாரத்
Ki	கி
Santaan	சந்தான்
Troy	ட்ராய்
Angela	ஏன்ஜெலா
Fort	ஃப்போர்ட்
albert	ஆல்பர்ட்
Bahlol	பஹலோல்
Kanhere	கன்ஹரே
Mutawassit	முதாவாசித்
Mendelevium	மென்டெலேவியம்
Devilal	தேவிலால்
Rianna	ரியன்னா
Farica	ஃபரிகா
Wafadaar	வாஃப்பதார்
Fado	ஃப்பாடோ
Cyril	சிரில்
Jahanara	ஜஹனாரா
Dan	டான்
Quayle	குவாலே
Rangle	ரங்கில்
Gode	கோதே
Hum	ஹம்
Junglee	ஜங்லீ
Hain	ஹெயின்
Egypt	எகிப்து
Taha	தாஹா
Osimam	ஓசிமாம்
Bourdieu	பெளடியூ
okz	ஓக்ஸ்
Ashtputre	அஷ்புத்ரே
East	ஈஸ்ட்
Nimad	நிமாத்
Rasesh	ரஸெஷ்
James	ஜேம்ஸ்
Cagney	கேக்னி
Meenar	மீனார்
Tara	தாரா
Guru	குரு
granth	கிரன்த்
sahib	ஸாஹிப்
Hayaat	ஹயாத்
Alfred	ஆல்ஃபிரட்
Tennison	டென்னிசன்
Ulka	ஊல்கா
Kotla	கோட்லா
Ravindra	ரவிந்திரா
Changqing	சாங்கிங்
World	வேர்ல்ட்
Trade	டிரேட்
Cenre	சென்டர்
Schilde	ஷில்டே
Benedetto	பெனெடெட்டோ
Brin	பிரின்
Harunur	ஹருனுர்
Rashid	ராஷித்
Don	டான்
Anurasiri	அனுராசிரி
Philips	ஃபிலிப்ஸ்
Vala	வலா
Chorvad	சோர்வாட்
Road	ரோட்
Shahriar	ஷாஹ்ரியர்
Nafees	நஃப்பீஸ்
Dakhineswar	தக்கினேஷ்வர்
Suven	சுவென்
Life	லைஃப்
Scie	சைன்ஸ்
Ghuzayyah	குஸாயா
Radiology	ரேடியாலஜி
Naismith	நேஸ்மித்
Award	அவார்ட்
Dubia	துபியா
Halimah	ஹலிமா
Order	ஆர்டர்
of	ஆஃப்
Lenin	லெனின்
Krishna	கிருஷ்ண
ji	ஜி
Taranga	தாரங்கா
Shahidah	ஷாஹிதா
Escorts	எஸ்கார்ட்ஸ்
Horse	ஹார்ஸ்
Riding	ரைடிங்
Sachaai	ஸச்சாயி
Ernesettle	எர்ன்செட்டில்
fort	ஃப்போர்ட்
Mother	மதர்
Theresa	தெரசா
Umm	உம்
kulthum	குல்தும்
Ji	ஜி
Chahta	சாஹ்தா
Hai	ஹை
Wajih	வஜி
Grey	கிரே
art	ஆர்ட்
Gallery	கேலரி
Naya	நயா
Paisa	பைசா
Light	லைட்
House	ஹவுஸ்
Cael	காயேல்
Bhoomi	பூமி
Mukulita	முகுலிதா
Alan	ஆலன்
Connolly	கோனொல்லி
Holmes	ஹோம்ஸ்
Leuseur	லியூஸுர்
Afasana	அஃபஸானா
Chittaprasad	சித்தபிரசாத்
Avaneendra	அவனீன்திரா
Fabrizio	ஃபாப்ரிஸியோ
Godfrey	காடஃப்ரே
Phillips	ஃபிலிப்ப்ஸ்
Ophelia	ஓபீலியா
Chandha	சந்தா
Warren	வாரன்
Bettie	பெட்டி
Sikander	சிக்கந்தர்
Bakht	பக்ட்
Avantika	அவன்திக்கா
Geeta	கீதா
Ki	கி
Saugandh	சௌகந்த்
Chandr	சந்தர்
Dainik	டைனிக்
sonar	சோனார்
cachar	காசார்
Shatayu	ஷதயு
Shivadaan	ஷிவதான்
Bharatmuni	பாரத்முனி
Jett	ஜேட்
Kaga	காகா
Verkhoyansk	வெர்கோயான்ஸ்க்
Satinderpal	சதிந்தர்பால்
Kirsten	கேர்ஸ்டென்
Jeet	ஜீத்
Forbes	போர்ப்ஸ்
Medi-Tech	மெடி-டெக்
Muraaree	முராரி
Kar	கர்
Bhala	பாலா
Badwasi	பாட்வாஸி
Mukhtar	முக்தார்
Iki	ஐகி
Sirius	சிரியஸ்
Xandy	ஜேண்டி
Gauri	கெளரி
Ek	ஏக்
Se	சே
Bhale	பலே
Do	தோ
Rasika	ரசிகா
Bratindra	ப்ரதீந்த்ரா
Wendell	வென்டெல்
Bhusaval	புசாவல்
Junction	ஜங்ஷன்
Birur	பிரூர்
Junction	ஜங்ஷன்
Robinson	ராபின்சன்
Griggs	கிரிக்ஸ்
Municipal	முனிசிப்பல்
Gallery	கேலரி
of	ஆஃப்
Corfu	கார்ஃப்பு
Yudhisthir	யுதிஷ்திர்
Melva	மெல்வா
Shambhavi	ஷாம்பவி
Clive	க்ளைவ்
Rice	ரைஸ்
Abhiram	அபிராம்
Bhutesh	பூதேஷ்
Louanna	லுவானா
Saeed	சயீத்
Bin	பின்
Nasir	நாசிர்
Yuvati	யுவதி
Bilaspur	பிலாஸ்பூர்
Junction	ஜங்ஷன்
Clea	கிளியா
Coca-Cola	கோகா-கோலா
India	இந்தியா
Wafiq	வஃபிக்
Nirvan	நிர்வாண்
World	வோர்ல்ட்
Food	ஃபுட்
Prize	ப்ரைஸ்
Kaysah	கேஸா
Mario	மரியோ
cuomo	குவோமோ
Maa	மா
Kasam	காஸம்
Badla	பாட்லா
Loonga	லூங்கா
Meriel	மேரியல்
Winston	வின்ஸ்டன்
Salwa	சல்வா
Tapati	தபதி
Bhakta	பக்த
Kabir	கபிர்
Shandaar	ஷான்தார்
Peary	பியரி
Trudeau	ட்ரோடியே
Dahana	டஹானா
Parth	பார்த்
Walmiki	வால்மீகி
Matrix	மேட்ரிக்ஸ்
Lab	லேப்
Garnet	கார்னெட்
Lal	லால்
Patthar	பாத்தர்
Twyla	த்வைலா
Parijat	பாரிஜாத்
Gayatri	காய்த்ரி
Bajva	பஜ்வா
Shane	ஷேன்
Warne	வார்ன்
James	ஜேம்ஸ்
Brown	பிரவுன்
Baba	பாபா
Fakruddin	ஃப்பக்ருத்தீன்
Berkelium	பெர்கேலியம்
Bogota	பொகோதோ
Raichur	ரைசூர்
Mahasweta	மஹாஸ்வேதா
Mhatre	மாத்ரே
Amandip	அமன்திப்
Char	சார்
Ankhein	ஆங்கேன்
Colton	கோல்டன்
Humayun	ஹுமாயுன்
Farhat	ஃபர்ஹத்
Guatemala	கடமலா
City	சிட்டி
Kavthekar	கவ்தேகர்
George	ஜார்ஜ்
Carlin	கார்லின்
Gumla	கும்லா
Fresno	ஃப்பிரெஸ்னோ
Art	ஆர்ட்
Museum	மியூஸியம்
Mubeenah	முபீனா
Dubaha	துபாஹா
Rafiqul	ரஃப்பிகுல்
Islam	இஸ்லாம்
Chitrakoot	சித்ராகூட்
Bhore	போர்
Amalia	அமாலியா
Frederica	ஃப்ரெடரிகா
Bhakt	பக்த்
Surdas	சுர்தாஸ்
Vijay	விஜய்
Yadav	யாதவ்
Rianne	ரியன்னா
Gurla	குர்லா
311	311
South	சௌத்
Wacker	வக்கர்
Drive	டிரைவ்
Wal	வால்
Mart	மார்ட்
Stores	ஸ்டோர்ஸ்
Progeon	ப்ரோஜியான்
Camtek	காம்டெக்
Londhe	லோன்தே
Cira	சிரா
Metripolitan	மெட்ரிபோலிட்டன்
Museum	மியூஸியம்
of	ஆஃப்
art	ஆர்ட்
Bhagavaan	பகவான்
Sayyidah	சய்யிதா
Keith	கீத்
Arthurton	ஆர்தர்டன்
Parvatinandan	பார்வதிநந்தன்
Medhekar	மேதேகர்
Betelsmann	பீடெல்ஸ்மன்
Atmaj	அத்மஜ்
Dadi	தாதி
Maa	மா
Pramodya	ப்ரோமோத்யா
Wickramasinghe	விக்ரமசிங்கே
Fallon	ஃபாலன்
Prinzregent	பிரின்ஸ்ரேஜென்ட்
Luitpold	லுயிட்போல்ட்
Earl	ஏர்ல்
Sanjushree	சஞ்சுஸ்ரீ
Caja	காஜா
Kef	கெப்
al	அல்
Kaous	காவோஸ்
Banga	பாங்கா
Arth	அர்த்
Marilu	மேரிலு
Mangu	மங்கு
Dada	தாதா
Okanogan	ஒகனோகன்
Atinderjit	அத்திந்தர்ஜீத்
Tacey	டெஸி
Aachaarysutaa	ஆசார்யாசுதா
Jeevana	ஜீவனா
Mata	மாதா
Medzhybizh	மெட்ஸிபிஸ்
Samrat	சம்ராத்
Iran	இரான்
Ki	கி
Ek	ஏக்
Raat	ராத்
Robert	ராபர்ட்
Atkins	அட்கின்ஸ்
Ajir	அஜிர்
asom	அஸோம்
Simeon	சிமியோன்
Mala	மாலா
Thanjavur	தஞ்சாவூர்
National	நேஷனல்
Public	பப்ளிக்
School	ஸ்கூல்
Otago	ஒடாகோ
University	யூனிவர்சிட்டி
Analiese	அனாலியஸ்
Postman	போஸ்ட் மேன்
Bundi	புன்டி
fort	ஃப்போர்ட்
Hbos	எச்பாஸ்
Aradia	அரடியா
Garry	காரி
David	டேவிட்
Tikolo	டிக்கோலோ
Rangoon	ரங்கூன்
Ahmed	அஹ்மத்
Yesevi	யெஸெவி
Robinson	ராபின்சன்
Christian	கிறிஸ்டியன்
Charl	சார்ல்
Willoughby	வில்லோக்பி
Aakrosh	ஆக்ரோஷ்
Hertog	ஹெர்டாக்
Hendrik	ஹென்ட்ரிக்
Kaalaraatri	காலராத்ரி
Nagarkar	நகர்கர்
Gent	ஜெண்ட்
Soccer	சாக்கர்
Bert	பெர்ட்
Vance	வான்சி
Melina	மெலினா
Sundar	சுந்தர்
Liam	லியம்
Plunkett	பிளன்கெட்
Sahaja	சஹஜா
Dil	தில்
Deke	தேகே
Dekho	தேகோ
Reen	ரீன்
New	நியூ
York	யார்க்
Transit	டிரான்சிட்
Museum	மியூஸியம்
Elda	எல்டா
Bombay	பாம்பே
War	வார்
Mangalagiri	மங்கலகிரி
Viareggio	வியரிகியோ
Prize	ப்ரைஸ்
Salahuddin	ஸாலாஹுத்தின்
Ahmed	அஹ்மத்
Ladke	லாட்கெ
Baap	பாப்
Se	செ
Badh	பாத்
Ke	கெ
University	யூனிவர்சிட்டி
of	அஃப்
Alabama	அலபாமா
Babagon	பாபாகோன்
Dam	டேம்
Tsavo	டிசாவோ
East	ஈஸ்ட்
National	நேஷனல்
High	ஹை
School	ஸ்கூல்
Voltaire	வால்டைய்ர்
Prakasham	பிரகாஷம்
Lisa	லிசா
Marie	மேரி
Presley	ப்ரிஸ்லி
Jackson	ஜாக்சன்
Baghdad	பாக்தாத்
Ka	கா
Jadu	ஜாடு
Sapre	சாப்ரே
Ek	ஏக்
Main	மெயின்
Aur	ஔர்
Ek	ஏக்
Tu	து
University	யூனிவர்சிட்டி
of	ஆஃப்
South	சௌத்
Queensland	குயின்ஸ்லேண்ட்
War	வார்
of	ஆப்
the	த
Reunions	ரீயூனியன்ஸ்
Dulip	துலீப்
Samaraweera	சமரவீரா
Gurudwara	குருத்வாரா
Gowindwal	கோவிந்த்வால்
Sahib	சாஹிப்
Anokhi	அனோகி
Seva	சேவா
Matsushita	மட்சுஷிட்டா
Electric	எலக்டிரிக்
Industrial	இண்டஸ்டிரியல்
Chunauti	சுனௌதி
Guj	குஜ்
NRE	என்ஆர்இ
Coke	கோக்
Queens	குயின்ஸ்
County	கவுன்டி
Farm	ஃப்பார்ம்
Museum	மியூஸியம்
Pyar	பியார்
Mein	மேன்
Sauda	செளதா
Nahin	நஹின்
Somdev	சோம்தேவ்
Banke	பங்கே
Sanwaria	சன்வாரியா
Bolarum	பொலாரம்
Shamel	ஷமெல்
Jewell	ஜுவல்
Gumia	குமியா
Abdul	அப்துல்
muhayameen	முஹயமீன்
Hum	ஹம்
Panch	பஞ்ச்
Chaggan	சாக்கன்
Banshlai	பன்ஷ்லாய்
Bridge	ப்ரிட்ஜ்
Nicky	நிக்கி
Boje	ஹோயே
Raj	ராஜ்
Ramani	ரமனி
Francois	ஃப்ரான்காய்ஸ்
Damaad	தமாத்
Shah	ஷா
E	இ
Misar	மிஸார்
Maribeth	மரிபெத்
Bamanheri	பமன்ஹேரி
Flugelhorn	ஃப்ளியூகல்ஹார்ன்
Cicily	சிஸ்ஸி
Brijesh	பிரிஜேஷ்
Patel	பட்டேல்
Vidyut	வித்யூத்
Vern	வெர்ன்
Adwaakee	அத்வாகீ
Fort	ஃப்போர்ட்
mcandrew	மெக்கான்ட்ரூ
Anglo-Dutch	ஆங்கிளோ-டச்
War	வார்
Trikaya	த்ரிகயா
Sangeet	சங்கீத்
Samrat	சம்ரத்
Tansen	டான்சென்
Serra	செர்ரா
dos	டாஸ்
orgaos	ஆர்காவோஸ்
Samata	சமதா
Deshnok	தேஷ்னோக்
Anoushkaa	அனெளஷ்க்கா
Samara	சமரா
Marchovelette	மார்சோவெலெட்டே
Qareeb	கரீப்
Devon	டெவான்
Malcolm	மால்காம்
Satyam	சத்யம்
Computers	கம்ப்யூட்டர்ஸ்
Meharbaan	மெஹர்பான்
Anil	அனில்
Dalpat	தல்பாத்
Mohinee	மோஹினீ
Adishvar	அதிஷ்வர்
Gurudwara	குருத்வாரா
Mata	மாதா
Kaulan	கௌலான்
ji	ஜீ
Maa	மா
Ka	கா
Pyar	பியார்
Makkaar	மக்கார்
Balkan	பால்கன்
Kirkan	கிர்கான்
Ahsan	அஹ்சான்
Sudipti	சுதிப்தி
Floyd	ஃப்ளாய்ட்
Reifer	ரீஃபர்
Premchand	ப்ரேம்சந்த்
Conan	கோனான்
Gajre	கஜ்ரே
Ambardekar	அம்பர்தேகர்
Ashley	ஆஷ்லி
Noffke	நோஃப்கே
Ana	அனா
Neecha	நீச்சா
Nagar	நகார்
David	டேவிட்
Steele	ஸ்டீல்
Lakde	லக்தே
Mawiyah	மவியா
Sharmistha	ஷர்மிஸ்தா
Arnala	அர்னாலா
fort	ஃப்போர்ட்
Devgam	தேவ்கம்
Gertrude	கெர்ட்ரூட்
University	யூனிவர்சிட்டி
of	ஆஃப்
California	கலிஃபோர்னியா
Sweekar	ஸ்வீகர்
Kiya	கியா
Maine	மைனே
Avanindra	அவனின்திரா
Christianity	கிரிஸ்டியானிட்டி
Jyotsanaa	ஜோத்ஸ்னா
Purity	ப்யூரிட்டி
Akash	ஆகாஷ்
Pari	பாரி
Fateh	ஃபதேஹ்
Singhpura	சிங்க்பூரா
Birmitrapur	பிர்மித்ராபூர்
Sushila	சுஷிலா
Xenia	ஜேனியா
Angooree	அங்கூரீ
Newstime	நியூஸ்டைம்
Stockton	ஸ்டாக்டன்
Aasimah	ஆஸிமா
Fortaleza	ஃப்போர்டாலெஸா
da	டா
guia	கியா
Balawala	பலாவாலா
Lynette	லினெட்
Tilak	திலக்
Chattan	சத்தன்
Singh	சிங்
Atlantic	அட்லான்டிக்
Ocean	ஓஷன்
Dahina	தாஹினா
Zainabad	ஜாய்னாபாத்
Truly	ட்ரூலி
Shree	ஸ்ரீ
Ganesh	கணேஷ்
Vivah	விவாஹ்
Bank	பேங்க்
of	ஆப்
China	சைனா
Ashok	அஷோக்
Mankad	மன்கத்
Museum	மியூஸியம்
of	ஆஃப்
Biblical	பிப்லிக்கல்
art	ஆர்ட்
Pemex	பேமெக்ஸ்
Howard	ஹோவர்ட்
Hughes	ஹக்ஸ்
Fort	ஃப்போர்ட்
york	யார்க்
Raja	ராஜா
Radhika	ராதிகா
Prasad	பிரசாத்
Leelamayee	லீலாமயி
Waris	வாரிஸ்
Sugandh	சுகந்த்
Spyridon	ஸ்பைரிடன்
Gidarpindi	கிதர்பிண்டி
Zakhmi	ஸாக்மி
Dil	தில்
Madeira	மாதேய்ரா
Bhajaraam	பஜராம்
Ena	எனா
Keshini	கேஷினி
Banphool	பன்பூல்
Golaghat	கோலாகாட்
Aahlad	ஆஹ்லாத்
Arnhem	ஆர்ன்ஹெம்
Egg	எஃக்
buckland	பக்லாண்ட்
keep	கீப்
Velankar	வெலன்கர்
Old	ஓல்ட்
roman	ரோமன்
Chelsia	செல்ஸியா
Turco-Persian	டர்கா-பெர்ஷியன்
War	வார்
Milam	மிலம்
Bethany	பெதனி
Baptist	பேப்டிஸ்ட்
Citadelle	சிட்டாடெல்
fort	ஃப்போர்ட்
Ayodhyapati	அயோத்யபதி
Pahu	பாஹு
Malamkar	மலம்கர்
Alec	அலெக்
Stewart	ஸ்டீவர்ட்
Adawi	அடாவி
Roop	ரூப்
Kahani	கஹானி
Mihir	மிஹிர்
Cricket	கிரிக்கெட்
World	வோர்ல்ட்
Cup	கப்
Dhirendra	திரேந்திரா
Main	மேன்
Aur	அவுர்
Mera	மேரா
Bhai	பாய்
Ossama	ஓஸ்ஸாமா
Liverpool	லிவர்பூல்
John	ஜான்
Moores	மூர்ஸ்
University	யூனிவர்சிட்டி
Yamini	யாமினி
Napoli	நாபோலி
Lei	லீ
yue	யு
mun	மன்
fort	ஃப்போர்ட்
Bikhare	பிகாரே
Moti	மோதி
Grishma	கிரிஷ்மா
Bhadraksh	பாத்ராக்ஷ்
Banco	பாங்கோ
Do	டூ
Brasil	பிராஸில்
Agnee	அக்னீ
Omar	ஒமர்
Henry	ஹென்ரி
Viresh	விரேஷ்
Shurahbeel	ஷுராபீல்
Brahmadutt	ப்ரம்மதத்
Tung	துங்
chung	சங்
fort	ஃப்போர்ட்
Aayee	ஆயே
Phir	ஃபிர்
Bahar	பஹார்
Naach	நாச்
Utha	உதா
Sansar	சன்ஸார்
Shatranj	ஷாத்ராஞ்
Chinchalkar	சின்சல்கர்
Mehsaana	மெஹ்சானா
Glasgow	க்ளாஸ்கோ
Caledonian	கலிடோனியன்
University	யூனிவர்சிட்டி
Chandrakant	சந்திரகாந்த்
Pandit	பன்டிட்
Octavio	ஆக்டேவியோ
Profiles	ப்ரொஃபைல்ஸ்
in	இன்
Courage	கரேஜ்
Award	அவார்ட்
Maurice	மௌரிஸ்
Karishma	கரிஷ்மா
Kudrat	குத்ரத்
Ka	கா
Seetaasaran	சியன்னா
Chakori	சக்கோரி
Shyamala	ஷியாமளா
Pucca	பக்கா
Badamash	பாதாமாஷ்
Edger	எட்கர்
allan	ஆலன்
Poe	போப்
Ghatampur	கட்டம்பூர்
Throgs	திராக்ஸ்
Neck	நெக்
Iphigenia	இபிஜீனியா
Fidel	ஃபிடல்
Amy	எம்மி
Nocil	நோசில்
Canadian	கேனடியன்
Imperial	இம்பீரியல்
Bank	பேங்க்
of	ஆப்
Commerce	காமர்ஸ்
Baghpat	பாக்பத்
Ram	ராம்
Avtar	அவ்தார்
Ami	அமி
Arivumadhi	அரிவுமதி
Fineen	ஃபினீன்
Douglas	டக்ளஸ்
Argentina	அர்ஜன்டீனா
Gora	கோரா
Aur	ஔர்
Kala	காலா
Devika	தேவிகா
Darius	டேரியஸ்
Odelia	ஓடிலியா
Fabienne	ஃபாபியானி
Sarasija	சரஸிஜா
Neki	நேகி
Aur	அவுர்
Badi	பதி
Viklaant	விக்லாந்த்
Abdul	அப்துல்
muhasin	முஹசின்
Dainik	டைனிக்
purvoday	புர்வோதே
Boston	பாஸ்டன்
Cajon	காஜன்
Namoona	நமூனா
Malamaal	மாலாமால்
Vaachaa	வாச்சா
Tom	டாம்
Peters	பீட்டர்ஸ்
Gul	குல்
Sanobar	சனோபர்
Tamatha	டமாதா
Orson	ஆர்சன்
Wales	வேல்ஸ்
Narapat	நரபத்
Aurat	ஔரத்
Aurat	ஔரத்
Aurat	ஔரத்
Sitapur	சீதாபூர்
Inderdeep	இந்தர்தீப்
Devendra	தேவேந்திரா
Deen	தீன்
Shrikrushna	ஸ்ரீகிருஷ்ணா
Dean	டீன்
Ahad	அஹாத்
Mairead	மேரியட்
Sandoval	சான்டோவல்
World	வோர்ல்ட்
Figure	ஃபிகர்
skating	ஸ்கேட்டிங்
Champions	சாம்பியன்ஸ்
Woodstock	உட்ஸ்டாக்
Historical	ஹிஸ்டாரிக்கல்
Society	சொசைட்டி
Carla	கார்லா
Harry	ஹாரி
Potter	பாட்டர்
Anchoret	ஆங்கோரெட்
Weymouth	வெய்மவுத்
Laakshaa	லாக்ஷா
Mariel	மேரியல்
Millennium	மில்லினியம்
Technology	டெக்னாலஜி
Prize	ப்ரைஸ்
Imran	இம்ரான்
Nazir	நஸீர்
Raamalaal	ராமலால்
Sun	சன்
Microsystems	மைக்ரோசிஸ்டம்ஸ்
Kausar	கெளஸார்
Pandit	பண்டிட்
Aur	அவுர்
Pathan	பதான்
Oadira	ஒதிரா
Santan	சன்த்தன்
Mahanadi	மஹாநதி
Wilma	வில்மா
Fern	ஃபெர்ன்
Sadyojat	சத்யோஜத்
Husn	ஹஸன்
Ka	கா
Chor	சோர்
Cabo	காபோ
Orange	ஆரஞ்ச்
Dixie	டிக்ஸி
Aasiyah	ஆஸியா
Ronador	ரொனடார்
Zoraster	ஜோரஸ்டர்
Atre	அட்ரீ
Jack	ஜேக்
Heron	ஹெரோன்
Vineeta	வினீதா
Aar	ஆர்
Paar	பார்
Barua	அப்ருஆ
Jhade	ஜாதே
Jaan-E-Bahaar	ஜான்-ஏ-பஹார்
Milonga	மிலோங்கா
Garwah	கார்வா
Abdul	அப்துல்
qadir	காதிர்
Prerna	பிரேமா
Abou	அபூ
Ben	பென்
Adhem	அதெம்
Commerzbank	காமர்ஸ்பேங்க
Zentrale	சென்ட்ரல்
Louis	லூயிஸ்
Armstrong	ஆம்ஸ்ட்ராங்
Ek	ஏக்
Chadar	சதர்
Maili	மயிலி
Si	சி
Iqbal	இக்பால்
Qasim	காஸிம்
Linore	லினோர்
Shrilakshmi	ஸ்ரீலக்ஷ்மி
Chalaak	சாலாக்
Yashodaanandan	யசோதாநந்தன்
pricewaterhouse	பிரைஸ்வாட்டர்ஹவுஸ்
coopers	கூப்பர்ஸ்
Isadora	இசாதோரா
Matwale	மாத்வாலெ
Order	ஆர்டர்
of	ஆஃப்
Smile	ஸ்மைல்
Narendra	நரேந்திரா
Barkha	பர்க்கா
Eithne	ஐத்ன்
Craig	க்ரெய்க்
Wishart	விஷார்ட்
Abhi	அபி
Abhi	அபி
Buxar	புக்ஸார்
Johannesburg	ஜோவன்னஸ்பர்க்
Chakshu	சக்ஷூ
Gariep	கரிப்
Dam	டேம்
Woodrow	வுட்ரூ
Lazar	லாஸர்
Subhaash	சுபாஷ்
Piya	பியா
Ghar	கர்
Aja	அஜா
Cedric	செட்ரிக்
Dabhade	தபதே
Khimsar	கிம்சார்
David	டேவிட்
Smith	ஸ்மித்
Vyomesh	வியோமேஷ்
Rotterdam	ரோட்டர்டாம்
Demeter	டிமீட்டர்
Estelle	எஸ்டெல்
Gaurika	கெளரிக்கா
Pitsberg	பிட்ஸ்பர்க்
Paul	பால்
Simon	சைமன்
Dixmude	டிக்ஸ்முட்
Maysun	மேசன்
John	ஜான்
Traicos	ட்ரெய்காஸ்
Adonis	அடோனிஸ்
Narasimha	நரசிம்மா
Aligarh	அலிகர்
Clarimonde	கிளாரிமாண்ட்
Denesh	தினேஷ்
Ramdin	ராம்தின்
Raisa	ரெய்சா
Gorbachev	கார்பச்சேவ்
Ruggiero	ருஜிரோ
Kumudam	குமுதம்
Schopenhauer	ஷோபென்ஹாயர்
Peter	பீட்டர்
Hell	ஹெல்
Gate	கேட்
RailRoad	ரேயில்ரோட்
Azadeh	அஸாதேஹ்
Geological	ஜியாலாஜிக்கல்
Museum	மியூஸியம்
of	ஆஃப்
china	சைனா
Devasthali	தேவஸ்தலி
Batool	பதூல்
Jai	ஜெய்
Prakash	பிரகாஷ்
Yadav	யாதங்
Lisette	லிசட்
Bheem	பீம்
Paul	பால்
Sheahan	ஷியேஹான்
Grant	கிராண்ட்
Gayatri	காயத்ரி
Mahima	மஹிமா
Nani	நானி
Maa	மா
Govilkar	கோவில்கர்
Bayer	பாயர்
India	இந்தியா
Garran	கார்ரன்
Manzilen	மன்ஸிலென்
Aur	அவுர்
Bhi	பி
Hain	ஹைன்
Albion	அல்பியான்
Abundant	அபண்டண்ட்
Life	லைப்
Christian	கிறிஸ்டியன்
Fellowship	பெல்லோஷிப்
Tanika	தனிகா
Jaydeep	ஜெய்தீப்
Kachchi	கச்சி
Kali	காளி
Susil	சுஷீல்
Fernando	ஃபெர்னாண்டோ
Ratnabali	ரத்னபாலி
Ahaggar	அஹாக்கர்
Malini	மாலினி
Shakun	ஷகுன்
Liers	லையர்ஸ்
Sumitraa	சுமித்ரா
Paavgi	பாவ்கி
Henri	ஹென்ரி
Gary	காரி
Robertson	ராபெர்ட்சன்
Calvine	கால்வின்
Tony	டோனி
Kent	கெண்ட்
Strix	ஸ்ட்ரிக்ஸ்
award	அவார்ட்
Caraf	காராஃப்
Elaine	எலைனி
Gul	குல்
Sanovar	சனோவர்
Chelsea	செல்ஸியா
Saleem	சலீம்
Malik	மாலிக்
I^jeeniyar	இஞ்சீனியர்
Hussain	ஹுசெயின்
Subayah	சுபாயா
Serra	செர்ரா
da	டா
Capivara	கேப்பிவாரா
Nicholas	நிக்கோலஸ்
Pirama	பிரமா
Fort	ஃப்போர்ட்
spion	ஸ்பியான்
Ek	ஏக்
Aur	ஔர்
Khoon	கூன்
Vaakpati	வாக்பதி
Lepanto	லெபான்டோ
Fatwa	ஃபட்வா
Raikoti	ராஜ்கோடி
Phande	பான்தே
Baaz	பாஸ்
Adidas	அடிடாஸ்
Acharya	அசார்யா
Acharyasutaa	ஆசார்யாசுதா
Andhra	ஆந்திரா
Bank	பேங்க்
Wahhaj	வாஜ்
Bhandape	பாந்தபே
Ghodgaonkar	கோத்கோன்கர்
Kitty	கிட்டி
Rashid	ரஷீத்
Latif	லத்தீஃப்
Daren	டேரன்
Ganga	கங்கா
Mike	மைக்
Atherton	அதெர்டன்
Papua	பபுவா
New	நியூ
Guinea	கினியா
Pravesh	பிரவேஷ்
Renee	ரெனீ
Zellweger	ஸெல்வேகர்
Vishaal	விஷால்
Philippine	பிலிப்பைன்
Bank	பேங்க்
of	ஆப்
Communication	கம்யுனிகேஷன்
Sonalee	சோனாலி
Arundhatinaath	அருந்தாதினாத்
Tahina	தஹினா
Tom	டாம்
Hogan	ஹோகன்
Fatinah	ஃபதீனா
Teesri	தீஸ்ரி
Aankh	ஆங்க்
Kirti	கிர்த்தி
Mukarram	முக்காராம்
Livett	லிவெட்
Divaakar	திவாகர்
Muqaddas	முக்காதாஸ்
Maqsad	மக்சாத்
Linda	லிண்டா
Trip	ட்ரிப்
Chadotar	சடோத்தார்
Bhajan	பஜன்
Pitambar	பிதாம்பர்
Bhavna	பாவ்னா
Mangu	மங்கு
Shahjahanpur	ஷாஜாஹான்பூர்
Vanani	வனனி
Laxmi	லக்ஷ்மி
Narayan	நாராயன்
Banamala	பனமாலா
Kitna	கித்னா
Badal	பாதல்
Gaya	காயா
Insan	இன்சான்
Nizam	நிஸாம்
Sagar	சாகர்
Order	ஆர்டர்
of	ஆஃப்
the	தி
Tower	டவர்
and	அண்ட்
Sword	ஸ்வார்ட்
Gurudwara	குருத்வாரா
Tikana	டிகானா
Sahib	சாஹிப்
Diqrah	திக்ரா
Srapanch	ஸ்ரபஞ்ச்
Berlin	பெர்லின்
Agatha	அகாதா
Edith	ஈடித்
Ritadhvaj	ரிதாத்வாஜ்
Uwayam	ஊவாயம்
Ek	ஏக்
Adhuri	அதுரி
Kahani	கஹானி
Chip	சிப்
Charlemagne	சார்லேமாக்னெ
Aakhri	ஆக்ரி
Cheekh	சீக்
Ek	ஏக்
Baar	பார்
Kaho	கஹோ
War	வார்
between	பிட்வீன்
Brandenburg	பிரான்டென்பர்க்
and	அண்ட்
Sweden	ஸ்வீடன்
Garam	கரம்
Masala	மசாலா
Dildaar	தில்தர்
Kinshuk	கின்ஷுக்
Maharaja	மஹாராஜா
Vikram	விக்ரம்
Sau	செள
Saal	ஸால்
Baad	பாத்
Ranbaxy	ரேன்பேக்ஸி
Labs	லேப்ஸ்
Harold	ஹரால்ட்
Morton	மார்ட்டன்
Landon	லேண்டன்
Translation	ட்ரான்ஸ்லேஷன்
Award	அவார்ட்
Fillmore	ஃப்பில்மோர்
Saudaa	செளதா
Kahma	காஹ்மா
Uranium	உரேனியம்
Robert	ராபர்ட்
Fulghum	ஃபல்கம்
Tambora	டம்போரா
Deswal	தேஸ்வல்
Sati	சதி
Madalasa	மடல்ஸா
Devinderpal	தேவிந்தர்பால்
Katyal	காட்யால்
Patthar	பத்தர்
Aur	அவுர்
Payal	பாயல்
Gul	குல்
Bahar	பாஹர்
Meghanaad	மேகானாத்
Ghrishneshwar	கிரினேஷ்வர்
Pamposh	பம்போஷ்
Saffron	சாஃபரான்
Vidhaata	விதாதா
Thorium	தோரியம்
Pyar	பியார்
Ho	ஹோ
Gaya	காயா
Gloria	க்ளோரியா
Steinem	ஸ்டேனம்
Buraj	புராஜ்
Alicia	அலிஷியா
Mohul	மொஹல்
El	எல்
Potosi	பொடோஸி
Lance	லான்ஸ்
Klusener	க்ளூஸ்னர்
Chhapi	சாப்பி
Babul	பாபுல்
Khooni	கூனி
Kaun	கவுன்
Fort	ஃப்போர்ட்
op	ஆப்
de	டி
voordorpsdijk	வூர்டார்ப்ஸ்டிஜ்க்
Chhabi	சாப்பி
Baraigram	பராய்க்ராம்
Junction	ஜங்ஷன்
Winona	வினோனா
Ryder	ரைடர்
Kan_haiyaalaal	கன்ஹையாலால்
Jashn	ஜாஷ்ன்
Azad	ஆஸாத்
Desh	தேஷ்
Ke	கே
Ghulam	குலாம்
Anokha	அனோகா
Pyar	பியார்
Kato	கேட்டோ
Chris	கிரிஸ்
Kuggeleijn	குஜ்ஜெலேஜ்ன்
Chakar	சாகார்
Beijing	பெய்ஜிங்
Matondkar	மதோன்கர்
Yashogaan	யஷோகன்
Baalagopal	பாலகோபால்
Panini	பனினி
Thaqaf	தகாஃப்
Gandhik	காந்திக்
Halal	ஹலால்
Ki	கி
Kamai	கமாய்
Claudio	கிளாவ்டியோ
Ukkusiksalik	உக்குசிக்சாலிக்
Lesley	லெஸ்லி
Enakshi	இனாக்ஷி
Queenie	குயினி
Gaylord	கேலார்ட்
Farrah	ஃபராஹ்
Yojana	யோஜனா
Mahmood	மஹ்மூத்
Hamid	ஹமீத்
Keral	கேரளா
Albury	அல்பரி
Order	ஆர்டர்
of	ஆஃப்
National	நேஷனல்
Establishment	எஸ்டாப்ளிஷ்மெண்ட்
Merit	மெரிட்
Haimavat	ஹைமாவத்
Beena	பீனா
Aatikah	ஆதிகா
Lamar	லமர்
Romesh	ரொமேஷ்
Kaluwitharana	கலுவிதரானா
Abdul	அப்துல்
ali	அலி
Gopi	கோபி
Chand	சந்த்
Chamraura	சம்ரௌரா
Ford	போர்ட்
Motor	மோட்டார்
Tewaaraton	தீவாரத்தன்
Trophy	ட்ராஃபி
Gyula	க்யூலா
Getey	கேட்டி
Eulalie	இயுலலி
Tremain	ட்ரெமெய்ன்
Sheadon	ஷியாடன்
Venecia	வெனிசியா
Central	சென்ட்ரல்
Bank	பேங்க்
Travis	ட்ராவிஸ்
Bitti	பிட்டி
Altai	அல்தாய்
Bakhtiar	பக்தியார்
Tambura	டம்பூரா
Crystal	க்ரிஸ்டல்
Globe	க்ளோப்
Gyaaniji	கியாஞ்சி
SelaQui	செலாகி
World	வோர்ல்ட்
School,	ஸ்கூல்,
Dehradun	டெஹ்ராடூன்
Fort	ஃப்போர்ட்
niagara	நையாகரா
Cha	சா
cha	சா
Paper	பேப்பர்
Products	ப்ராடக்ட்ஸ்
ayyar	அய்யர்
Glenda	கிலென்டா
Khalis	காலிஸ்
Damini	தாமினி
Broechem	பிரோசெம்
fort	ஃப்போர்ட்
Bette	பெட்டே
Davis	டேவிஸ்
Ogle	ஓக்லே
Minhajul	மின்ஹாஜுல்
Abedin	அபேதின்
Lenci	லென்ஸி
Omkar	ஓம்கார்
Gulshan	குல்ஷான்
Shrivalli	ஸ்ரீவள்ளி
Boron	போரான்
Abdul	அப்துல்
Razzaq	ரசாக்
Pico	பீகோ
da	டா
Neblina	நெப்லினா
Do	தோ
Dost	தோஸ்த்
Shokhiyan	ஷோகியான்
Nagendra	நாகேந்த்ரா
Bawoo	பாவூ
Jacques	ஜாக்ஸ்
His	ஹிஸ்
Church	சர்ச்
World	வேர்ல்ட்
Outreach	அவுட்ரீச்
Center	சென்டர்
Bandra	பண்ட்ரா
Terminus	டெர்மினஸ்
Bankimchandra	பங்கிம்சந்திர
Chatarjee	சாட்டர்ஜி
Thetis	தேடிஸ்
Gurudwara	குருத்வாரா
Mata	மாதா
Gujri	குஜ்ரி
ji	ஜீ
Haashim	ஹாஷிம்
Mujhe	முஜே
Kasam	கஸாம்
Hai	ஹை
Gemini	ஜெமினி
Award	அவார்ட்
Mausmi	மௌசமி
Emmly	எம்லி
Simon	சைமன்
Davis	டேவிஸ்
Chalti	சல்தி
Ka	கா
Naam	நாம்
Zindagi	ஜிந்தகி
Graeme	கிராயெம்
Hick	ஹிக்
Sky	ஸ்கை
diving	டைவிங்
Gina	ஜீனா
Aster	அஸ்டர்
Dhola	தோலா
Mazra	மஸ்ரா
Wapusk	வாபுஸ்க்
Girls	கேர்ள்ஸ்
School	ஸ்கூல்
Renville	ரென்வில்லெ
Bhaini	பயினி
Khurd	குர்த்
Ghar	கர்
Ki	கி
Laaj	லாஜ்
Ajantaa	அஜந்தா
Valero	வாலெரோ
Energy	எனர்ஜி
Royal	ராயல்
Alberta	அல்பெர்டா
Museum	மியூஸியம்
Golden	கோல்டன்
Gate	கேட்
Highlands	ஹைலேண்ட்ஸ்
Shaurya	ஷௌர்ய
Chakra	சக்ரா
Amur	அமூர்
Shinano	ஷினானோ
Sant	சன்த்
Raghu	ராகு
Amar	அமர்
Akbar	அக்பர்
Anthony	ஆண்டனி
Raajakumaaree	ராஜகுமாரீ
Amitabh	அமிதாப்
Chaudhari	சௌதாரி
Adele	அடெல்
Anusooya	அனுசூயா
Ret	ரேத்
Mahal	மஹால்
Chaani	ச்சானி
Chakkar	சக்கார்
Pe	பே
Chakkar	சக்கார்
Jawdan	ஜவதான்
Jiyo	ஜியோ
Aur	ஔர்
Jeene	ஜீனே
Do	தோ
Desdemona	டெஸ்டேமோனா
Hindustan	ஹிந்துஸ்தான்
Copper	காப்பர்
Aamirah	ஆமிரா
Deependu	தீபேந்து
China	சீனா
Natural	நேச்சுரல்
Resources	ரிஸோசஸ்
Weldon	வெல்டன்
Rutland	ரட்லேண்ட்
Francis	ஃப்ரான்சிஸ்
Ford	ஃபோர்ட்
Coppola	கொப்போலா
El	எல்
Veladero	வெலாடெரோ
University	யூனிவர்சிட்டி
of	ஆஃப்
Bradford	ப்ராட்ஃபோர்ட்
Usariya	உசரியா
Mitsubishi	மிட்சுபீஷி
Chemical	கெமிக்கல்
TungaBhadra	துங்கபத்ரா
Dam	டேம்
Firdous	ஃபிர்டோஸ்
Mastek	மேஸ்டெக்
Dale	டேல்
fort	ஃப்போர்ட்
Devinder	தேவிந்தர்
West	வெஸ்ட்
Falls	பால்ஸ்
Christian	கிறிஸ்டியன்
Community	கம்யுனிட்டி
Namaste	நமஸ்தே
Ji	ஜி
Saptakoteshwar	சப்தகோடேஷ்வர்
Abjinipati	அப்ஜின்பட்டி
Maruf	மரூஃப்
Helen	ஹெலன்
Keller	கெல்லர்
Prospect	பிராஸ்பெக்ட்
Missionary	மிஷனரி
Baptist	பேப்டிஸ்ட்
Sarasvat	சரஸ்வத்
Marut	மரூத்
Muzzammil	முஸ்ஸாமில்
Nishvan	நிஷ்வன்
Eldorado	எல்டோராடோ
Suvarna	சுவர்ணா
Krikor	க்ரிகோர்
Bahu	பாஹு
Rani	ராணி
Masud	மசூத்
Khadilkar	கதில்கர்
Mohan	மோகன்
Faustine	ஃபாஸ்டின்
Mohal	மொஹல்
Mohak	மோஹக்
Zayba	ஜேபா
Rheinland	ரேய்ன்லாண்ட்
Tapesh	தபேஷ்
Guntakal	குண்டக்கல்
Junction	ஜங்ஷன்
Suruj	சுருஜ்
Ragoonath	ரகுநாத்
Sea	சீ
of	ஆப்
Japan	ஜப்பான்
Ramayana	ராமாயனா
Satyakam	சத்யகம்
Barath	பரத்
Seven	செவன்
Years'	இயர்ஸ்
War	வார்
Bedetti	பெதேட்டி
Phaansi	பான்ஸி
Gulati	குலாதி
Mahmud	மாஹ்முத்
Shabistari	ஷாபிஸ்தாரி
Shokaghn	ஷோககன்
Stotinki	ஸ்டொடின்கி
Kuntaa	குன்டா
Baudhdh	பௌத்
Miss	மிஸ்
Good	குட்
Night	நைட்
Gajavaan	கஜாவான்
Gulami	குலாமி
Naqli	நக்லி
Baap	பாப்
Inam	இனாம்
Dus	தஸ்
Hazar	ஹஸர்
Lovey	லோவி
Johnavon	ஜானேவன்
Jasvinder	ஜஸ்விந்தர்
Varna	வர்ணா
Dil	தில்
Ka	கா
Sathi	சதி
Dil	தில்
Indubhushan	இந்துபூஷன்
Sassi	சாஸி
Punnu	புன்னு
Bharani	பரணி
Gajavakr	கஜாவாக்ர்
Janet	ஜானட்
Rino	ரினோ
Girikshit	கிரிக்ஷித்
Prem	பிரேம்
Kahani	கஹானி
Yukon	யூகான்
Red	ரெட்
Rose	ரோஸ்
Yolanda	யோலந்தா
Lanzarote	லான்ஸாரோதே
Ishan	இஷான்
Whitney	விட்னி
Houston	ஹூஸ்டன்
Kedar	கேதார்
Vanee	வாணீ
Gregg	கிரெக்
Bharti	பாரதி
Air	ஏர்
Sharmila	ஷர்மிலா
Yaraana	யாரானா
Veerandhar	வீரந்தர்
Tavita	டவிதா
Shiv	ஷிவ்
Bhakta	பக்தா
Shagufa	ஷாகுஃப்பா
Nippon	நிப்பான்
Express	எக்ஸ்பிரஸ்
Seemant	சீமந்த்
Chaz	சாஸ்
Prem Bandhan	பிரேம்
Davendra	தேவேந்த்ரா
Ajay	அஜய்
Jadeja	ஜடேஜா
Kushal	குஷால்
Prathi	ப்ரதி
Hana	ஹனா
Azan	அஸான்
Germaine	ஜெர்மெய்ன்
Philander	ஃபிலாண்டர்
Abhyudita	அபியுதிதா
Bapat	பாபத்
Sodi	சோதி
Char	சார்
Minar	மினார்
Rangeen	ரங்கீன்
Zamana	ஸமானா
Hanifah	ஹனிஃபா
Sidrah	சித்ரா
Robert	ராபர்ட்
Kennedy	கென்னடி
Dharm	தர்ம
Patni	பத்னி
Nafrat	நஃப்ரத்
Ki	கி
Andhi	அந்தி
Armand	அர்மான்ந்த்
Parminder	பர்மிந்தர்
Pondera	பான்டெரா
Aviva	அவிவா
Cargill	கார்கில்
Induma	இந்துமா
Shree	ஸ்ரீ
Ganesh	கணேஷ்
Aanandit	ஆனந்தித்
Rifa'ah	ரிஃபாஹ்
Asaavari	அசாவாரி
Gir	கிர்
Hadmatiya	ஹத்மாட்டியா
Flex	ஃப்ளெக்ஸ்
Industries	இண்டஸ்ட்ரீஸ்
Binnaguri	பின்னகுரி
Bhai	பாய்
Saheb	சாஹேப்
Nusrat	நுஸ்ரத்
Fateh	ஃப்பதேஹ்
Ali	அலி
Khan	கான்
Kris	கிரிஸ்
Srikkanth	ஸ்ரிகான்த்
Darnell	டார்னேல்
Baruva	பாருவா
Ramaneek	ரமனீக்
War	வார்
of	ஆப்
the	த
Confederation	கானஃப்பெடரேஷன்
of	ஆப்
Bar	பார்
in	இன்
Poland	போலாண்ட்
Gulam	குலாம்
Begum	பேகம்
Badshah	பாட்ஷா
Bilaspuri	பிலாஸ்பூரி
La	லா
Martiniere	மார்ட்டினியர்
College	காலேஜ்
Theodore	தியோதர்
Roosevelt	ரூஸ்வெல்ட்
Andoy	அன்டாய்
fort	ஃப்போர்ட்
Fort	ஃப்போர்ட்
sheffield	ஷஃப்பீல்ட்
Time	டைப்
Warner	வார்னர்
Abdul	அப்துல்
rahim	ராஹிம்
Dagabaaz	தாகாபாஸ்
Shinjini	ஷிஞ்சினி
Langstone	லாங்ஸ்டோன்
redoubt	ரீடவுட்
Nippon	நிப்பான்
Oil	ஆயில்
Balli	பாலி
Anaamikaa	அனாமிக்கா
Alexandre	அலெக்சாண்டர்
Dumas	டுமாஸ்
Prajaapat	பிரஜபாத்
Kashif	கஷீஃப்
Raza	ராஸா
Isma'il	இஸ்மெயில்
Ismah	இஸ்மா
Firdaus	ஃபிர்தௌஸ்
Abdul	அப்துல்
raqib	ராகிப்
Ek	ஏக்
Nai	நய்
Paheli	பஹேலி
Dachigam	டாச்சிகாம்
Ganwar	கன்வர்
Tori	டோரி
Nestor	நெஸ்டர்
Manjural	மன்ஜுரல்
Islam	இஸ்லாம்
Rana	ரானா
Tai	தய்
Tam	தம்
Reservoirs	ரிசர்வாயர்ஸ்
Lala	லாலா
Marcel	மார்சல்
Benoist	பெனோயிஸ்ட்
Prize	ப்ரைஸ்
Yasmin	யாஸ்மின்
Lakkad	லக்கத்
Rookie	ரூக்கி
of	ஆஃப்
the	தி
Year	இயர்
Award	அவார்ட்
Vijite^driy	விஜிதேந்திரி
Geeti	கீதி
Faith	ஃபெயித்
Gustavo	குஸ்தவோ
Shiv	ஷிவ்
nandan	நந்தன்
Sharlene	ஷெர்லீன்
Aashir	ஆஷிர்
Lankeshvar	லங்கேஷ்வர்
Shyamangi	ஷியாமாங்கி
War	வார்
of	ஆப்
the	த
Holy	ஹோலி
League	லீக்
Chetan	சேட்டன்
Wenda	வென்டா
Sullivan	சல்லிவன்
Pepper	பெப்பர்
Jariyah	ஜரியா
Rajasthan	ராஜஸ்தான்
patrika	பத்ரிகா
Rohini	ரோஹினி
Salifah	சலிஃபா
Odin	ஓடின்
Milan	மிலன்
Linate	லினெட்
Bambai	பம்பை
Ka	கா
Babu	பாபு
Prabhuraam	பிரபுராம்
Taravindar	தரவிந்தர்
Debipur	தேபிபூர்
Arsenic	ஆர்சீனிக்
Chandralekha	சந்திரலேகா
Hailakandi	ஹைலகன்டி
Lubana	லுபானா
Shisham	ஷிஷாம்
Vermont	வெர்மான்ட்
Marble	மார்பல்
Museum	மியூஸியம்
Saed	சயித்
E	இ
Havas	ஹவாஸ்
Japinder	ஜபிந்தர்
Chinchli	சின்ஜ்லி
Akif	அகிஃப்
Visisht	விசிஷ்ட்
Seva	சேவா
Medal	மெடல்
Jacob's	ஜேகப்ஸ்
Well	வெல்
Aseem	அசீம்
Upama	உப்பாமா
Bennington	பென்னிங்டன்
Dilhara	தில்ஹாரா
Lokuhettige	லோகுஹெட்டிகே
Badr	பாதர்
aldin	அல்தின்
Abdus	அப்துஸ்
sattar	சத்தர்
Agnikumar	அக்னிகுமார்
Bahar	பஹார்
Exmouth	எக்ஸ்மவுத்
Pyrenees	பைரிநீஸ்
Giddh	கித்
Hersey	ஹெர்சி
Tejal	தேஜல்
Lincoln	லிங்கன்
Kosi	கோஸி
Kori	கோரி
Rosamund	ரோஸமண்ட்
Zaynab	ஜேனப்
Bhilwara	பில்வாரா
Aatirah	ஆதிரா
Bawal	பாவல்
Prometheus	புரோமெதியஸ்
Fort	ஃப்போர்ட்
darnet	டார்னெட்
Elizabeth	எலிசபத்
Tailor	டெய்லர்
Ezra	எஸ்ரா
Moseley	மோஸ்லீ
Bhuppal	புப்பால்
Baharon	பயரோன்
Ke	கே
Sapne	சாப்னே
Shitut	ஷிதுத்
Talwarkar	தல்வார்கர்
Raat	ராத்
Aur	அவுர்
Din	தின்
Dombivili	டோம்பிவிலி
Badree	பத்ரி
Norwich	நார்விச்
Order	ஆர்டர்
of	ஆஃப்
the	தி
Dutch	டச்
Lion	லயன்
Mahendragarh	மஹேந்திராகர்ஹ்
Himalay	ஹிமாலய்
Najiyah	நஜியா
Ferry	ஃபெர்ரி
Krodhi	குரோதி
Tanseem	தன்ஸீம்
Shaadaab	ஷதாப்
Hathras	ஹத்ராஸ்
Jennifer	ஜெனிஃபர்
Bahaudeen	பஹாவுதீன்
Frank	ஃப்ராங்க்
Capucine	காபூசின்
Suhrewardi	சுஹ்ரேவார்டி
The	தி
Royal	ராயல்
Norwegian	நார்வேயன்
Order	ஆர்டர்
of	ஆஃப்
Merit	மெரிட்
Kawabata	கவபாட்டா
Yasunari	யாசுனாரி
Prize	ப்ரைஸ்
Draxis	டிராக்ஸிஸ்
Health	ஹெல்த்
Ambodala	அம்போடாலா
Joey	ஜோயி
Benjamin	பெஞ்சமின்
Lori	லோரி
Duniya	துனியா
Ka	கா
Mela	மேளா
Wentworth	வென்ட்வொர்த்
Brayla	ப்ராய்லா
Chaurasi	சௌராஸி
Girik	கிரிக்
Angiotech	ஆன்ஜியோ
Pharmaceuticals	பார்மாசெட்டிக்கல்ஸ்
Dyllis	டய்ல்லிஸ்
Lake	லேக்
Nakuru	நகூரு
Craig	கிரெய்க்
Serjeant	செர்ஜியண்ட்
Lilli	லில்லி
National	நேஷனல்
Museum	மியூஸியம்
of	ஆஃப்
Contemporary	கான்டெம்போரரி
Art	ஆர்ட்
Municipal	முனிசிப்பல்
Museum	மியூஸியம்
of	ஆஃப்
the	த
Battle	பேட்டல்
of	ஆஃப்
Crete	கிரேட்
and	அண்ட்
the	த
National	நேஷன்ஸ்ல்
Resistance	ரெசிஸ்டன்ஸ்
Kamalkali	காமால்காலி
Bhaaratee	பாரதி
Kershaw	கெர்ஷா
Amritsar	அம்ரித்சார்
Samudra	சமுத்ரா
Chris	கிரிஸ்
Nevin	நெவின்
Keshavdas	கேஷவ்தாஸ்
Pujita	பூஜிதா
Safed	சாஃப்பெத்
Haathi	ஹாத்தி
Andre	அண்ட்ரே
Nel	நெல்
Daulat	தௌலத்
Adaa	அதா
Sudath	சுதாத்
Pasqual	பாஸ்கல்
Tongo	டோங்கா
Bandipur	பந்திபூர்
Stash	ஸ்டாஷ்
Tisha	திஷா
Simran	சிம்ரன்
Heath	ஹீத்
Streak	ஸ்ட்ரீக்
Brest	பிரெஸ்ட்
fortress	ஃப்போர்ட்ரெஸ்
Iranian	இரானியன்
Mundia	முன்டியா
Bheegi	பீகி
Raat	ராத்
Jerry	ஜெர்ரி
Reghe	ரெகே
Aishbagh	அயிஸ்பாக்
National	நேஷனல்
parks	பார்க்ஸ்
of	ஆஃப்
Brazil	பிரேசில்
General	ஜெனரல்
Insurance	இன்சூரன்ஸ்
Corporation	கார்ப்பரேஷன்
Maanasee	மானஸீ
Kartik	கார்டிக்
Suraksha	சுரக்ஷா
Dasha	டாஷா
Sterlite	ஸ்டெர்லைட்
Roop	ரூப்
Rupaiya	ருபையா
Mahoba	மஹூபா
Moscow	மாஸ்கோ
State	ஸ்டேட்
University	யூனிவர்சிட்டி
Kenneth	கென்னத்
Star	ஸ்டார்
Thomas	தாம்ஸ்
Jefferson	ஜெஃபர்சன்
Zelig	ஜெலிக்
Hemant	ஹேமந்த்
Kaamagni	காமாக்னி
Sevita	செவிதா
Gopesh	கோபேஷ்
Bhatni	பட்ணி
Junction	ஜங்ஷன்
Collins	கோலின்ஸ்
Obuya	ஓபுயா
Ajooba	அஜூபா
Kudrat	குத்ரத்
Ka	கா
Chikodi	சிடோக்கி
Road	ரோட்
Heeraalaal	ஹீராலால்
Navbharat	நவ்பாரத்
times	டைம்ஸ்
Darwaza	தர்வாஸா
Moghe	மோகே
Mera	மேரா
Pyara	பியாரா
British	ப்ரிட்டிஷ்
Petroleum	பெட்ரோலியம்
Vyakhya	வியாக்யா
Mahum	மஹும்
Shraddha	ஷரத்தா
Shelagh	ஷெலாக்
Kacy	கேசி
Fort	ஃப்போர்ட்
ronduit	ரான்டுயிட்
Gurudaspur	குருதாஸ்பூர்
Taisei	டைசே
Makhaya	மகாயா
Ntini	நிடினி
Edda	எட்டா
Usman	உஸ்மான்
Afzaal	அஃப்ஸால்
Jadugar	ஜாடுகர்
Raju	ராஜு
Kulkarni	குல்கர்னி
Miss	மிஸ்
Chalbaaz	சால்பாஸ்
Donal	டானல்
Smith	ஸ்மித்
Dwijesh	த்விஜேஷ்
Mafizur	மாஃப்பிஸுர்
Rahman	ரஹ்மான்
Sakhi	சகி
Banar	பானார்
Kaise	கைசே
Kahoon	கஹூன்
Bijolia	பிஜோலியா
Zulaym	ஜுலேய்ம்
Bhavnagar	பாவ்நகர்
Madeleine	மேடலீன்
Moti	மோதி
Vilas	விலாஸ்
Shubh	ஷுப்
Din	தின்
Apni	அப்னி
Izzat	இஸ்ஸாத்
Aandhi	ஆந்தி
Toofan	தூஃபன்
Mars	மார்ஸ்
Hill	ஹில்
Hari	ஹரி
Darshan	தர்ஷன்
Origins	ஆரிஜிஸ்
Award	அவார்ட்
Fort	ஃப்போர்ட்
red	ரெட்
bay	பே
Neodymium	நியோடிமியம்
Shatrujetaa	ஷத்ருஜேதா
Pico	பீகோ
de	டீ
Orizaba	ஓரிஜாபா
Senapati	சேனாபட்டி
Banyan	பேன்யன்
Zsa	ஜா
zsa	ஜா
Bommidi	பொம்மிடி
Lacy	லசி
Beck's	பெக்ஸ்
Futures	ஃப்யூச்சர்ஸ்
Cochin	கொச்சின்
Harbour	ஹார்பர்
Terminus	டெர்மினஸ்
Sharp	ஷார்ப்
Charlee	சார்லீ
Russian	ரஷ்யன்
Federation	பெட்டரேஷன்
Aunrihar	அவுன்ரிஹார்
Junction	ஜங்ஷன்
Taku	டாக்கூ
forts	ஃப்போர்ட்ஸ்
Allauddin	அலாவுதின்
Khan	கான்
Cotton-eyed-joe	காட்டன்-ஐட்-ஜோ
Ashraf	அஷ்ரஃப்
Ali	அலி
Sibson	ஸிம்சன்
Prix	ப்ரிக்ஸ்
Femina	ஃபெமினா
Mayon	மாயோன்
Anugamita	அனுகாமித்தா
Gogi	கோகி
Edi	எட்டி
Murphy	மர்ஃபி
Amaranta	அமரான்டா
Gobi	கோபி
Dean	டீன்
Headley	ஹெட்லே
Americium	அமெரிஷியம்
Cawsand	காசாண்ட்
fort	ஃப்போர்ட்
Kimaya	கிமாயா
Mere	மேரெ
Bhaiya	பையா
Abdul	அப்துல்
nur	நுர்
Amanaath	அமானாத்
Amay	அமே
Fort	ஃப்போர்ட்
lafayette	லாஃபேயெட்
Ashwin	அஷ்வின்
Babar	பாபர்
Bhiwandi	பிவாண்டி
Road	ரோட்
Didjeridu	டிட்ஜெர்டியூ
Bela	பேலா
Tal	தால்
Gautam	கெளதம்
Gambhir	கம்பிர்
Alnavar	அல்னாவர்
Junction	ஜங்ஷன்
Naved	நவேத்
Ashraf	அஷ்ரஃப்
Malkangiri	மல்கன்கிரி
Dayavan	தயாவன்
Lankesh	லங்கேஷ்
Kavishwar	கவிஷ்வார்
Santa	சான்டா
Monica	மோனிகா
Unmesh	உன்மெஷ்
Order	ஆர்டர்
of	ஆஃப்
the	தி
Elephant	எலிஃபண்ட்
Sonachanpaa	சோனசன்பா
Parma	பார்மா
Missionary	மிஷனரி
Baptist	பேப்டிஸ்ட்
Humsafar	ஹம்ஸஃபர்
Asghar	அஸ்கர்
Andre	ஆன்ட்ர்
Bham	பாம்
The	த
British	பிரிட்டிஷ்
Museum	கேலரி
Abdul	அப்துல்
nafee	நாஃபீ
Kamla	கம்லா
Ki	கி
Maut	மௌத்
Dharti	தர்தி
Mata	மாதா
The	த
assam	அஸ்ஸாம்
tribune	டிரைபூன்
Gorochana	கோராசனா
Kathie	காத்தீ
Cary	கேரி
Cornelius	கார்னெலியஸ்
Jadui	ஜாடுய்
Chitra	சித்ரா
Presidents	ப்ரெசிடெண்ட்ஸ்
Cup	கப்
Aaradhana	ஆராதணா
Ajeet	அஜீத்
Prix	ப்ரிக்ஸ்
Apollo	அப்போலோ
Zayb	ஜெய்ப்
Asta	அஸ்தா
Jalaun	ஜலவுன்
Dalton	டால்டன்
Emmy	எம்மத்
Zia	ஜியா
Asma	அஸ்மா
Phil	பில்
Emery	எமெரி
Vijul	விஜுல்
Purani	புரானி
Pehchan	பெஹ்சான்
Chingari	சிங்காரி
Arihant	அரிஹன்த்
Central	சென்டிரல்
chronicle	கிரானிக்கல்
Madhusudan	மதுசுதன்
Ian	ஐயான்
Harvey	ஹார்வே
Prasheet	பிரஷீத்
Squiddy	ஸ்க்விட்டி
Awards	அவார்ட்ஸ்
Anandinee	ஆனந்தினீ
Hutchison	ஹட்சிசன்
Essar	எஸ்ஸார்
Do	தோ
Dishayen	திஷாயென்
Arafaat	அராஃபாத்
Tulsa	டக்ஸ்ன்
Barharwa	பார்ஹார்வா
Junction	ஜங்ஷன்
Gorakhpur	கோரக்பூர்
City	சிட்டி
Masoomah	மசூமா
Brick	பிரிக்
Schoolhouse	ஸ்கூல்ஹவுஸ்
Museum	மியூஸியம்
Krishna	கிருஷ்ணா
Sudaama	சுதாமா
Vusi	வூஸி
Sibanda	சிபாண்டா
Log	லாக்
Kya	க்யா
Kahenge	காஹெங்கே
Amitaabh	அமிதாப்
Khot	கோத்
Dabilpur	தபில்பூர்
Bodhran	போத்ரான்
Bansi	பன்சி
Birju	பிர்ஜு
Cytheria	சிதெரியா
Bheegi	பீகி
Palken	பால்கன்
Nandur	நந்தூர்
Madhmeshwar	மத்மேஷ்வர்
Dam	டேம்
Gary	காரி
Oonch	ஊன்ச்
Neech	நீச்
Beech	பீச்
Apala	அபாலா
Neela	நீலா
Aakash	ஆகாஷ்
Ameer	அமீர்
Zadi	ஸதி
Sarai	சாரை
Ke	கே
Bahar	பாஹர்
Padman	பத்மன்
Ambedkarnagar	அம்பேத்கார்நகர்
Haim	ஹயிம்
Shaankar	ஷங்கர்
Raghupati	ரகுநாத்
Alam	ஆலம்
Ara	அரா
Ki	கி
Beti	பேட்டி
Dhilwan	தில்வான்
Sylvie	சில்வி
Shafaat	ஷஃபாத்
Dohara	டோஹாரா
Nobel	நோபல்
Prize	ப்ரைஸ்
in	இன்
Literature	லிட்ரேச்சர்
Boca	போகா
Raton	ரடோன்
Community	கம்யுனிட்டி
Avent	அவன்த்
Ramanadhi	ரமாநதி
Reservoir	ரிசர்வாயர்
Ringo	ரிங்கோ
Star	ஸ்டார்
Raameshvar	ராமேஷ்வர்
Vishnupriya	விஷ்ணுபிரியா
Karsan	கர்ஸன்
Ghavri	காவ்ரி
Bunaken	புனாகென்
Vivienne	விவின்னி
Guru	குரு
Ho	ஹோ
Ja	ஜா
Shuru	ஷுரு
Muktsar	முக்ட்சார்
Dennis	டென்னிஸ்
Kucinich	குச்சினிக்
Callie	காலீ
Luanda	லுவான்டா
Najidah	நஜிதா
Interceptor	இன்டர்செப்டர்
Rambha	ரம்பா
Jahm	ஜம்
Muhriz	முஹ்ரிஸ்
Corinthia	கோரின்தியா
Chiragh	சிராக்
Aachaaryasutaa	ஆசார்யாசுதா
Saib	சயிப்
Anirvaan	அனிர்வான்
Duniya	துனியா
Macon	மேகான்
Divis	டிவிஸ்
Labs	லேப்ஸ்
Raghukul	ரகுகுல்
Silverline	சில்வர்லைன்
School,	ஸ்கூல்,
Ghaziabad	காஸியாபாத்
Titanic	டைட்டானிக்
Bakeer	பகீர்
Sahim	சஹிம்
Kalikambal	காளிகாம்பாள்
Mandakranta	மண்டக்ரந்தா
Batu	படு
Dam	டேம்
Giuseppe	கியூஸெப்பே
Garibaldi	காரிபால்டி
Mard-E-Maidan	மார்த்-இ-மைதான்
Anvil	ஆன்வில்
Chyna	சைனா
John	ஜான்
The	தி
Baptist	பாப்டிஸ்ட்
Ghutayf	குடேஃப்
Chandi	சண்டி
Das	தாஸ்
Krishnadeva	கிருஷ்னதேவா
Rajkot	ராஜ்கோட்
Clovis	கிளோவிஸ்
Winston	வின்ஸ்டன்
Davis	டேவிஸ்
Fort	ஃப்போர்ட்
austin	ஆஸ்டின்
Bhaatvadekar	பாத்வதேகர்
Artah	அர்தா
Tanizaki	தனிஸாக்கி
Prize	ப்ரைஸ்
Jab	ஜப்
Andhera	அந்தேரா
Hota	ஹோதா
Hai	ஹை
Sachdeva	சாச்தேவா
Public	பப்ளிக்
School,	ஸ்கூல்,
Rohini	ரோஹினி
Shaheedur	ஷாஹீதுர்
Rahman	ரஹ்மான்
Intisar	இன்டிசார்
Otto	ஓட்டோ
Group	குரூப்
Shoaib	ஷோயப்
Mohammad	மொஹம்மத்
Lee	லீ
Germon	ஜெர்மன்
Vaishnav	வைஷ்ணவ்
Vats	வத்ஸ்
Bansthali	பன்ஸ்தாலி
Niwai	நிவாய்
Jayeshvar	ஜெயேஷ்வர்
Muttee	முத்தீ
Bridge	பிரிட்ஜ்
El-awra	எல்-ஆவ்ரா
Corliss	கோலிஸ்
Kiyedh	கியேத்
Aparna	அபர்ணா
Birmingham	பிர்மிங்கம்
Manon	மேனன்
Akram	அக்ரம்
Khan	கான்
Dodada	டோதாதா
Condecoracion	காண்டெஷோரேசியன்
Miguel	மிக்வெல்
Hidalgo	ஹிடால்கோ
Saregama	சரிகம
India	இந்தியா
Violet	வயோலெட்
Ernie	எர்னி
Dil	தில்
Daulat	தௌலத்
Duniya	துனியா
Sivni	சிவ்னி
Mukhadaa	முகாதா
Aryaman	அர்யாமான்
Hubbard	ஹப்பர்ட்
Medal	மெடல்
Donald	டொனால்ட்
Trump	ட்ரம்ப்
Sham	ஷாம்
Savera	சவேரா
Naim	நயீம்
Najm	நஜிம்
Dausni	தௌஸ்னி
Tum	தும்
Laut	லோத்
Aao	ஆஓ
Hafs	ஹஃப்ஸ்
Dheer	தீர்
Hermes	ஹெர்மெஸ்
Maxim	மேக்சிம்
Garci	கார்சி
Achalapati	அச்சலாபதி
Alaka	அலாகா
Order	ஆர்டர்
of	ஆஃப்
the	தி
Three	த்ரீ
Stars	ஸ்டார்ஸ்
Woh	வஹ்
Din	தின்
Aayega	ஆயேங்கா
Ferguson	ஃபெர்குசன்
Hanste	ஹன்ஸ்டே
Rehna	ரெஹ்னா
Budapest	புடாபெஸ்ட்
Ferihegy	பெரிஹெகி
Prem	பிரேம்
Yatra	யாத்ரா
Kharga	கார்கா
Paul	பால்
Grayson	கிரேசன்
West	வெஸ்ட்
Coast	கோஸ்ட்
Bhat	பட்
Menara	மேனரா
Telekom	டெலிகாம்
headquarters	ஹெட்குவார்டர்ஸ்
Barnstable	பார்ன்ஸ்டேபிள்
Sannata	சன்னாடா
United	யூனைடெட்
Arab	அராப்
Emirates	எமிரேட்ஸ்
Goodlass	குட்லாஸ்
Nerolac	நெரோலாக்
Bajaj	பஜாஜ்
Tempo	டெம்போ
Vishavanbhar	விஷவன்பர்
Kanwarlal	கன்வர்லால்
Sonal	சோனல்
Jinta	ஜின்டா
Konig	கோனிக்
Albert	ஆல்பர்ட்
Amaresh	அமரிஷ்
Junyo	ஜுன்யோ
Aadarsh	ஆதர்ஷ்
Antietam	அன்டியேடம்
Bahiyy	பாஹி
al	அல்
din	தின்
Massey	மஸ்ஸி
University	யூனிவர்சிட்டி
Acharynandana	ஆசார்யனான்தனா
Ashu	அஷு
Animish	அனிமிஷ்
Dumbarton	டம்பர்டன்
Carli	கார்லி
Simon	சைமன்
Abdul	அப்துல்
muneem	முனீம்
Anpadh	அன்பத்
Habib	ஹபிப்
Ozaafar	ஓசாஃப்பர்
Angoothi	அங்கூதி
Azeem	அஸீம்
Hafeez	ஹஃபீஸ்
Bahadur	பஹதூர்
Biscayne	பிஸ்கேன்
Mastani	மஸ்தானி
Abdul	அப்துல்
rafi	ராஃபி
Symona	சிமோனா
Manchester	மேன்செஸ்டர்
Metropolitan	மெட்ரோபாலிட்டன்
University	யூனிவர்சிட்டி
Edakkad	எடக்காட்
Arkaj	அர்கஜ்
Trishagni	டிரிஷாங்னி
Intizar	இன்டிஸார்
Pooran	பூரண்
Waliyah	வலியா
Uinta	உயின்டா
Manoratha	மனோரதா
Laalasaa	லாலஸா
Cholkar	சோல்கர்
Wajahat	வஜஹத்
Naagachanpaa	நாகசன்பா
Rod	ராட்
Marsh	மார்ஷ்
Lomonosov	லொமோனோசோவ்
Gold	கோல்ட்
Medal	மெடல்
Rishiyaketu	ரிஷியகேது
Thames	தேம்ஸ்
Ram	ராம்
Lakhan	லக்கான்
Khuli	குலி
Khidki	கிட்கி
Verity	வெரிடி
Nijjar	நிஜ்ஜார்
Grinham	கிரின்ஹாம்
Sardana	சர்தானா
Alarice	அலரிஸ்
Thurnwald	தர்ன்வால்ட்
Sandhya	சந்தியா
Chhaya	சாயா
Sorrento	சோரன்டோ
1	1
Disabled	டிசேபில்ட்
sailing	செய்லிங்
Jalgaon	ஜல்காவூன்
Vipra	விப்ரா
Collin	கோலின்
Abdul	அப்துல்
mannaan	மன்னான்
Abeedah	அபீதா
Uttara	உத்தாரா
Saint	செயிண்ட்
Joseph's	ஜோஸப்ஸ்
Senior	சீனியர்
Secondary	செக்கன்டரி
School,	ஸ்கூல்,
Kanpur	கான்புர்
Taaraa	தாரா
Darinda	தரிந்தா
Audrey	ஆட்ரே
Hepburn	ஹெப்பர்ன்
Damul	தாமுல்
Amal	அமல்
Silva	சில்வா
South	செளத்
America	அமெரிக்கா
Aajaad	ஆஜாத்
Zeno	ஜெனோ
Fort	ஃப்போர்ட்
lawrence	லாரென்ஸ்
Bhala	பால
Manus	மனுஸ்
Shriman	ஸ்ரீமான்
Satyawadi	சத்யவாதி
Madan	மதன்
Shoeb	ஷோப்
Heer	ஹீர்
Ranjha	ரன்ஜா
Ma	மா
Foi	ஃபோய்
Gokul	கோகுல்
Varyag	வார்யாக்
Tony	டோனி
Blair	ப்ளேர்
Maryum	மர்யூம்
Prem	ப்ரேம்
Naqeeb	நகீப்
Suneeti	சுனீதி
Synchronised	சிங்க்ரனைஸ்ட்
Swimming	ஸ்விம்மிங்
Mohinder	மொஹிந்தர்
Amarnath	அமர்னாத்
BEAVERTON	பேவர்டன்
CHRISTIAN	கிறிஸ்டியன்
Aag	ஆக்
Lago	லகோ
Do	தோ
Sawan	சவன்
Ko	கோ
Alpanaa	அல்பானா
Adelie	அடெலி
Pointer	பாயிண்டர்
Telocation	டெலோக்கேஷன்
Wilkinson	வில்கின்சன்
Kharad	காராத்
Smaram	ஸ்மரம்
Mexican	மெக்சிகன்
Order	ஆர்டர்
of	ஆஃப்
the	தி
Aztec	ஆஸ்டெக்
Eagle	ஈகிள்
Manaakshu	மனாக்ஷூ
Mahaganapati	மகாகணபதி
Bishop	பிஷப்
Magar	மகர்
Upasana	உப்பாசானா
Aadinarayan	ஆதினாராயன்
Aachwal	ஆச்வல்
Andie	ஆன்டி
Delano	டெலேனோ
Anokha	அனோகா
Rishta	ரிஷ்டா
Fort	ஃப்போர்ட்
randall	ரான்டல்
Magan	மகன்
Conner	கோனர்
Bruce	புரூஸ்
French	ஃபிரெஞ்சு
Connor	கோனர்
Arivarasu	அரிவரசு
Reynolds	ரேனால்ட்ஸ்
Lathrop	லத்ரோப்
VistaPrint	விஸ்டாபிரிண்ட்
Limited	லிமிடெட்
Saint	செயிண்ட்
thomas	தோமஸ்
tower	டவர்
Delores	டெலோரெஸ்
Maha	மஹா
Chor	சோர்
Ek	ஏக்
Hi	ஹி
Bhool	பூல்
Golden	கோல்டன்
Raspberry	ராஸ்ப்பெர்ரி
Awards	அவார்ட்ஸ்
Sohail	சோஹைல்
Sajjad	சஜ்ஜத்
Sadoof	சதூஃப்
Pyasi	பியாஸி
Nadi	நதி
Attila	அட்டில்லா
Jozsef	ஜோஸ்செஃப்
Prize	ப்ரைஸ்
Lucy	லுசி
Dustin	டஸ்டின்
Middle	மிடில்
Fail	ஃப்பெய்ல்
Conlan	கோன்லன்
Defiant	டிஃப்பியண்ட்
Illustrious	இலஸ்டிரியஸ்
Adolph	அடால்ப்
University	யூனிவர்சிட்டி
of	ஆஃப்
Canterbury	கேன்டர்பரி
Fort	ஃப்போர்ட்
santo	சான்டோ
domingo	டாமிங்கோ
Shamoodah	ஷமூதா
Gaskin	காஸ்கின்
Karnataka	கர்நாடகா
Biwi	பிவி
Kiraye	கிரயே
Ki	கி
Bhuranyu	பூரண்யூ
The	தி
International	இண்டர்நேஷநல்
Andy	ஆண்டி
Awards	அவார்ட்ஸ்
Roopakumaar	ரூபகுமார்
Lahu	லாஹூ
Ke	கே
Do	டோ
Rang	ராங்
The	தி
tyne	டைன்
turrets	டுர்ரெட்ஸ்
Anantnag	அனன்த்னாக்
Kang	காங்
Barzah	பர்ஜாஹ்
Peso	பெசோ
Rahmat	ரஹ்மத்
Pro	ப்ரோ
Football	ஃபுட்பால்
Hall	ஹால்
of	ஆஃப்
Fame	ஃபேம்
Koyna	கொய்னா
Comcast	காம்காஸ்ட்
Yashaswini	யஷஸ்வினி
Parakram	பராக்ரம்
Yorkshire	யார்க்‌ஷயர்
Dales	டேல்ஸ்
Bhatpur	பட்பூர்
Nairit	நைரித்
Daal	தால்
Mein	மெயின்
Kala	கலா
Raasavihaaree	ராஸவிஹாரீ
Audra	ஆத்ரா
Banwet	பான்வெத்
Glad	கிளாட்
Tidings	டைடிங்ஸ்
Allyson	அலிசன்
Bhartendu	பர்டேண்டு
Harishchndra	ஹரிஷ்சந்திரா
Rajgad	ராஜ்காத்
fort	ஃப்போர்ட்
Hemis	ஹெமிஸ்
Gompa	கோம்பா
Paolo	பாவோலா
Fighter	ஃபைட்டர்
Sheila	ஷீலா
Shishir	ஷிஷிர்
Aparaajit	அபராஜித்
Baariq	பாரிக்
Viraj	விரஜ்
Nishit	நிஷித்
Rand	ராண்ட்
Pardesi	பர்தேஸி
Saiyaan	சையான்
Awaam	ஆவாம்
Vishvajayee	விஷ்வஜயீ
Basant	பசந்த்
Panchami	பஞ்சமி
Virunga	விருங்கா
Angamali	அங்கமாலி
Bajeel	பஜீல்
Astatine	அஸ்டாடின்
Saint	செயிண்ட்
Joseph's	ஜோசப்ஸ்
Boys'	பாய்ஸ்
High	ஹை
School,	ஸ்கூல்,
Bangalore	பெங்களூர்
South	சௌத்
Seminole	செமினோல்
Baptist	பேப்டிஸ்ட்
Gurudwara	குருத்வாரா
Gursagar	குர்சாகர்
Prakash	ப்ரகாஷ்
Mahindra	மஹிந்த்ரா
and	அண்ட்
Mahindra	மஹிந்த்ரா
Dorpveld	டார்ப்வெல்ட்
Depinder	தீபிந்தர்
Mevan	மெவன்
Pieris	பியரிஸ்
Mento	மென்டோ
University	யூனிவர்சிட்டி
of	ஆஃப்
Essex	எஸ்ஸெக்ஸ்
Yogita	யோகிதா
Grimes	கிரிம்ஸ்
Dharmendra	தர்மேந்த்ரா
Khanduja	கன்டுஜா
Jorjanna	ஜோர்ஜன்னா
Vicki	விக்கி
Argonia	அர்கோனியா
Friends	ஃபிரண்ட்ஸ்
Eads	இஎட்ஸ்
Niket	நிகேத்
Donald	டொனால்ட்
Rumsfeld	ரம்ஸ்ஃபெல்ட்
Indo	இண்டோ
Rama	ராமா
Palkon	பால்கோன்
Ki	கி
Chhaon	சாஹான்
Mein	மேன்
Lanier	லானியர்
Axa	ஆக்ஸா
Mamta	மம்தா
Ki	கி
Chhaon	சாவுன்
Mein	மேன்
Boncelles	பான்செல்லெஸ்
fort	ஃப்போர்ட்
Bayana	பயானா
Junction	ஜங்ஷன்
Kapani	கபானி
Logitech	லாகிடெக்
International	இன்டர்நெஷனல்
Azamnagar	அஸம்நகர்
Road	ரோட்
Sulagte	சுலாக்தே
Arman	அர்மான்
Hickory	ஹிக்கரி
Street	ஸ்டிரீட்
Presbyterian	பிரெஸ்பைடிரியன்
Barry	பேரி
Manilow	மனிலோ
Consolidated	கன்சாலிடேட்டட்
Mercantile	மெர்கன்டைல்
Colin	கோலின்
Mahak	மஹக்
Connor	கான்னூர்
Williams	வில்லியம்ஸ்
Goldie	கோல்டி
Haun	ஹான்
Fakir	ஃபகிர்
Badshah	பாட்ஷா
Hanste	ஹன்ஸ்டே
Ansoo	அன்சூ
Duty	டூட்டி
Vaad	வாத்
Nice	நைஸ்
Cote	கோட்
D'azur	டி'அஸூர்
Implacable	இம்பிலேசபிள்
Dadasaheb	தாதாசாஹெப்
Phalke	பால்கே
Nishan-E-Jung	நிஷான்-இ-ஜங்
Achalganj	அசல்கஞ்ச்
Chana	சானா
Usha	உஷா
Martin	மார்டின்
Cape	கேப்
Flattery	பிலாட்டரி
Pehli	பெஹ்லி
Jhalak	ஜாலக்
Raj	ராஜ்
Darbar	தர்பார்
Nadine	நாடைன்
Fort	ஃப்போர்ட்
saint	செயிண்ட்
john	ஜான்
Krishnakumar	கிருஷ்னகுமார்
Fort	ஃப்போர்ட்
scoveston	ஸ்காவெஸ்டன்
University	யூனிவர்சிட்டி
of	ஆஃப்
Maryland	மேரிலேண்ட்
Aslesh	அஸ்லேஷ்
Ayoob	அயூப்
Chander	சந்தர்
Cityspire	சிட்டிஸ்பைர்
Chandel	சான்டெல்
Char	சார்
Diwari	திவாரி
Shaque	ஷாக்
Dhareshwar	தாரேஷ்வார்
Baare	பாரே
Conakry	கோனக்ரி
Karik	காரிக்
Rowing	ரோயிங்
E'temad	எ'டிமாத்
LaGrange	லாகிரான்ஜெ
Dulon	டுலோன்
Vrashaakapaayee	விராஷாகபாயீ
Vrinda	விருந்தா
Savitri	சாவித்ரி
Noakes	நோயேக்ஸ்
Latifah	லதிஃபா
Jagger	ஜாகர்
Fort	ஃப்போர்ட்
le	லெ
vieux	வியூக்ஸ்
Anuradha	அனுராதா
Sana	சனா
Gurudwara	குருத்வாரா
Santokhsar	சந்தோக்சர்
Yusuf	யூசுஃப்
Aachaaryasuta	ஆசார்யாசுதா
Kuberasinh	குபராசின்ஹ்
Kaun	கோன்
Saccha	சாச்சா
Kaun	கோன்
Jhootha	ஜூதா
Umaasut	உமாசுத்
Shravana	ஷரவனா
Akitsu	அகிட்ஸு
Maru	மாரு
Chuck	சக்
Ashoka	அசோக
Chakra	சக்ரா
Cheng	செங்
Strait	ஸ்டிரெயிட்
of	ஆப்
Magellan	மெகாலன்
Baladi	பாலாடி
Willem	வில்லெம்
Telyn	டேலின்
Jaeger	ஜேகர்
Carsyn	கார்ஸின்
Navjot	நவ்ஜோத்
Singh	சிங்
Sidhu	சித்து
Bhapa	பாப்பா
Nisbat	நிஸ்பத்
Thirunarayan	திருநாராயண்
Godse	கோட்சே
Bike	பைக்
racing	ரேசிங்
Ayra	அய்ரா
Oxford	ஆக்ஸஃபோர்ட்
Brookes	ப்ரூக்ஸ்
University	யூனிவர்சிட்டி
Laud	லவுட்
Hindustan	ஹிந்துஸ்தான்
Zinc	ஸிங்க்
Julakka	ஜுலாக்கா
Athula	அதுலா
Samarasekera	சமரசேகரா
Lalithamana	லலிதமானா
Fernando	ஃபெர்னாண்டோ
Bhai	பாய்
Ka	கா
Pyar	பியார்
Declan	டெக்லன்
Agnee	அக்னீ
Pareeksha	பரீக்ஷா
Deewana	தீவானா
Tere	தேரே
Naam	நாம்
Ka	கா
Shawm	ஷாம்
Chandramukhi	சந்திரமுகி
Aaj	ஆஜ்
Ka	கா
Robinhood	ராபின்ஹூட்
Gair	கயிர்
Kanooni	கனூனி
Nayan	நயன்
Mongia	மாங்கியா
Swatantra	ஸ்வந்திரா
Shrey	ஷ்ரேய்
Amar	அமர்
Rahe	ரஹே
Yeh	யேஹ்
Pyar	பியார்
Guriya	குரியா
Ab	அப்
Insaf	இன்சாஃப்
Hoga	ஹோகா
Providence	புரோவிடென்ச்
Jeete	ஜீதே
Hain	ஹெயின்
Shan	ஷான்
Se	சே
Darla	டார்லா
Desari	தேசரி
Round	ரவுண்ட்
dance	டான்ஸ்
Meena	மீனா
Flinders	ஃப்ளிண்டர்ஸ்
University	யூனிவர்சிட்டி
Bhagta	பக்தா
Suhag	சுஹாக்
Raidah	ரய்தா
Christian	கிறிஸ்டியன்
Church	சர்ச்
of	ஆப்
Clarendon	கிளாரென்டன்
Hills	ஹில்ஸ்
Aag	ஆக்
Ka	கா
Toofan	தூஃபன்
Shataansh	ஷதான்ஷ்
Wren	ரென்
Xanthus	ஜேந்தஸ்
Veradis	வெரதிஸ்
Nadirah	நாதிரா
Levar	லேவர்
Burton	பர்டன்
Ladki	லாட்கி
Kristine	கிரிஸ்டி
Pyasi	பியாஸி
Nigahen	நிகாஹென்
Godfrey	காட்ஃப்ரீ
Ibiza	இபிஸா
Jiten_dr	ஜிதேந்தர்
Ibrat	இப்ராத்
Bank	பேங்க்
of	ஆஃப்
Punjab	பஞ்சாப்
Kuldeep	குல்தீப்
Naiyar	நையார்
Constantinople	கான்ஸ்டன்டினோபிள்
Patmanjari	பத்மஞ்சரி
Brian	ப்ரயன்
Lara	லாரா
Dashavtar	தஷாவ்தார்
Cyprus	சைப்ரஸ்
Amrita	அம்ரிதா
preetam	ப்ரீதம்
Aminul	அமினுள்
Islam	இஸ்லாம்
Jon	ஜன்
Lewis	லீவிஸ்
Joseph	ஜோசப்
Stalin	ஸ்டாலின்
Maqsood	மக்ஸூத்
Rana	ரானா
University	யூனிவர்சிட்டி
of	ஆஃப்
Staffordshire	ஸ்டாஃப்போர்ட்ஷேர்
Katni	கட்னி
Parichay	பரிசய்
Deepali	தீபாலி
Padosan	படோசன்
Bijli	பிஜ்லி
Chamke	சம்கே
Jamana	ஜமானா
Par	பர்
Janhavi	ஜானவி
Solah	சோலா
Satra	சாத்ரா
Malika	மலிகா
Salomi	சலோமி
Ramcoind	ராம்கோ இண்ட்
Tahir	டாஹிர்
Naqqash	நஷாக்
Euphemia	இயுபிமியா
Fram	ஃப்பிராம்
Ross	ராஸ்
Edwards	எட்வர்ட்ஸ்
Chandi	சண்டி
Pooja	பூஜா
Nadeem	நதீம்
Gurudwara	குருத்வாரா
Dhobari	தோபரி
Sahib	சாஹிப்
Sanghera	சங்கேரா
Tonganoxie	டோங்கனோக்ஸி
Christian	கிறிஸ்டியன்
Abdul	அப்துல்
mani	மனி
Dasuya	தசூயா
Begu	பேகு
Sarai	சராய்
Osmond	ஓஸ்மந்த்
Ala	அலா
Amaanaath	அமானாத்
Fort	ஃப்போர்ட்
ricasoli	ரிகாஸோலி
Gaya	கயா
Junction	ஜங்ஷன்
Mahotsaah	மஹோத்ஸா
Sultan	சுல்தான்
Kelvin	கெல்வின்
Bijainagar	பிஜாய்நகர்
Radha	ராதா
Krishna	கிருஷ்ணா
Yashoda	யசோதா
Saimah	சைமா
Texas	டெக்ஸாஸ்
Instruments	இன்ஸ்டூரூமென்ட்ஸ்
World	வோர்ல்ட்
Chess	செஸ்
Champions	சாம்பியன்ஸ்
Abdul	அப்துல்
mujib	முஜிப்
Queen	குயின்
Cleopatra	கிளியோபட்ரா
Wolcott	வால்கோட்
Robin	ராபின்
Jackman	ஜேக்மேன்
Devang	தேவாங்
Gandhi	காந்தி
Majd	மாஜ்த்
Apna	அப்னா
Ghar	கர்
Peri	பெரி
Yaar	யார்
Kasam	கஸம்
Jwala	ஜ்வாலா
Daku	தாக்கு
Bahut	பாஹுத்
Din	தின்
Hue	ஹியு
Dard	தர்த்
Kaushal	கௌஷல்
Lokuarachchi	லொக்குவாராச்சி
Syed	சயத்
Rasel	ராசெல்
Tekachand	டேகசந்த்
Smruti	ஸ்ம்ருதி
Daad	டாட்
Nadir	நாதிர்
Shah	ஷா
Indrapriya	இந்திராபிரியா
Hancock	ஹான்காக்
Fort	ஃப்போர்ட்
zachary	ஸாகாரி
taylor	டெய்லர்
Prithvi	பிரித்வி
Vallabh	வல்லாப்
Mahaamantree	மஹாமந்த்ரி
Gearing	கியரிங்
Chaucer	சாசர்
Pahla	பஹலா
Pyar	பியார்
Kamakshi	காமாட்சி
Amman	அம்மன்
Babugarh	பாபுகார்
Brandeis	ப்ராண்டீஸ்
Award	அவார்ட்
Albertsons	ஆல்பர்ட்சன்ஸ்
Petronas	பெட்ரோனஸ்
Tower	டவர்
2	2
Manish	மனீஷ்
Tyanne	டையானி
Parakh	பர்ரக்
Anantram	அனன்த்ராம்
Royal	ராயல்
Ahold	அஹோல்டு
Aakarshan	ஆகார்ஷன்
Kynthia	கின்த்யா
Thuwaybah	துவேபா
Viklav	விக்லவ்
Shobna	ஷோப்னா
Fahd	ஃபாஹத்
Mathmesh	மத்மேஷ்
Shobha	ஷோபா
Nalavade	நளவாதே
Sadhu	சாது
Aur	அவுர்
Shaitan	ஷைத்தான்
Muhtadi	முஹ்தாதி
Bhumika	புமிகா
Alex	அலெக்ஸ்
Tait	டைட்
University	யூனிவர்சிட்டி
of	ஆஃப்
Central	சென்ட்ரல்
England	இங்க்லேண்ட்
Trinculo	டிரின்குலோ
Aulenda	ஔலேண்டா
Jaisalmer	ஜைஸால்மெர்
fort	ஃபோர்ட்
Madhu	மாது
Bansari	பன்சாரி
Harsingaar	ஹர்சிங்கர்
Lokaadhip	லோகதிப்
Raste	ராஸ்தே
Pyar	பியார்
Ke	கெ
University	யூனிவர்சிட்டி
of	ஆஃப்
Hyderabad	ஹைட்ராபாட்
Ameenaa	அமீனா
Masrur	மஸ்ரூர்
Jasbeer	ஜஸ்பீர்
Chandpur	சந்த்பூர்
Nell	நெல்
Fort	ஃப்போர்ட்
popham	பாப்பாம்
Shaalinee	ஷாலினீ
Nadalia	நாடாலியா
Volga	வோல்க்
Custer	கஸ்டெர்
Jharna	ஜார்னா
Aru	அரு
Philippines	பிலிப்பைன்ஸ்
Aon	ஏவோன்
Centre	சென்டர்
Idana	ஐடானா
Ara	அரா
Fort	ஃப்போர்ட்
cartwright	கார்ட்வெயிட்
Winthrop	வின்த்ரோப்
Bhagirathi	பாகிரதி
Kaamchor	காம்சோர்
Chhabili	சப்பிலி
Kiefer	கைஃபர்
Dayle	டேல்
Hadlee	ஹாட்லீ
Chhota	சோட்டா
Bhai	பாய்
Aacharyanandanaa	ஆசார்யானான்தனா
Police	போலிஸ்
Wali	வாலி
Kissa	கிஸ்ஸா
Kursi	குர்ஸி
Ka	கா
Mutazah	முதாஸா
Kali	காலி
Uttar	உத்தர்
Dinajpur	தினஜ்பூர்
Mrage^dr	ம்ரகேந்தர்
Abdul	அப்துல்
hakim	ஹகிம்
Rex	ரெக்ஸ்
Abhinaath	அபினாத்
Vaadkar	வாத்கர்
Ratowal	ரதோவால்
Shane	ஷேன்
Watson	வாட்சன்
Blair	பிளெய்ர்
Hartland	ஹார்ட்லாண்ட்
Brendon	பிரென்டன்
Julian	ஜூலியன்
Shan	ஷன்
Creek	கிரீக்
Community	கம்யூனிட்டி
Bible	பைபிள்
Taruni	தருணி
Danka	டங்கா
Business	பிசினஸ்
Systems	ஸிஸ்டம்ஸ்
Chandni	சாந்தினி
Rani	ராணி
Stanley	ஸ்டான்லி
De	டி
Silva	சில்வா
Abhijvaalaa	அபிஜ்வாலா
Napier	நேப்பியர்
University	யூனிவர்சிட்டி
Vidya	வித்யா
Niketan	நிக்கேதன்
School	ஸ்கூல்
Liyaakat	லியாகத்
Tej	தேஜ்
Andaaz	அந்தாஸ்
Ikshu	இக்ஷூ
Garth	கேர்த்
Brooks	ப்ரூக்ஸ்
Sanor	சனோர்
Durga	துர்கா
Mata	மாதா
Fritzi	ஃப்ரிட்ஸி
Teertha	தீர்த்தா
Sao	சாவோ
Joaquim	ஜாவோகியம்
Constellation	கான்ஸ்டெல்லேஷன்
Duggad	டுக்காட்
Ladki	லாட்கி
Jawan	ஜாவான்
Ho	ஹோ
Gai	காய்
Ravin_dar	ரவீந்தர்
Gurneet	குர்னீத்
Bhai	பாய்
Ho	ஹோ
To	தோ
Asia	ஏசியா
Kenadia	கெனாதியா
Mujhe	முஜே
Insaf	இன்சாஃப்
Chahiye	சாஹியெ
Seif	சிஃப்
David	டேவிட்
Joseph	ஜோசஃப்
Gurpreet	குர்ப்ரீத்
Azaraq	அஸராக்
Dakar	தகார்
Kashmir	காஷ்மிர்
post	போஸ்ட்
Supreme	சுப்ரீம்
Petro	பெட்ரோ
Malinga	மலிங்கா
Bandara	பண்டாரா
Warren	வார்ரன்
Stott	ஸ்டாட்
Agam	ஆகாம்
Mera	மேரா
Gaon	காஓன்
Barkha	பர்க்கா
Bahar	பஹர்
Indravishnu	இந்திராவிஷ்ணு
Pransukh	ப்ரண்சுக்
Barsaat	பர்ஸாத்
Darren	டேரன்
Sammy	சமி
Kyzyl-Kum	கைஸில்-கும்
Ladki	லாட்கி
Sahyadri	சாஹ்யாத்ரி
Ki	கி
Lexi	லெக்ஸி
Edythe	ஈடிதி
Fell	ஃபெல்
Angelo	ஏன்ஜெலோ
University	யூனிவர்சிட்டி
of	ஆஃப்
Bath	பாத்
Harare	ஹராரே
Motilal	மோதிலால்
Ghamandee	கமந்தீ
Jassal	ஜஸ்ஸல்
Perth	பெர்த்
Pramada	பிரமதா
Dakhla	தாக்லா
Caulfield	கால்ஃபீல்ட்
Cup	கப்
Dorel	டோரல்
Industries	இண்டஸ்டிரீஸ்
Lamb	லாம்ப்
Besharam	பெஷாரம்
Apollo	அப்போலோ
Tyres	டயர்ஸ்
University	யூனிவர்சிட்டி
of	ஆஃப்
Hawaii	ஹவாய்
Shintre	ஷின்த்ரே
Zafar	ஸஃபர்
Iqbal	இக்பால்
Verne	வெர்ன்
citadel	சிட்டாடெல்
Samajh	சமஜ்
Mahasati	மஹாஸதி
Tulsi	துல்சி
Bhadraksha	பாத்ராக்ஷா
Tegel	டீகல்
Hem	ஹெம்
Iqbal	இக்பால்
Sikander	சிக்கந்தர்
New	நியூ
Jersey	ஜெர்ஸி
Robert	ராபர்ட்
Haynes	ஹெய்ன்ஸ்
Negi	நேகி
Restoration	ரெஸ்டோரேஷன்
Vijetaa	விஜேதா
India	இந்தியா
Glycols	க்ளைகோல்ஸ்
Amazonia	அமஜோநியா
Betavad	பேடாவாட்
One	ஒன்
Chase	சேஸ்
Manhattan	மான்ஹாட்டன்
Plaza	பிளாஸா
Aadityakeshav	ஆதித்யாகேஷவ்
Holy	ஹோலி
Transfiguration	டிரான்ஸ்ஃபிகரேஷன்
Muqaddar	முகாதர்
Sugar	ஷுகர்
Dianthe	தயந்தே
Dean	டீன்
Jones	ஜோன்ஸ்
City	சிட்டி
University	யூனிவர்சிட்டி
Advait	அத்வைத்
Louise	லுயிஸ்
Cornish	கார்னிஷ்
Colony	காலனி
Museum	மியூஸியம்
Patil	பாட்டில்
Cape	கேப்
York	யோர்க்
Archaa	அர்சா
Villette	வில்லெட்
Shaun	ஷான்
Pollock	பொல்லாக்
Bhachau	பச்சாவ்
Godaa	கோட்டா
Janis	ஜானிஸ்
Joplin	ஜோப்லின்
Order	ஆர்டர்
of	ஆஃப்
Arts	ஆர்ட்ஸ்
and	அண்ட்
Letters	லெட்டர்ஸ்
Jen	ஜேன்
Baqi	பாகி
Steve	ஸ்டீவ்
Waugh	வாக்
Abdul	அப்துல்
aleem	அலீம்
Anokhi	அன்கி
Mohabbat	மொஹபத்
Bharat	பாரத்
Ke	கே
Shaheed	ஷஹீத்
Amanath	அமானாத்
Dharmanand	தர்மானந்த்
Tauseef	டௌசீஃப்
Ahmed	அகமத்
Shareef	ஷரீஃப்
Badmash	பாத்மாஷ்
Jaan	ஜான்
Hatheli	ஹதேலி
Pe	பே
Ceri	செரி
Jeevan	ஜீவன்
Ek	ஏக்
Sanghursh	சங்கர்ஷ்
Namumkin	நாமும்கின்
Nishad	நிஷாத்
Kala	கலா
Pani	பாணி
Umesh	உமேஷ்
Hisar	ஹிஸ்ஸார்
Pavak	பாவக்
Bad	பாத்
Aur	அவுர்
Badnaam	பத்னாம்
Cedi	சிடி
Anandini	ஆனந்தினி
Lel	லெல்
Mummy	மம்மி
Daddy	டாடி
Hiraa	ஹிரா
Galop	கேலாப்
Banarhat	பானாராட்
Beri	பேரி
Vaatve	வாத்வே
Gerald	ஜெரால்ட்
Peckover	பெக்கோவர்
Shwadhinota	ஷ்வாதினோடா
Dibosh	திபோஷ்
Puroskar	புரோஸ்கர்
Vegavaan	வேகவான்
Jayasinh	ஜெயசிங்
Kim	கிம்
Hughes	ஹக்ஸ்
Gurudwara	குருத்வாரா
Bibhor	பிபோர்
Sahib	சாஹிப்
Andrew	ஆண்ட்ரூ
Puttick	புட்டிக்
Mimbi	மிம்பி
Bedi	பேடி
Gargekar	கர்கேகர்
Arghya	அர்க்யா
Sasar	சாஸர்
Naiya	நையா
Muralidhar	முரளிதர்
Sacred	சேக்ரெட்
Heart	ஹார்ட்
Girls	கேர்ல்ஸ்
High	ஹை
School	ஸ்கூல்
Bhupinderpal	பூபிந்தர்பால்
Pratapgad	பிரதாப்காத்
Jatin	ஜதின்
Aag	ஆக்
Ke	கே
Sholay	ஷோலே
Mangal	மங்கல்
Pandey	பான்டே
Orden	ஆர்டன்
de	டி
Manuel	மேனுவல்
Amador	அமடார்
Guerrero	குயர்ரோ
Graham	க்ரஹாம்
Ford	ஃபோர்ட்
Mississippi	மிஸிஸிப்பி
Missouri	மிஸெளரி
Quasi-War	குவாஸி-வார்
Nasamajh	நாஸ்ம்ஜ
Akhila	அகிலா
Rockwell	ராக்வெல்
Frank	ஃப்ராங்க்
Zappa	ஸாப்பா
Kenneth	கென்னத்
Kossuth	கொஸூத்
Prize	ப்ரைஸ்
Garot	காரோட்
Chianki	சியாங்கி
Majarooh	மஜாரூஹ்
Timbales	டிம்பால்ஸ்
Ek	ஏக்
Aur	ஔர்
Sangram	சங்ரம்
Moinuddin	மொய்னுதீன்
Chishti	சிஷ்டி
Fort	ஃப்போர்ட்
san	சான்
felipe	ஃப்பெலிப்
Sarhindi	சர்ஹிந்தி
Nek	நேக்
Parveen	பர்வீன்
Dantewada	தன்தேவாதா
Baheri	பஹேரி
Basant	பசந்த்
Bahar	பஹர்
Kahani	கஹானி
Kismat	கிஸ்மத்
Ki	கி
Workstream	வர்க்ஸ்டிரீம்
Honorary	ஹானரரி
Citizen	சிட்டிசன்
of	ஆஃப்
the	தி
United	யுனைடெட்
States	ஸ்டேட்ஸ்
Kiev	கியேவ்
Ek	ஏக்
Thi	தி
Ladki	லட்கி
Trude	ட்ரூட்
Sevilla	செவில்லா
Southern	சதர்ன்
Petrochem	பெட்ரோகெம்
Salado	சலடோ
Ek	ஏக்
Jaan	ஜான்
Hai	ஹை
Hum	ஹம்
Bruce	ப்ரூஸ்
Springsteen	ஸ்ப்ரிங்ஸ்டீன்
Fort	ஃப்போர்ட்
bridger	பிரிட்ஜர்
Paul	பால்
Jarvis	ஜார்விஸ்
Satnam	சத்னம்
Overseas	ஓவர்சீஸ்
Viplav	விப்லவ்
Adheera	அதீரா
Arnold	ஆர்னால்ட்
Schwarzenegger	ஸ்வார்சனேகர்
Rakhshan	ரக்ஷான்
Frick	ஃப்பிரிக்
Collection	கலெக்ஷன்
Jamai	ஜமாய்
Raja	ராஜா
Prabhjit	பிரப்ஜித்
Salam	சலாம்
Cantara	சான்தாரா
Orbotech	ஆர்போடெக்
Daryapur	தார்யாபூர்
Huzayl	ஹுஸைல்
Salah	சலா
Aelwen	ஏல்வின்
Kuchipudi	குச்சிப்புடி
Atish	ஆதிஷ்
Bharatpur	பரத்பூர்
Junction	ஜங்ஷன்
Tyson	டைசன்
Bashirah	பஷீரா
Cybil	சிபில்
Order	ஆர்டர்
of	ஆஃப்
the	தி
Falcon	ஃபால்கன்
Order	ஆர்டர்
of	ஆஃப்
Aviz	அவீஸ்
Samaj	சமாஜ்
Lutetium	லுடெஷியம்
Angoori	அங்கூரி
Meg	மேக்
Pahunche	பஹுன்செ
Hue	ஹூயே
Log	லாக்
Order	ஆர்டர்
of	ஆஃப்
the	தி
Cross	க்ராஸ்
of	ஆஃப்
the	தி
Eagle	ஈகிள்
Nirdoshi	நிர்தோஷி
Abla	அப்லா
Dorothy	டொரோத்தி
Canfield	கேன்ஃபீல்ட்
Fisher	ஃபிஷர்
Children's	சில்ட்ரன்ஸ்
Book	புக்
Award	அவார்ட்
Saubhagya	செளபாக்யா
Bitterroot	பிட்டேரூட்
University	யூனிவர்சிட்டி
of	ஆஃப்
Middlesex	மிடில்செக்ஸ்
Super	சூப்பர்
Bowl	பௌல்
Sajan	சஜன்
Rockbridge	ராக்பிரிட்ஜ்
Suraj	சுரஜ்
Pratosh	பிரதோஷ்
Dee	டீ
Bhadli	பத்லி
Shakir	ஷகிர்
Rossa	ரோஸ்ஸா
Sajeewa	சஜீவா
de	டி
Silva	சில்வா
Aadhi	ஆதி
Roti	ரோட்டி
Rockbrook	ராக்புரூக்
United	யுனைட்டெட்
Suzy-q	ஸுஸி-க்
Adwakee	அத்வாகீ
Seeta	சீதா
Swayamvar	ஸ்வயம்வர்
Jai	ஜெய்
Mahalaxmi	மகாலக்ஷ்மி
Lakshadweep	லக்‌ஷதீப்
Aa	ஆ
Gale	கலே
Lag	லாக்
Ja	ஜா
Vipin	விபின்
Xenos	ஜெனோஸ்
Chittoor	சித்தூர்
Perumpallam	பெரும்பள்ளம்
Reservoir	ரிசர்வாயர்
Vernados	வெர்னதாஸ்
Bob	பாப்
Massie	மாஸ்ஸி
Acropolis	ஆக்ரோபோலிஸ்
Museum	மியூஸியம்
Mark	மார்க்
Dekker	டெக்கர்
Falgun	ஃபல்குன்
De	டி
Zeven	ஸேவென்
Provincien	புரோவிஷியன்
Wakalat	வகாலத்
Halers	ஹலெர்ஸ்
Zaytoon	ஜேடூன்
Nazeefah	நஸீஃபா
Bade	பாடே
Gulam	குலாம்
ali	அலி
Khan	கான்
Ravindr	ரவிந்தர்
Geneva	ஜெனிவா
Road	ரோட்
Baptist	பேப்டிஸ்ட்
Subhash	சுபாஷ்
Mukhopadhyay	முகோபாத்யாய்
Highway	ஹைவே
Holdings	ஹோல்டிங்க்ஸ்
Kaltham	கல்தம்
New	நியூ
York	யார்க்
City	சிட்டி
Police	போலிஸ்
Museum	மியூஸியம்
Mettur	மேட்டூர்
Reservoir	ரிசர்வாயர்
Delran	தெல்ரன்
First	ஃபர்ஸ்ட்
United	யுனைடெட்
Methodist	மெதோடிஸ்ட்
Mushtaq	முஷ்டாக்
Ahmed	அகமத்
Anjaam	அஞ்ஜாம்
Chaturmukha	சத்தூர்முகா
Salgirah	சால்கிராஹ்
Govindaraja	கோவிந்தராஜ
Perumal	பெருமாள்
Sean	சீன்
Davies	டேவிஸ்
Vevay	வேவய்
Historical	ஹிஸ்டாரிக்கல்
Museum	மியூஸியம்
of	ஆஃப்
Crete	கிரேட்
Sanaa	சனா
Quickstep	குயிக்ஸ்டெப்
Frank	ஃப்ராங்க்
Sinatra	சினாத்ரா
Sanam	சனம்
Fort	ஃப்போர்ட்
rotterdam	ராட்டர்டாம்
Bombay	பாம்பே
samachar	சமாச்சர்
Sherburne	ஷெர்பர்னெ
Mehmaan	மெஹ்மான்
Sanat	சனத்
Balkrishna	பாலகிருஷ்ணா
Ind	இண்ட்
Atul	அட்டூல்
Tata	டாடா
Coffee	காஃபி
Moxenos	மொக்ஸீனோஸ்
Balaji	பாலாஜி
Telefilm	டெலிஃபிலிம்
Sanath	சனத்
Jayasuriya	ஜெயசூர்யா
Jecy	ஜெசி
Jackson	ஜாக்சன்
Joy	ஜாய்
Atal	அட்டல்
Qutayyah	குடாய்லா
Spencer	ஸ்பென்சர்
Teranika	டெரானிகா
Retalix	ரிட்டாலிக்ஸ்
Mahamaya	மஹாமாயா
Bahadur	பஹதுர்
Naresh	நரேஷ்
Anand	ஆனந்த்
Math	மத்
Stew	ஸ்டீவ்
Roland	ரோலண்ட்
Holder	ஹோல்டர்
Titus	டைடஸ்
Seeta	சீதா
Fort	ஃப்போர்ட்
benghisa	பெங்ஹிசா
Chambal	சம்பல்
Ki	கி
Rani	ராணி
Order	ஆர்டர்
of	ஆஃப்
Suvorov	சுவோரோவ்
Abdul	அப்துல்
muqit	முக்கித்
Caliana	காலியானா
Baalaji	பாலாஜி
Ashanti	ஆஷாந்தி
Alfred	ஆலஃப்பிரெட்
Luseno	லுசெனோ
Patch	பேட்ச்
Vajont	வஜோந்த்
Dam	டேம்
Birju	பிர்ஜு
Ustad	உஸ்தாத்
Ian	ஐயன்
Bell	பெல்
Campion	கேம்பியான்
School,	ஸ்கூல்,
Mumbai	மும்பை
Balwara	பல்வாரா
Ballaleshwar	பல்லலேஷ்வர்
Waseefah	வசீஃபா
Ingeborg	இங்கிபோர்க்
Bachmann	பேக்மேன்
Prize	ப்ரைஸ்
Padma	பத்ம
Bhushan	பூஷன்
Bhudraj	புத்ராஜ்
Pulak	புலக்
Abjayoni	அப்ரயோனி
Gandhapalin	கந்தாபாலின்
Glenyon	கிளேனியான்
Chhoti	சோட்டி
Si	சி
Mulaqat	முலாகத்
Medal	மெடல்
for	ஃபார்
Heroism	ஹீரோயிசம்
in	இன்
Silver	சில்வர்
Nishane	நிஷானெ
Baazi	பாஸி
Jacques	ஜாக்ஸ்
Rudolph	ருடால்ஃப்
Mamaji	மாமாஜி
Naarlekar	நார்லேகர்
Beraham	பெராஹம்
Solstice	சோல்ஸ்டைஸ்
Preussen	பிரூஸ்ஸென்
Graham	கிராஹாம்
Gooch	கூச்
E'temaad	எ'டிமாத்
Phadnis	பட்னிஸ்
Lack	லாக்
Walesa	வலேசா
Aadinaaraayan	ஆதினாராயன்
Discus	டிஸ்கஸ்
Anjalee	அஞ்சலீ
Zwyndrecht	ஸைன்டிரெச்ட்
Saza	சாஸா
E	இ
Maut	மெளத்
Pyar	பியார்
Ka	கா
Toofan	டூஃப்பன்
Charles	சார்லஸ்
Martel	மார்டெல்
Allemande	அலெமான்டெ
Deekshaapati	தீக்‌ஷாபதி
Khel	கேல்
Khiladi	கிலாடி
Ka	கா
University	யூனிவர்சிட்டி
of	ஆஃப்
Leeds	லீட்ஸ்
Safwah	சஃப்வஹ்
Chindwara	சிந்வாரா
Word	வேர்ட்
and	அண்ட்
Spirit	ஸ்பிரிட்
Family	பேமிலி
Gavan	காவன்
Manikuntala	மணிகுண்டலா
Brian	பிரயன்
Luckhurst	லக்ஹஸ்ட்
Miss	மிஸ்
India	இண்டியா
Kaiser	கைஸர்
Luciano	லூசியாநொ
Pavarotti	பவாரோட்டி
Gabon	கபோன்
Ekatan	எகாதான்
Marisela	மரீசெலா
Nikunja	நிகுஞ்சா
Krishnakali	கிருஷ்னாகாலி
Gehra	கெஹ்ரா
Daag	தாக்
Ramswaroop	ராமஸ்வரூப்
Tendulkar	தெண்டுல்கர்
Bir	பிர்
Uttom	உத்தம்
Chandrabhaan	சந்திரபான்
Ekambir	எகாம்பிர்
Onega	உனேகா
Lisbon	லிஸ்பன்
Portela	போர்டெலா
Noor	நூர்
Jahan	ஜஹான்
Kulachi	குலாசி
Hansraj	ஹன்ஸ்ராஜ்
Model	மாடல்
School	ஸ்கூல்
Murray	முர்ரே
Goodwin	குட்வின்
Nellie	நெலியே
Mike	மைக்
Watkinson	வாட்கின்சன்
Adeline	அடெலின்
Badi	படா
Didi	தீதி
Yogit	யோகித்
Abdul	அப்துல்
wahaab	வாஹாப்
Bheeshm	பீஷ்ம
Virgil	விர்ஜில்
Triyama	ட்ரியாமா
Madhavdas	மாதவ்தாஸ்
Mike	மைக்
Gatting	கேட்டிங்
Bassi	பஸ்ஸி
Gymnastics	ஜிம்னாஸ்டிக்ஸ்
Irfan	இர்ஃபான்
Bhatti	பாட்டீ
Lal	லால்
Kothi	கோதி
Lotte	லோட்டே
Sagar	சகர்
Sepik	செபிக்
flutes	ஃப்ளூட்ஸ்
Kanengara	கனேங்கரா
Gran	கிரான்
Canaria	கனரியா
Pittsburg	பிட்ஸ்பர்க்
church	சர்ச்
of	ஆப்
Christ	கிறிஸ்ட்
Vrajabala	விரஜபாலா
Sonnagh	சோன்னக்
Andrew	ஆன்ட்ரூ
Penn	பென்
Aine	ஐன்
Chris	கிரிஸ்
Cowdrey	கவ்டிரே
Evanthe	இவான்தே
Tino	டினோ
Ratul	ரதுல்
Habeeba	ஹபீபா
Deulkar	தியுல்கர்
Alexander	அலெக்சாண்டர்
the	தி
Great	கிரேட்
Ananda	அனன்தா
bazar	பஸார்
patrika	பர்திக்கா
Talladega	டாலாடெகா
Pyasa	பியாஸா
Dil	தில்
Finlay	ஃபின்லே
Ringgit	ரிங்கிட்
Czechoslovakia	செக்கோஸ்லேவேக்கியா
Venezuela	வெனிசூலா
Burhar	புர்ஹார்
Firozpur	ஃபிரோஸ்பூர்
Cantonment	கண்டோன்மெண்ட்
Babrala	பாப்ராலா
Aanandamayee	ஆனந்தமாயீ
Thirumurthi	திருமூர்த்தி
Reservoir	ரிசர்வாயர்
Mount	மவுண்ட்
Carmel	கார்மெல்
School	ஸ்கூல்
Bhagwati	பகவதி
Lagoa	லகாவோ
do	டோ
Peixe	பிக்ஸி
Sazaa	சாஸா
Yellow	யெல்லோ
Sea	சீ
Gaali	காலி
Kifayat	கிஃபாயாத்
Farz	ஃபர்ஸ்
Aur	ஔர்
Kanoon	கனூன்
Sipahsalar	சிப்பாஹ்சலார்
Bretagne	பிரேடக்னெ
Medal	மெடல்
for	ஃபார்
Rescue	ரெஸ்க்யூ
at	அட்
Sea	சீ
Copper	காப்பர்
Ivanhoe	இவன்ஹோ
Energy	எனர்ஜி
Tandem	டேண்டம்
Cycling	சைக்கிளிங்
Steve	ஸ்டீவ்
Palframan	பால்ஃப்ராமேன்
Eurohypo	யூரோஹைபோ
Rupye	ருப்யே
Ki	கி
Kahani	கஹானி
Roy	ராய்
Fredericks	ஃப்ரெட்ரிக்ஸ்
Ramon	ரமோன்
Warwah	வார்வா
Gajraula	கஜ்ரௌலா
Junction	ஜங்ஷன்
Faisal	ஃபைசால்
Athar	அக்தர்
Chaminda	சமிந்தா
Mendis	மெண்டிஸ்
Anaesthesiology	அனஸ்தீஸியலஜி
Radon	ரேடான்
Dave	டேவ்
Rundle	ரண்டில்
Ganaraj	கானாராஜ்
Shahriar	ஷாஹ்ரியர்
Hossain	ஹோஸ்ஸென்
Athawale	அதாவாலே
Bhitaura	பிடவுரா
Chilean	சிலியன்
Kaden	காடென்
Yang	யாங்
Qin	கின்
Mathilda	மத்தில்டா
Madelia	மேடலியா
Jalia	ஜாலியா
Mahabala	மஹாபாலா
Lauwershoek	லாவ்வெர்ஷூயிக்
Sakinah	சகினா
Changez	சேஞ்சஸ்
Khan	கான்
Kulbhushan	குல்பூஷன்
Rikki	ரிக்கி
Clarke	கிளார்க்
Kashelikar	கஷெலிகர்
Laverne	லவெர்ன்
Hilal	ஹிலால்
Mera	மேரா
Dharam	தாராம்
Daku	தாக்கு
Aur	ஔர்
Jawan	ஜவான்
Bambai	பம்பை
Ka	கா
Maharaja	மஹராஜா
Poonam	பூனம்
Ka	கா
Chand	சந்த்
Chini	சினி
Jadugar	ஜாதுகர்
Medal	மெடல்
of	ஆஃப்
the	தி
Order	ஆர்டர்
of	ஆஃப்
Merit	மெரிட்
for	ஃபார்
the	தி
Fatherland	ஃபாதர்லேண்ட்
Kwacha	க்வாச்சா
Jazlynn	ஜாஸ்லின்
Manjooshaa	மஞ்சூஷா
Abha	அபா
Order	ஆர்டர்
of	ஆஃப்
the	தி
Chrysanthemum	க்றிசாந்திமம்
Ron	ரான்
Hart	ஹார்ட்
Chor	சோர்
Pe	பே
Mor	மோர்
Dibang	டிபங்
Valley	வாலி
Khurana	குரானா
Mrityunjai	ம்ரித்யுஞ்சய்
Yagya	யக்ய
Darakhshaan	தரக்ஷன்
Bidar	பிதார்
Gopichand	கோபிசந்த்
Jasoos	ஜசூஸ்
Dharashivkar	தாராஷிவ்கர்
Bidai	பிதாய்
Dan	டான்
Rather	ராதர்
Baalamohan	பாலமோகன்
Brooklyn	புரூக்லின்
Museum	மியூஸியம்
Khazanchi	கஸான்ச்சி
The	த
tribune	டிரைபூன்
Yahya	யாஹ்ய
Aighar	ஐகார்
Berry	பெர்ரி
head	ஹெட்
fort	ஃப்போர்ட்
San	சான்
Juan	ஜுவான்
Petula	பெடுலா
Anahita	அனஹிதா
The	தி
Carper	கார்பர்
Award	அவார்ட்
Lake	லேக்
District	டிஸ்ட்ரிக்ட்
Manning	மானிங்
Martin	மார்டின்
Suji	சுஜி
Gurudwara	குருத்வாரா
Daatan	டாத்தன்
Sahib	சாஹிப்
Mutayyib	முதாயிப்
Glynn	கிலின்
Tripta	த்ருப்தா
Bae	பே
Systems	ஸிஸ்டம்ஸ்
Anand	ஆனந்த்
Aur	அவுர்
Anand	ஆனந்த்
Annette	அன்னெட்
Wasim	வாசிம்
Bari	பாரி
Bhilai	பிலாய்
Power	பவர்
House	ஹவுஸ்
Hum	ஹம்
Kisi	கிசி
Se	சே
Kum	கம்
Nahin	நஹின்
Abdul	அப்துல்
muaid	முவேத்
Angaarikaa	அங்காரிக்கா
Westlb	வெஸ்ட்எல்பி
Rajouri	ராஜவுரி
Rockford	ராக்போர்ட்
Aabshar	ஆப்ஷர்
Swaroopaa	ஸ்வரூபா
Aahlaadit	ஆஹ்லாதித்
Akamal	அகமால்
Karate	கராத்தே
Bajrang	பஜ்ரங்
Girdhar	கிர்தார்
Gopal	கோபால்
Ki	கி
Mira	மிரா
Marcantonio	மார்கான்டோனியோ
Colonna	கோலோன்னா
Subhaashachandr	சுபாஷ்சந்தர்
Sysco	சிஸ்கோ
Ghayoor	காயூர்
Ek	ஏக்
Baar	பார்
Muskura	முஸ்குரா
Do	தோ
Gurudwara	குருத்வாரா
Majnu	மஜ்னு
kaa	கா
Tila	டீலா
Saran	சரண்
Shareef	ஷரீஃப்
Prix	ப்ரிக்ஸ்
Ars	அர்ஸ்
Electronica	எலக்ட்ரானிகா
Vaughan	வாகான்
Brown	பிரவுன்
Balharshah	பல்லார்ஷா
Tiana	டியானா
Julia	ஜூலியா
Roberts	ராபர்ட்ஸ்
Maya	மாயா
Angelo	ஏஞ்சலோ
Mu'alla	முவால்லா
Shafee	ஷஃபீ
Aurvashey	ஆர்வாஷி
Will	வில்
Norwegian	நார்வேஜியன்
Campana	கம்பானா
Kankukus	கன்குகுஸ்
Don	டான்
Juan	ஜுவான்
Matus	மாதுஸ்
Mitti	மிட்டி
Mein	மேன்
Sona	சோனா
College	காலேஜ்
Football	ஃபுட்பால்
Awards	அவார்ட்ஸ்
Padmalaya	பத்மாலயா
Tele	டெலி
Datia	டாஷியா
fort	ஃப்போர்ட்
Annapurnaa	அன்னாபுர்னா
Kalea	காலியா
Main	மேன்
Awara	அவாரா
Hoon	ஹூன்
Langley	லாங்லே
Adityanandan	ஆதித்யானன்தன்
Ramashray	ராமஷ்ராய்
Montshire	மான்ட்ஷைர்
Museum	மியூஸியம்
of	ஆஃப்
Science	சைன்ஸ்
Mitti	மிட்டி
Ke	கே
Khilone	கிலோனே
Warnix	வார்னிக்ஸ்
Naya	நயா
Zamana	ஸமானா
Nai	நயி
Kranti	கிரான்தி
Abduh	அப்துஸ்
shaahid	ஷாஹித்
Paanch	பான்ச்
Dushman	துஷ்மன்
Bikaner	பிக்கானெர்
Junction	ஜங்ஷன்
Cape	கேப்
Town	டவுன்
International	இன்டர்நேஷனல்
Jugnu	ஜுக்னு
Vrashtiheen	விரஷ்டிஹீன்
Abdul	அப்துல்
adl	அத்ல்
Transverse	டிரான்ஸ்வெர்ஸ்
Little	லிட்டில்
Richard	ரிச்சர்ட்
Peace	பீஸ்
Dil	பில்
Se	சே
Mile	மிலே
Dil	தில்
Emmet	எம்மட்
Atul	அடுல்
Wassan	வாஸ்ஸன்
Fort	ஃப்போர்ட்
constitution	கான்ஸ்டிட்டியூஷன்
Bin	பின்
Maa	மா
Ke	கே
Bhachchey	பச்சேய்
Nyay	நியாய்
Anyay	அன்யாய்
Bahu	பாஹு
Ho	ஹோ
To	தோ
Aisi	அய்ஸி
Manzoor	மன்சூர்
Akhtar	அக்தர்
Jayprada	ஜெய்பிரதா
Church	சர்ச்
of	ஆப்
the	தி
Open	ஓபன்
Door	டோர்
Goresuar	கோரேசௌர்
Mere	மேரெ
Mehboob	மெஹ்பூப்
Mandara	மந்தரா
Eileen	ஐலீன்
Bombay	பாம்பே
Ki	கி
Billi	பில்லி
Atlas	அட்லஸ்
Pacific	பஸிஃபிக்
Limited	லிமிடெட்
Cox	காக்ஸ்
Plate	ப்ளேட்
Nandita	நந்திதா
Bombay	பாம்பே
Raat	ராத்
Ki	கி
Bahon	பஹோன்
Mein	மெயின்
Gawaiya	கவைய்யா
Samarendra	சம்ரேந்திரா
Abdullah	அப்துல்லா
Faizi	ஃப்பைஸி
ad-Daghestani	அத்-டாகெஸ்தானி
Hameem	ஹமீம்
Westminster	வெஸ்ட்மின்ஸ்டர்
Presbyterian	பிரெஸ்பைடேரியன்
Hansraj	ஹன்ஸ்ராஜ்
Morarji	மொரார்ஜி
Public	பப்ளிக்
School	ஸ்கூல்
Annapoorna	அன்னாபூர்னா
Imran	இம்ரான்
Farhat	ஃபர்ஹத்
Pink	பிங்க்
Model	மாடல்
School,	ஸ்கூல்,
Bikaner	பிகானெர்
Guajira	குவாஜிரா
Khubgaonkar	குப்கோன்கர்
Rose	ரோஸ்
Bina	பினா
Junction	ஜங்ஷன்
Selkirk	செல்கிர்க்
Sajjad	சாஜ்ஜாத்
Ahmed	அஹ்மத்
Dino	டினோ
Nat	நாட்
King	கிங்
Cole	கோல்
Excalibur	எக்ஸ்காலிபர்
Anuttam	அனுத்தம்
Jill	ஜில்
Phadatare	பதாதரே
Abbaasee	அப்பாஸீ
Bill	பில்
Clinton	கிளிண்டன்
Dhasa	தாசா
Junction	ஜங்ஷன்
Adonia	அடோனியா
Aksh	அக்ஷ்
Brijmohan	ப்ரிஜ்மோகன்
SIGNY	சிக்னி
award	அவார்ட்
Siddhatek	சித்தாதேக்
Yaachishnu	யாசிஷ்னு
Cerise	செரைஸ்
Ojaswini	ஓஜஸ்வானி
Rajan	ரஜன்
Rajam	ராஜம்
Champaran	சம்பாரம்
Anmol	அன்மோல்
Sitarey	சிதாரே
Bajarang	பஜ்ரங்
Urbana	அர்பனா
Achaarynandan	ஆசார்யனான்தன்
Isaura	ஐசவ்ரா
Manipur	மனிப்பூர்
today	டுடே
Carlow	கார்லோ
Swiss	சுவிஸ்
Life	லைப்
Asasia	அசாசியா
Gorakhpur	கோரக்பூர்
Cantonment	கண்டோன்மெண்ட்
Fico	ஃபீக்கோ
Gurudwara	குருத்வாரா
Guru	குரு
ke	கே
Wadali	வடாலி
Afsar	அஃப்சார்
Shobhana	சோபனா
Daawat	தாவத்
Lankston	லங்ஸ்டன்
Jwala	ஜ்வாலா
Jab	ஜப்
Se	சே
Tumhe	தும்ஹே
Dekha	தேகா
Hai	ஹை
Guthrie	குத்ரீ
Yosemite	யோஸ்மைட்
Ping	பிங்
Pong	பாங்
Manimukthanadhi	மணிமுக்தாநதி
Reservoir	ரிசர்வாயர்
Phir	பிர்
Wohi	வோஹி
Dil	தில்
Laya	லாயா
Hoon	ஹூன்
Marvela	மார்வேலா
Thattha	தத்தா
Jigri	ஜிக்ரி
Dost	தோஸ்த்
Ito	ஐடோ
Yokado	யோகாடா
Shrivats	ஸ்ரீவத்ஸ்
Heeron	ஹீரோன்
Ka	கா
Chor	சோர்
Abdul	அப்துல்
mannan	மன்னன்
Pooranasinh	பூரணசின்ஹ்
Prince	பிரின்ஸ்
George	ஜார்ஜ்
Christian	கிறிஸ்டியன்
Bank	பேங்க்
of	ஆப்
America	அமெரிக்க
Plaza	பிளாஸா
Fort	ஃப்போர்ட்
mcnab	மெக்னாப்
Ankush	அன்குஷ்
Mahakaleshwar	மஹாகலேஷ்வர்
Jyotirlinga	ஜோதிர்லிங்க
Leverett	லெவெரெட்
Santosh	சந்தோஷ்
Samarah	சமரா
Jim	ஜிம்
Carter	கார்டர்
Akora	அகோரா
Dudhani	டுதானி
Hope	ஹோப்
Rani	ராணி
Aur	அவுர்
Jani	ஜானி
Michelle	மிஷேல்
Nostradum	நாஸ்ட்ராடம்
University	யூனிவர்சிட்டி
of	ஆஃப்
New	நியூ
South	சவுத்
Wales	வேல்ஸ்
Shergill	ஷெர்கில்
Shoorveer	ஷூர்வீர்
Palekar	பலேகர்
Mackinac	மாக்கினாக்
Ramapo	ராமாபோ
Aarti	ஆர்த்தி
Industrie	இண்டஸ்ட்ரி
Kiara	கியாரா
Baragaon	பாராகோன்
Chhabra	சப்ரா
Gugor	குகோர்
Paris	பாரீஸ்
Orly	ஓர்லி
Choki	சோக்கி
Sorath	சோரத்
Bhabhi	பாபி
Devaria	தேவாரியா
Ruggiero	ருக்கியாரோ
di	டி
Lauria	லாரியா
Vibhuti	விபூதி
Bhushan	பூஷன்
Merlin	மெர்லின்
kville	க்விலே
Kunti	குன்ட்டி
Paighaam	பைகாம்
Joie	ஜோயி
Kirin	கிரின்
Brewery	ப்ரூவேரி
Company	கம்பெனி
Genna	ஜென்னா
Aahlaad	ஆஹ்லாத்
Nasiruddin	நஸிருத்தீன்
Sailani	சைலானி
Badesha	பாதேஷா
Pratap	பிரதாப்
Banhishikha	பன்ஹிஷிகா
Buldhana	புல்தானா
Tata	டாடா
Finance	ஃபைனான்ஸ்
Ivory	ஐவரி
Coast	கோஸ்ட்
Midway	மிட்வே
Trent	ட்ரெண்ட்
Chhindwara	சிண்ட்வாரா
Junction	ஜங்ஷன்
Tatini	தாதினி
Anoush	அனவ்ஷ்
Odele	ஓடெல்
Museum	மியூஸியம்
of	ஆஃப்
Anthropology	ஆன்த்ரோபாலஜி
Dirt	டேர்ட்
Bike	பைக்
Racing	ரேசிங்
E'jaaz	இ'ஜாஸ்
Rexam	ரெக்ஸாம்
Sanjana	சஞ்சனா
Paraye	பராயெ
Bas	பஸ்
Mein	மேன்
Kendurkar	கெந்துர்கர்
Terrence	டெரன்ஸ்
Gold	கோல்ட்
hathur	ஹாதுர்
Ghar	கர்
Ghar	கர்
Mein	மெயின்
Diwali	திவாளி
Tate	டேட்
Gallery	கேலரி
Nachiket	நாச்சிகேத்
Shripati	ஸ்ரீபதி
Afjal	அஃப்ஜல்
Mid-day	மிட்-டே
Ecrins	எக்ரின்ஸ்
Rabat	ரபாத்
Bishan	பிஷான்
Singh	சிங்
Bedi	பேடி
Cesar	சீசர்
Award	அவார்ட்
Phaninath	பனிநாத்
Saheb	சாஹெப்
Bahadur	பஹதூர்
Bairagarh	பைராகார்
Barun	பருண்
Muslim	முஸ்லிம்
Ka	கா
Lal	லால்
Baalgopaal	பால்கோபால்
Dial	டயல்
Kiranmay	கிரண்மை
Daliganj	தாலிகஞ்ச்
Adam	அதம்
Shahaane	சஹானி
Vaikraant	வைக்ராந்த்
Shoreham	ஷோர்ஹாம்
redoubt	ரீடவுட்
Bob	பாப்
Packwood	பேக்வுட்
Sugouri	சுகௌரி
Kapila	கபில்லா
Kashish	காசிஷ்
Sheetalaa	ஷீடலா
Sabarwal	சபர்வால்
Elfat	எல்ஃபாத்
Cholamandalam	சோழமண்டலம்
Lal	லால்
Chitthi	சிட்தி
John	ஜான்
Grisham	க்ரிஷாம்
Ravi	ரவி
Shastri	ஷாஸ்த்ரி
Thyra	தைரா
Attala	அட்டாலா
Order	ஆர்டர்
for	ஃபார்
merits	மெரிட்ஸ்
to	டோ
Lithuania	லூதியானா
Rangnathar	ரங்கநாதர்
Dave	டேவ்
Richardson	ரிச்சர்ட்சன்
Pyar	பியார்
Ka	கா
Sapna	ஸப்னா
Janani	ஜனனி
Francium	ஃப்பிரான்ஷியம்
Aurobindo	அரபிந்தோ
Memorial	மெமோரியல்
School	ஸ்கூல்
Rawahah	ரவஹாஹ்
Fiorenza	ஃபியோரென்சா
Chittapur	சித்தாபூர்
Hite	ஹைட்
Road	ரோட்
Achyut	அச்சியுத்
Davangere	தாவங்கேரே
Netra	நேத்ரா
Gallagher	கேலாகெர்
Kemijarvi	கெமிஜர்வி
Cailean	கைலீன்
Chomun	சோமுன்
Samod	சமோத்
Tenet	டெனெட்
Healthcare	ஹெல்த்கேர்
Pavanjit	பவன்ஜித்
Guest	கெஸ்ட்
House	ஹவுஸ்
Shad	ஷத்
Wasimah	வஸிமா
Surya	சூர்ய
Pahar	பஹர்
Ankushee	அன்குஷீ
Austro-Turkish	ஆஸ்டிரோ-டர்க்கிஷ்
War	வார்
Imad	இமாத்
Picklecombe	பிக்கல்காம்பே
fort	ஃப்போர்ட்
Aarambh	ஆரம்ப்
Falah	ஃபலாஹ்
Exelon	எக்ஸ்லான்
Anilaatmaj	அனிலாத்மஜ்
Wasilah	வஸிலா
Raigad	ரைகாத்
fort	ஃப்போர்ட்
Naoki	நாவோக்கி
Prize	ப்ரைஸ்
Kamrup	காம்ரப்
Aachaaryanandana	ஆசார்யானான்தனா
Hanso	ஹன்சோ
Hanso	ஹன்சோ
Aye	ஆயே
Duniya	துனியா
Walo	வாலோ
Karunashankar	கருணாஷங்கர்
Graeme	கிராயெம்
Fowler	ஃப்போலெர்
Mauritius	மொரீஷியஸ்
Fort	ஃப்போர்ட்
revelin	ரெவேலின்
Vaaghmare	வாக்மாரே
Arjuna	அர்ஜுனா
Ranatunga	ரனதுங்கா
Fort	ஃப்போர்ட்
elson	எல்சன்
Order	ஆர்டர்
of	ஆஃப்
Leopold	லியோபோல்ட்
Cheema	சீமா
Sir	சர்
Winston	வின்ஸ்டன்
Churchill	சர்ச்சில்
Jewett-Cameron	ஜூவெட்-கேமரான்
Trading	டிரேடிங்
Company	கம்பெனி
Faraz	ஃபராஸ்
Stalin	ஸ்டாலின்
Bagga	பாக்கா
Jawani	ஜவானி
Ki	கி
Kahani	கஹானி
Harishchandra	ஹரிஷ்சந்திர
Taramati	தாராமதி
Spanish	ஸ்பானிஷ்
war	வார்
between	பிட்வீன்
England	இங்கிலாண்ட்
and	அண்ட்
France	ஃப்பிரான்சு
Aakhri	ஆக்ரி
Khat	காத்
Surekha	சுரேகா
Fateenah	ஃபதீனா
Indira	இந்திரா
Gandhi	காந்தி
Bedekar	பெதேகர்
Sukhanand	சுகானந்த்
Jadhav	ஜாதவ்
Amguri	அம்குரி
Mandy	மேண்டி
Yachad	யச்சாத்
Dobbelaar	பாப்லார்
Lockeridge	லாக்கரிட்ஜ்
Makayla	மகேலா
Natalia	நடாலியா
Cecile	செசிலி
Jhitaruraam	ஜிதாருராம்
Gore	கோர்
Jathhar	ஜத்ஹர்
Ram	ராம்
Bhakt	பக்த்
Hanuman	ஹனுமான்
Duguid	டகுயித்
Trixie	ட்ரிக்ஸி
Order	ஆர்டர்
of	ஆஃப்
Liberty	லிபர்டி
Amritap	அம்ரிதாப்
Henkel	ஹென்கல்
Cholang	சோலாங்
Museum	மியூஸியம்
of	ஆஃப்
Royal	ராயல்
Palace	பாலஸ்
Nitya	நித்யா
Aacharyanandana	ஆசார்யானான்தனா
Sanjula	சஞ்ஜுலா
Dehri	டெஹ்ரி
On	ஆன்
Sone	சோனே
Mengkuang	மெங்முவாங்
Dam	டேம்
Unnat	உன்னத்
Rayyan	ரய்யன்
Lillian	லிலியன்
Ahista	அஹிஸ்டா
Ahista	அஹிஸ்டா
Maluka	மலுகா
Chand	சந்த்
Aur	ஔர்
Suraj	சுரஜ்
Sulayman	சுலய்மான்
David	டேவிட்
Mutendera	முடேண்ட்ரா
Professor	புரொஃப்பசர்
Su'ad	சுவத்
Azadi	ஆஸாதி
Ke	கே
Baad	பாத்
Gurudatta	குருதத்தா
Shawn	ஷான்
Bahadur	பஹதுர்
Kisan	கிசான்
Prem	பிரேம்
Ki	கி
Jyoti	ஜோதி
American	அமெரிக்கன்
Academy	அகாடமி
of	ஆஃப்
Arts	ஆர்ட்ஸ்
and	அண்ட்
Letters	லெட்டர்ஸ்
Fiction	பிக்‌ஷன்
Award	அவார்ட்
Babhru	பாப்ரு
Diplana	திப்லானா
Nepal	நேபாளம்
Bangrod	பங்ரோட்
Aurav	ஆரவ்
Pyar	பியார்
Jhukta	ஜுக்தா
Nahin	நஹின்
Somerset	சோமர்செட்
Maugham	மாஹம்
Award	அவார்ட்
Sangdil	சங்தில்
Samaj	சமாஜ்
Minjonet	மின்ஜோனெட்
Veerbhum	வீர்பம்
Kalanki	கலன்கி
Sumitranandan	சுமித்ராநந்தன்
Pant	பண்ட்
Pooja	பூஜா
Lorne	லோர்ன்
Kavita	கவிதா
Johnson	ஜான்ஸன்
Controls	கன்டிரோல்ஸ்
West	வெஸ்ட்
Side	ஸைட்
General	ஜெனரல்
Baptist	பேப்டிஸ்ட்
Delora	டெலோரா
Jai	ஜெய்
Karoli	கரோலி
Maa	மா
Bundi	புந்தி
Chandil	சண்டில்
Junction	ஜங்ஷன்
Nanjing	நாஞ்ஜிங்
Museum	மியூஸியம்
Wockhardt	வோக்ஹார்ட்
Telugu	தெலுகு
Dennis	டென்னிஸ்
Rodman	ராட்மேன்
Meri	மேரி
Jung	ஜங்
Amreek	அம்ரீக்
Nevan	நெவன்
Kajal	காஜல்
Sharma	ஷர்மா
Waheeda	வஹீதா
Roch	ரோச்
Manasijaa	மனாஸிஜா
Sibley	ஸிப்லே
Vardha	வர்தா
Eastman	ஈஸ்ட்மேன்
Kodak	கோடக்
Luckett	லுக்கெட்
Aliwal	அலிவால்
Truckin	டிரக்கின்
Fort	ஃப்போர்ட்
monckton	மான்க்டன்
Jhambaari	ஜாம்பாரி
Goodwin	குட்வின்
Anuvaa	அனுவா
Hum	ஹம்
Se	சே
Hai	ஹை
Zamana	ஸமானா
Bhopatkar	போபத்கர்
Aaj	ஆஜ்
Ki	கி
Baat	பாத்
Lokayan	லோகயன்
Doris	டோரிஸ்
Catherine	கேத்தரின்
Turner	டர்னர்
Fort	ஃப்போர்ட்
blauwkapel	பிலாவ்காபெல்
Wasifah	வசீஃபா
Dorothy	டொரோத்தி
Darnarik	டார்னாரிக்
Farz	ஃபர்ஸ்
Ki	கி
Jung	உங்
Texas	டெக்சாஸ்
Health	ஹெல்த்
Science	சயின்ஸ்
Center	சென்டர்
Dumbra	டும்ப்ரா
James	ஜேம்ஸ்
Foster	ஃப்பாஸ்டர்
Chhota	சோட்டா
Baap	பாப்
Raiseni	ராய்சேனி
Trafalgar	டிராஃப்பால்கர்
Meghnad	மேக்னாத்
Siddhi	சித்தி
Vinayak	விநாயக்
Raeeszada	ரயீஸ்சதா
Indiana	இண்டியானா
University	யூனிவர்சிட்டி
East	ஈஸ்ட்
Dewanganj	தேவன்கஞ்ச்
Algawan	அல்கவான்
Hum	ஹம்
Tum	தும்
Aur	ஔர்
Who	ஹூ
Jaag	ஜாக்
Utha	உதா
Insaan	இன்சான்
University	யூனிவர்சிட்டி
of	ஆஃப்
Ulster	உல்ஸ்டர்
Shahrukh	ஷாருக்
Jasminder	ஜஸ்மிந்தர்
Augustin	அகஸ்டின்
Apurvaa	அபூர்வா
Brahamdev	ப்ரஹம்தேவ்
Naag	நாக்
Champa	சம்பா
Forbes	ஃபோர்ப்ஸ்
Gokak	கோகாக்
Jagadhidh	ஜகதீத்
Naya	நயா
Darpan	தர்பன்
Yaqub	யாகுப்
Chuchura	சுச்சுரா
Serengeti	செரெண்கேட்டி
Tawanda	டவாண்டா
Mupariwa	மபுரிவா
Evania	இவானியா
Museum	மியூஸியம்
of	ஆஃப்
Dionysios	டையோனிசியோஸ்
Solomos	சோலோமாஸ்
and	அண்ட்
Eminent	எமினென்ட்
Zakynthians	ஸாக்கின்தியன்ஸ்
Barkaat	பர்காத்
Champaner	சம்பனேர்
Road	ரோட்
Junction	ஜங்ஷன்
Mississippi	மிஸிஸிப்பி
Medhaa	மேதா
Jayaditya	ஜெயதித்யா
Mohabbat	மொஹபத்
Zindabad	ஸிந்தாபாத்
Uttar	உத்தர்
Golf	கோல்ஃப்
Ramnaresh	ராம்நரேஷ்
Sarwan	சர்வாண்
University	யூனிவர்சிட்டி
of	ஆஃப்
canberra	கேன்பெர்ரா
Rene-Levasseur	ரேனே-லேவஸியர்
Roll	ரோல்
Asokhar	அசோக்ஹார்
Tu	து
Hi	ஹை
Tu	து
Najma	நஜ்மா
Bhakti	பக்தி
Nagar	நகர்
Pragathi	பிராகதி
High	ஹ
School,	ஸ்கூல்,
Sitaphalmandi,	சிதாபால்மாண்டி,
Secunderabad	செக்குந்திராபாத்
Madan	மடன்
Manjari	மஞ்ஜாரி
Colonial	கலோனியல்
Heights	ஹைட்ஸ்
Baptist	பேப்டிஸ்ட்
Carolena	காரோலீனா
American	அமெரிக்கன்
War	வார்
of	ஆப்
Independence	இன்டிபென்டென்ஸ்
Sangli	சான்கிலி
Yeardley	இயர்ட்லி
Panhala	பான்ஹாலா
Cardiff	கார்டிஃப்
University	யூனிவர்சிட்டி
Mere	மேரெ
Baad	பாத்
Dhiya	தியா
Malaysia	மலேஷியா
Bazooband	பஸூபந்த்
Gillette	ஜில்லெட்
India	இந்தியா
Bellevue	பெல்லேவு
Christian	கிறிஸ்டியன்
Santhal	சன்தல்
Pargana	பர்கானா
Maryada	மர்யாதா
Mahommed	மஹோமெத்
Ghaus	காயெஸ்
Gajapaal	கஜாபால்
Library	லைப்ரரி
of	ஆஃப்
Congress	காங்கிரஸ்
Living	லிவிங்
Legend	லெஜண்ட்
Hashir	ஹஷிர்
Church	சர்ச்
of	ஆஓ
the	தி
Harvest	ஹார்வஸ்ட்
Laiq	லைக்
Tata	டாடா
Sons	சன்ஸ்
Dhumr	தும்ரு
Mirchandani	மிர்சந்தனி
Yorktown	யோர்க்டவுன்
Mushfiqur	முஷ்ஃப்பிகுர்
Rahman	ரஹ்மான்
Samayapuram	சமயபுரம்
Hoor-E-Arab	ஹூர்-ஏ-அரப்
Condoleeza	காண்டோலீசா
Rice	ரைஸ்
Abhimanyusut	அபிமன்யூசுத்
Ghungroo	குங்ரூ
Thomas	தாமஸ்
Hobbs	ஹாப்ஸ்
Chaman	சாமான்
Dindayal	தீனதயாள்
Opra	ஓப்ரா
Winfre	வின்ஃப்ரி
Nazirah	நஸீரா
Toran	தோரன்
Matwala	மாத்வாலா
Paanch	பான்ச்
Fauladi	ஃப்பெளலாடி
Saman	சமன்
Jayantha	ஜெயந்தா
Evette	இவெட்டே
Musaddiq	முஸாதிக்
Balram	பல்ராம்
Shrikrishna	ஸ்ரீகிருஷ்ணா
Biroliya	பிரோலியா
Chalti	சல்தி
Ka	கா
Naam	நாம்
Gaadi	காடி
Sir	சர்
Darya	தார்யா
Ian	ஐயான்
Chappell	சாப்பல்
Wavre-sainte-catherine	வாவ்ரே-செயிண்டெ-காத்ரீன்
Earth	ஏர்த்
Royal	ராயல்
Arch	ஆர்ச்
Nagarjuna	நாகார்ஜுனா
Fert	ஃபெர்ட்
Hardanger	ஹார்டங்கர்
fiddle	ஃபிடில்
Sambhav	சம்பவ்
Luxembourg	லக்சம்பர்க்
Chimayi	சிமாயி
Toppan	டாப்பன்
Printing	பிரிண்டிங்
Cipla	சிப்லா
University	யூனிவர்சிட்டி
of	ஆஃப்
Bristol	ப்ரிஸ்டால்
Chelsa	செல்ஸா
James	ஜேம்ஸ்
Jivan	ஜீவன்
Thurayya	துரய்யா
Auryon	ஆரீயான்
Anisha	அனிஷா
Riordan	ரியோர்தன்
Vanshadhar	வன்ஷதார்
Harshe	ஹர்ஷே
Mambo	மாம்போ
Makaila	மகைலா
Bekrar	பெக்ரார்
Mercantour	மெர்கான்டர்
Dannie	டேனி
Heineman	ஹீன்மேன்
Prize	ப்ரைஸ்
Bombay	பாம்பே
Dyeing	டையிங்
Puraskaar	புராஸ்கார்
Madhavi	மாதவி
Thomas	தாம்ஸ்
Hardy	ஹார்டி
Godhra	கோத்ரா
Junction	ஜங்ஷன்
Yawatmal	யாவாட்மல்
Mutsu	முட்ஸு
Asif	ஆசிஃப்
Iqbal	இக்பால்
Sewnarine	சியூநாராய்ண்
Chattergoon	சேட்டர்கூன்
Shrihari	ஸ்ரீஹரி
Kyushu	க்யூஷூ
Electric	எலக்டிரிக்
Power	பவர்
Gharpure	கர்புரே
Bhoura	போரா
Arun	அருண்
Shourie	ஷோரி
Revolt	ரிவோல்ட்
in	இன்
the	த
Vendee	வென்டீ
Tarunima	தருணிமா
Ushashi	உஷாஷி
Crownhill	க்ரவுன்ஹில்
fort	ஃப்போர்ட்
Jhalak	ஜாலக்
Condorcet	கான்டார்செட்
United	யுனைடெட்
India	இந்தியா
Insurance	இன்சூரன்ஸ்
Mittal	மித்தல்
Steel	ஸ்டீல்
Private	பிரைவெட்
Detective	டிடெக்ட்டிவ்
Tasneen	தஸ்னீன்
Gogorron	கோகோரோன்
Joul	ஜெளல்
Livingston	லிவிங்ஸ்டன்
Graf	கிராஃப்
Zeppelin	ஸெப்பெலின்
Zakir	ஸாகிர்
Hasan	ஹாசன்
Shahar	ஷாஹர்
Se	சே
Door	தூர்
Joel	ஜோயல்
Daman	தமன்
Aur	ஔர்
Aag	ஆக்
College	காலேஜ்
Girl	கேர்ள்
Manjareek	மஞ்சரீக்
Badreeprasad	பத்ரிபிரசாத்
Japesh	ஜபேஷ்
Noel	நோயல்
David	டேவிட்
Raj	ராஜ்
Nandini	நந்தினி
Hamilton	ஹேமில்டன்
Masakadza	மசகட்ஸா
Palk	பால்க்
Rahabar	ரஹபர்
Norwich	நார்விச்
University	யூனிவர்சிட்டி
Museum	மியூஸியம்
Charlotte	சார்லட்
Vartouhi	வர்தௌஹி
Dekalb-Peachtree	டெக்கல்ப்-பீச்ட்ரீ
Saggai	சகாய்
Suwaydah	சுவய்தா
Benin	பெனின்
Bankimchandra	பங்கிம்சந்திரா
Rama	ராமா
Newsprint	நியூஸ்ப்ரிண்ட்
One-step	ஒன்-ஸ்டெப்
Jawani	ஜவானி
Solah	சோலாஹ்
Saal	சால்
Ki	கி
Azaraaq	அஸாராக்
Taro	டாரோ
Pharmaceutical	பார்மாசெட்டிக்கல்
Industries	இண்டஸ்டிரீஸ்
Chalthan	சல்தான்
Holikaa	ஹோலிகா
Mamduh	மம்தூ
Bhartiya	பாரதிய
Kyna	கைனா
Agreement	அக்ரீமெண்ட்
Order	ஆர்டர்
of	ஆஃப்
Merit	மெரிட்
of	ஆஃப்
the	தி
Principality	ப்ரின்சிபாலிட்டி
of	ஆஃப்
Liechtenstein	லீச்டென்ஸ்டீன்
Yuktika	யுக்திகா
Aadinath	ஆதினாத்
Jhoom	ஜூம்
Utha	உதா
Akaash	ஆகாஷ்
Laramie	லாராமி
Goriyan	கோரியான்
Ivvavik	இவ்வாவிக்
Jalal	ஜலால்
al-Din	அல்-தின்
Rumi	ருமி
Shubhaasheesh	ஷுபாஷீஷ்
Dummer's	டும்மெர்ஸ்
War	வார்
Michelle	மிஷேல்
Kenny	கென்னி
Do	தோ
Mastane	மஸ்தானே
Callum	காலும்
Adishree	ஆதிஸ்ரீ
Raj	ராஜ்
Kanya	கன்யா
Dapodi	தபோடி
Jawahar	ஜவஹர்
Venkateshvar	வெங்கடேஷ்வர்
Abdus	அப்துஸ்
shafee	ஷாஃபீ
Dharti	தர்தி
Ke	கே
Lal	லால்
Henry	ஹென்ரி
Ford	ஃபோர்ட்
Joseph	ஜோசப்
Campbell	கேம்பெல்
White	ஒயிட்
Aagashe	ஆகாஷ்
Vaataketu	வாதகேது
Uqbah	உக்பா
Neptunium	நெப்டூனியம்
Suvarnaprabha	சுவர்ணபிரபா
Sophia	சோபியா
High	ஹை
School	ஸ்கூல்
Stefan	ஸ்டிஃபன்
Peter	பீட்டர்
Rawson	ராசன்
Amin	அமின்
Dharti	தர்தி
Kahe	கஹே
Pukar	புகார்
Ke	கே
Hibatullah	ஹிபதுல்லா
Urooj	உரூஜ்
Ek	ஏக்
Din	தின்
Bahu	பாஹு
Ka	கா
Shashiprabh	ஷஷிபிரபா
Barsi	பார்ஸி
Takli	தக்லி
Massena	மாஸ்ஸெனா
Abdul	அப்துல்
wajid	வாஜித்
House	ஹவுஸ்
of	ஆப்
Prayer	பிரேயர்
Lutheran	லுதெரன்
Berger	பெர்ஜர்
Paints	பெயிண்ட்ஸ்
Devajyoti	தேவஜோதி
Chhipadohar	சிப்படோஹர்
Ambika	அம்பிகா
Lokadi	லோகதி
Maitree	மைத்ரி
Ratan	ரதன்
Deep	தீப்
Bachan	பச்சன்
Lohgad	லாஹ்காத்
Vipul	விபுல்
Didier	டிடியேர்
Sri	ஸ்ரீ
Ramakrishna	ராமகிருஷ்ணா
Vidyashala,	வித்யஷாலா,
Mysore	மைசூர்
Atchafalaya	அட்சாபாலாயா
Akmaal	அக்மால்
Zuari	ஜுவாரி
Industries	இண்டஸ்ட்ரீஸ்
Baluran	பலுரான்
Emerald	எமரால்ட்
Mohammad	மொஹம்மத்
Sharif	ஷரீஃப்
Guldhar	குல்தார்
Alhad	அல்ஹாத்
Kameng	காமெங்
Tochi	தோச்சி
June	ஜூன்
Conocophillips	கோனகோபிலிப்ஸ்
Sidhhardh	சித்தார்த்
Saubal	சௌபல்
King	கிங்
Edward	எட்வர்ட்
VII	VII
Avikshit	அவிக்ஷித்
Anees	அனீஸ்
Selene	செலினி
Order	ஆர்டர்
of	ஆஃப்
the	தி
Precious	ப்ரெஷியஸ்
Crown	க்ரவுன்
Laiqah	லய்கா
Fort	ஃப்போர்ட்
clatsop	கிளாட்சாப்
Khush	குஷ்
Raho	ராஹோ
Zareenah	ஜரீனா
Dildarnagar	தில்தர்நகர்
Junction	ஜங்ஷன்
Kanika	கனிகா
Cuddalore	கூடலூர்
Junction	ஜங்ஷன்
Museum	மியூஸியம்
of	ஆஃப்
Welsh	வெல்ஷ்
Life	லைஃப்
Mitravaan	மிதேஷ்
Chal	சல்
Chal	சல்
Re	ரே
Naujawan	நௌஜவான்
Scrots	ஸ்க்ராட்ஸ்
Prisca	ப்ரிஸ்கா
Babhnan	பாப்னான்
Brown	புரவுன்
Abdul	அப்துல்
muhaymin	முஹாய்மின்
Check	செக்
Point	பாயிண்ட்
Software	சாப்ட்வேர்
Technologies	டெக்னாலஜீஸ்
Vitalis	விதலிஸ்
Rajeshwar	ராஜேஷ்வர்
Tom	டாம்
Moody	மூடி
Dempster	டெம்ப்ட்ரஸ்
Lake	லேக்
Street	ஸ்டிரீட்
Church	சர்ச்
of	ஆப்
Evanston	இவன்ஸ்டன்
Luke	லுக்
Flint	ஃப்ளிண்ட்
Clive	கிளிவ்
Radley	ராட்லே
Oliver	ஆலிவர்
Stone	ஸ்டோன்
Anadyant	அனாத்யன்ட்
Marv	மர்வ்
Willie	வில்லி
Nelson	நெல்சன்
Osprey	ஆஸ்ப்ரே
Magroor	மக்ரூர்
Nadeem	நதீம்
Ghauri	கோரி
Re	ரே
di	டி
Portogallo	போர்டோகாலோ
Asgari	அஸ்கரி
Chandrasekhara	சந்திரசேகரா
Tugal	துகல்
Jeene	ஜீனே
Do	தோ
Aziz	அஸிஸ்
Mahmud	மாஹ்முத்
Hudayi	ஹுதாயி
Murali	முரளி
Kartik	கார்த்திக்
Gurudwara	குருத்வாரா
Ritha	ரீட்டா
Sahib	சாஹிப்
Fisher	ஃப்பிஷ்ஷர்
Lanau	லானவ்
Center	சென்டர்
Hidayat	ஹிதயத்
Chalu	சலு
Mera	மேரா
Naam	நாம்
Murray	முர்ரே
Parker	பார்க்கர்
Dhawan	தவான்
Times	டைம்ஸ்
Internet	இன்டர்நெட்
Limited	லிமிடெட்
Almas	அலமாஸ்
Nursing	நர்ஸிங்
Pratishtha	ப்ரதிஷ்தா
Leonard	லியோனார்ட்
Nimoy	நிமோய்
Yauvani	யௌவனி
Girls	கேர்ள்ஸ்
Hostel	ஹாஸ்டல்
Hadiyah	ஹதியா
Srimati	ஸ்ரீமதி
Sulochanadevi	சுலோசனாதேவி
Singhania	சிங்கானியா
School,	ஸ்கூல்,
Thane	தானே
CISCO	சிஸ்கோ
Jawani	ஜவானி
Ki	கி
Lehren	லெய்ரென்
Muqtasid	முக்தாஸித்
Genevieve	ஜெனீவீ
Bushra	புஷ்ரா
Founders	ஃபவுண்டர்ஸ்
Cup	கப்
Kevin	கெவின்
Arnott	ஆர்னாட்
Nai	நயி
Reet	ரீத்
Hollywood	ஹாலிவுட்
Walk	வாக்
of	ஆஃப்
Fame	ஃபேம்
Madhumaan	மதுமான்
San	சான்
Matias	மாடியாஸ்
Kismat	கிஸ்மத்
Wala	வாலா
Ghar	கர்
Grihasti	கிரிஹஸ்தி
Princess	ப்ரின்சஸ்
Sarah	சாரா
Ferguson	ஃபெர்குசன்
Na'il	நாயில்
Majboor	மஜ்பூர்
Jayalalita	ஜெயலலிதா
Aur	ஔர்
Kaun	கோன்
National	நேஷனல்
Folk	ஃப்போக்
Museum	மியூஸியம்
Valentina	வாலண்டினா
Lalit	லலித்
Machhal	மாச்ஹால்
Amolak	அமோலக்
Sumantra	சுமந்த்ரா
Amolik	அமோலிக்
Teague	டீக்
Cahora	கஹோரா
Bassa	பஸ்ஸா
Dam	டேம்
Shesh	ஷேஷ்
Naag	நாக்
Shilpita	ஷில்பிதா
Hum	ஹம்
Matawle	மதவ்லே
Naujawan	நௌஜவான்
Zulm	ஸுல்ம்
Ka	கா
Badla	பாத்லா
Tarjani	தர்ஜானி
Chakraj	சக்ராஜ்
Mal	மால்
Adbul	அப்துல்
qawi	குவாயி
Jai	ஜெய்
Ambe	ஆம்பே
Maa	மா
Aayi	ஆயி
Yaad	யாத்
Teri	தேரி
Wuankara	உவான்காரா
Hayrah	ஹைரா
Brett	பிரெட்
Dorey	டோரே
Aakar	ஆகார்
Lacrosse	லாக்ரோஸ்
Sacred	சேக்ரெட்
Heart	ஹார்ட்
Senior	சீனியர்
Secondary	செக்கன்டரி
School,	ஸ்கூல்,
Chandigarh	சண்டிகர்
Regina	ரெஜினா
Margherita	மார்கெரிடா
Ishwar	ஈஷ்வர்
Allah	அல்லா
Tere	தேரே
Naam	நாம்
Amurt	அமுர்த்
National	நேஷனல்
Order	ஆர்டர்
of	ஆஃப்
Quebec	க்யூபெக்
Virdi	விர்தி
Aachaaraya	ஆசாரயா
Tarmon	டார்மோன்
Fort	ஃப்போர்ட்
richardson	ரிசார்ட்சன்
Rama	ராமா
O	ஓ
Rama	ராமா
Frank	ஃபிராங்
furt	ஃபர்ட்
Meyrick	மெய்ரிக்
Pringle	ப்ரிங்கிள்
Puranik	புரானிக்
Jab	ஜப்
Yaad	யாத்
Kisi	கிசி
Ki	கி
Aati	ஆதி
Hai	ஹை
Gabriel	கேப்ரியல்
India	இந்தியா
Mike	மைக்
Rindel	ரிண்டல்
Tudor	ட்யூடர்
Ek	ஏக்
Khilari	பிலாரி
Bawan	பவன்
Pattey	பட்டே
Corus	காரஸ்
Group	குரூப்
Dhiren	திரேன்
Oberoi	ஓப்ராய்
Hotels	ஹோட்டல்ஸ்
Colin	கோலின்
Cowdrey	கவ்டிரே
Gharoda	காரோடா
Mandy	மேண்டி
Gurudas	குருதாஸ்
Victory	விக்டரி
Assembly	அசெம்ப்ளி
of	ஆப்
God	காட்
Johar	ஜோஹர்
In	இன்
Kashmir	காஷ்மிர்
Mandu	மான்டு
San	சன்
Diego	டீகோ
Fabio	ஃபாபியோ
Pratidin	பிராதிதின்
Bonchune	பான்சுனெ
Mande	மண்டே
Geeta	கீதா
Mera	மேரா
Naam	நாம்
Kullursandai	குல்லுர்சந்தை
Reservoir	ரிசர்வாயர்
Flann	ஃப்ளான்
Shankhamala	ஷங்கமாலா
Fort	ஃப்போர்ட்
albany	ஆல்பனி
Lojki	லோஜ்கி
Paul	பால்
Taylor	டேலர்
Hubba	ஹப்பா
Yaman	யமன்
Aldan	அல்டன்
Bhayavadar	பயவதார்
Shoesmith	ஹூஸ்மித்
Molybdenum	மோலிப்டெனம்
Vijaya	விஜய
karnataka	கர்னாட்டக்கா
Melissa	மெல்லிசா
Mark	மார்க்
Municipal	முனிசிப்பல்
Gallery	கேலரி
of	ஆஃப்
Piraeus	பைரியாஸ்
Golden	கோல்டன்
Leopard	லெப்பர்ட்
Mukesh	முகேஷ்
Gangaganj	கங்காகஞ்ச்
Baghdad	பாக்தாத்
Ka	கா
Chor	சோர்
Bu	பு
Ali	அலி
Shah	ஷா
Qalandar	காலாந்தர்
Acharyanandan	ஆசார்யானான்தன்
Bilal	பிலால்
Asad	ஆசாத்
Jupiter	ஜுபிடர்
Bio	பயோ\
Wallbank	வால்பேங்க்
Ahankaar	அஹங்கார்
Preet	ப்ரீத்
Ka	கா
Geet	கீத்
Anamitra	அனமித்ரா
Maik	மைக்
Bony	போனி
Blair	ப்ளேர்
Fort	ஃப்போர்ட்
de	டி
chartres	சார்டிரெஸ்
Columbus	கொலம்பஸ்
Spectrum	ஸ்பெக்ட்ரம்
Signal	சிக்னல்
Processing	பிராசசிங்
Aap	ஆப்
Aye	ஆயே
Bahaar	பஹார்
Aayee	ஆயி
Khamoshi	காமோஷி
Sesa	சேசா
Goa	கோவா
Suzette	சுஸெட்
Hartford	ஹார்ட்போர்ட்
Financial	ஃபினான்ஷியல்
Services	சர்வீசஸ்
Vilyat	வில்யாத்
Khan	கான்
Demetria	டெமேட்ரியா
Aazim	ஆசிம்
Majdi	மாஜ்தி
OpenTV	ஓபென்டீவி
Madrid	மாட்ரிட்
Barajas	பாராஜாஸ்
Boris	போரிஸ்
Yeltsin	எல்சின்
Mainpuri	மெயின்பூரி
Primo	ப்ரிமோ
Arlo	அர்லோ
Dongare	தோன்கரே
Katadare	கததாரே
Bhattu	பட்டூ
Cianna	சியான்னா
Ariadne	அரியாட்ன்
Khote	கோட்டெ
Sikkey	சிக்கே
President	பிரெஸிடெண்ட்
Hayes	ஹேயெஸ்
Pyar	பியார்
Ki	கி
Baaten	பாத்தென்
Hum	ஹம்
Intezaar	இன்டசார்
Karenge	கரேங்கே
Mahajan	மஹாஜன்
Greg	கிரெக்
Loveridge	லோவெரிட்ஜ்
Pushpeshu	புஷ்பேஷு
Vaal	வால்
dam	டேம்
Najeeb	நஜீப்
Eeshvar	ஈஷ்வர்
Atifa	அதிஃபா
Prabal	ப்ரபால்
Norbert	நார்பர்ட்
Phillip	ஃபிலிப்
Barnett	பார்னெட்
Geeta	கீதா
Bhavan	பவன்
Burlington	பர்லிங்டன்
Kawthar	கவ்தார்
Dillan	டில்லன்
Lal	லால்
Dupatta	துப்பட்டா
Shola	ஷோலா
Aur	அவுர்
Shabnam	ஷப்னம்
Crossroads	கிராஸ்ரோட்ஸ்
Christian	கிறிஸ்டியன்
Center	சென்டர்
Yogish	யோகிஷ்
Bade	படே
Dilwala	தில்வாலா
Ajaibpur	அஜய்பூர்
Dobro	டோப்ரோ
Birla	பிர்லா
Tyres	டயர்ஸ்
Alethea	அலெதியா
Mirc	மிர்க்
Electronic	எலக்ட்ரானிக்
Shiv	ஷிவ்
Charan	சரண்
Pushpinder	புஷ்பிந்தர்
Nimana	நிமனா
Jal	ஜல்
Bin	பின்
Machali	மச்சாலி
Rudi	ரூடி
Bryson	ப்ரைசன்
Jayashekhar	ஜெயசேகர்
Taline	டேலின்
Malang	மலங்
Himmat	ஹிம்மத்
Aur	ஔர்
Mehnat	மெஹ்னத்
Bansi	பன்ஸி
Paharpur	பஹர்பூர்
Ashwa	ஆஷ்வா
Ghosh	கோஷ்
Lilika	லிலிகா
Commando	கமாண்டோ
Mount	மவுண்ட்
Abu	அபு
Obalesh	ஓபலேஷ்
Srisailam	ஸ்ரீஸைலம்
Ati	ஆதி
Visisht	விசிஷ்ட்
Seva	சேவா
Medal	மெடல்
Tim	டிம்
Robinson	ராபின்சன்
Talal	தலால்
Nathan	நாதன்
Bracken	பிராக்கென்
Alec	அலெக்
Automotive	ஆட்டோமோடிவ்
Axle	ஆக்சில்
Shiv	ஷிவ்
Leela	லீலா
Lochan	லோச்சன்
Laurence	லாரன்ஸ்
Olivier	ஆலிவர்
Awards	அவார்ட்ஸ்
Balugan	பலுகான்
Bilpur	பில்பூர்
Andy	ஆண்டி
Rupak	ருபக்
Melbourne	மெல்போர்ன்
Cup	கப்
Kaethe	கேய்தி
Pyar	பியார்
Ki	கி
Kahani	கஹானி
Hamra	ஹம்ரா
Tawqir	தௌக்கீர்
Chinmay	சின்மை
Deandra	டீன்ந்த்ரா
Fathom	ஃபாதோம்
Five	ஃபைவ்
Eveready	எவரெடி
Ind	இண்ட்
Anemone	அனெமென்
Bancroft	பேங்க்ராஃப்ட்
Prize	ப்ரைஸ்
Haar	ஹார்
Jeet	ஜீத்
Aparaajitaa	அபராஜித்தா
Nanhe	நன்ஹெ
Munne	முன்னெ
Sharan	ஷரன்
Taipei	தைபே
101	101
Dudhwa	தூத்வா
Chennai	சென்னை
Egmore	எக்மோர்
Thanos	தானோஸ்
Evertsen	எவர்ட்சென்
Bapatla	பபாட்லா
Meenaa	மீனா
Maneeshaa	மனீஷா
Aaqib	ஆகுப்
Clayton	கிளேடன்
Vince	வின்ஸ்
Hogg	ஹாக்
Devasheesh	தேவஷீஷ்
Shehar	ஷீஹார்
Aur	அவுர்
Sapna	சப்னா
Fort	ஃப்போர்ட்
william	வில்லியம்
Shaun	ஷௌன்
Simmond	சிம்மான்ட்
The	த
hindu	ஹிந்து
Vritti	விர்த்தி
Fort	ஃப்போர்ட்
scott	ஸ்காட்
Harisingaar	ஷரிசிங்கார்
Luana	லுவன்னா
Mujhe	முஜே
Jeene	ஜீனெ
Do	தோ
Tabla	தப்லா
Turkey	டர்க்கி
trot	டிராட்
Naubahar	நவ்பாஹர்
Romeo	ரோமியோ
Sumter	சும்டெர்
Raghibah	ரகிபா
Batuque	பாடுக்
Rangeela	ரங்கீலா
Raja	ராஜா
Rue	ருய்
Chastity	சேஸ்ட்டிட்டி
Mohabbat	மொஹபத்
Aur	அவுர்
Jung	ஜங்
Do	தோ
Dooni	தூனி
Char	சர்
Mahabal	மஹாபல்
Lambada	லம்பாடா
Scouts	ஸ்கௌட்ஸ்
Rodeo	ரோடியோ
Mac Donnell	மெக்டோனல்
Dan	டான்
David	டேவிட்
Prize	ப்ரைஸ்
Basava	பசவ
Sagar	சாகர்
Dam	டேம்
Khallad	காலாத்
Buddhism	புத்திஸம்
Vrahaspativaar	விராஹஸ்பதிவார்
Furkating	ஃபுர்காடிங்
Junction	ஜங்ஷன்
Phulbani	பூல்பானி
Mere	மேரெ
Bhagwan	பாக்வான்
Carmine	கேர்மைன்
Kodgu	கோட்கு
Sherin	ஷெரின்
Gomti	கோமதி
Ke	கே
Kinare	கினாரே
Husn	ஹஸன்
Ka	கா
Ghulam	குலாம்
Schock	ஷோக்
Prize	ப்ரைஸ்
in	இன்
Mathematics	மேத்தமேட்டிக்ஸ்
Finola	ஃபினோலா
Renu	ரேணு
Kerinci	கெரின்சி
Seblat	செப்லாத்
Sidki	சித்கி
Guneru	குணேரு
Bamori	பமோரி
Wolf	உல்ஃப்
Prize	ப்ரைஸ்
in	இன்
Mathematics	மேத்தமேட்டிக்ஸ்
Lewis	லூயிஸ்
Farrakhan	ஃபாராகான்
Jeet	ஜீத்
Hamari	ஹமாரி
Dainik	டைனிக்
jugasankha	ஜுகாசன்கா
Labangalata	லபன்கலாதா
John	ஜான்
Paul	பால்
Getty	கெட்டி
Asli	அஸ்லி
Naqli	நக்லி
Abdul	அப்துல்
wahhab	வாஹ்ஹப்
Tamas	டமாஸ்
Aderyn	அடெரின்
Motor	மோட்டார்
Racing	ரேசிங்
Gisela	கிசேலா
Museum	மியூஸியம்
of	ஆஃப்
Modern	மாடர்ன்
Art	ஆர்ட்
Anany	அனன்ய்
Husn	ஹஸன்
Aur	ஔர்
Ishq	இஷ்க்
Bisla	பிஸ்லா
Valtina	வல்டினா
Shaqeeqah	ஷகீகா
Nasbandi	நாஸ்பந்தி
Chacha	ச்சாச்சா
Zindabad	ஜிந்தாபாத்
Sultani	சுல்தானி
Harisingar	ஹரிசிங்கர்
Afsana	அஃப்சானா
Pyar	பியார்
Ka	கா
Titicaca	டிட்டிகாகா
Rodney	ரோட்னி
Dennis	டென்னிஸ்
Lillee	லில்லீ
Shravani	ஷரவனி
Birla	பிர்லா
Nadaleen	நதலீன்
Larchmont	லர்ச்மோண்ட்
Avenue	அவென்யு
Princess	பிரின்சஸ்
Royal	ராயல்
Anasah	அனாஸா
Abdus	அப்துஸ்
shakoor	ஷாகூர்
Silver	சில்வர்
Tarun	தருன்
bharat	பாரத்
Dahar	தாஹர்
Ka	கா
Balaji	பாலாஜி
Richard	ரிச்சர்ட்
Sims	சிம்ஸ்
Jimmy	ஜிம்மி
Hendricks	ஹென்ரிக்ஸ்
Deshalpar	தேஷல்பர்
Martine	மார்ட்டின்
Lal	லால்
Batti	பாட்டி
Raat	ராத்
Andheri	அன்தேரி
Thi	தி
Peter	பீட்டர்
Toohey	டூஹே
Kupwada	குப்வாதா
Dexter	டெக்ஸ்டர்
Shaun	ஷுவான்
Udal	உடால்
Vanhishikha	வன்ஹிஷிகா
Gogia	கோகியா
Romeo	ரோமியோ
Juliet	ஜூலியட்
Isabelle	இசாபெல்
John	ஜான்
Bracewell	பிரேஸ்வெல்
Vibhaa	விபா
Ek	ஏக்
Din	தின்
Aadhi	ஆதி
Raat	ராத்
Dulhan	துல்ஹன்
Wohi	வோஹி
Jo	ஜோ
Piya	பியா
Man	மன்
Bhaye	பாயே
Roentgenium	ரோஏன்ட்ஜீனியம்
Michael	மைக்கல்
Clarke	கிளார்க்
Dudhia	டுத்தியா
Khurd	குர்த்
Merch	மெர்ச்
Gundappa	குன்டப்பா
Viswanath	விஸ்வனாத்
Rik	ரிக்
Indraja	இந்திரஜா
Malhan	மல்ஹான்
Dindigul	திண்டுக்கல்
Junction	ஜங்ஷன்
Paul	பால்
and	அண்ட்
Alexandra	அலெக்ஸாடிரா
Canellopoulos	கானெல்லோபோலோஸ்
Museum	மியூஸியம்
Mradul	ம்ரடுல்
Dukh	துக்
Dard	தர்த்
Abril	எப்ரில்
Ghar	கர்
Ho	ஹோ
To	தோ
Aisa	அயிசா
Zeya	ஸெயா
Nellur	நெல்லூர்
Satya	சத்யா
Fawzan	ஃபாவ்ஸான்
Vermont	வெர்மாண்ட்
Charlie	சார்லி
Lock	லாக்
Bob	பாப்
Hope	ஹோப்
Samtel	சாம்டெல்
Color	கலர்
Khatta	கத்தா
Meetha	மீத்தா
Mahrajganj	மஹ்ராஜ்கன்ஞ்
Honda	ஹோன்டா
Motor	மோட்டார்
Vyas	வியாஸ்
Shivaa	ஷிவா
Dominican	டாமினிக்கன்
merengue	மெரென்க்
Warrick	வாரிக்
Borgaonkar	போர்காவூன்கர்
Chandok	சந்தோக்
Gordy	கார்டி
Raipur	ரைபூர்
Saahas	சாஹஸ்
Goneana	கொனியேனா
Pehli	பெஹ்லி
Shadi	ஷாதி
Kantele	கன்டிலி
Order	ஆர்டர்
of	ஆஃப்
the	தி
Redeemer	ரீடீமர்
Kaydence	கேடென்ஸ்
Aan	ஆன்
Milo	மிலோ
Sajna	சாஜ்னா
Pragyawati	ப்ரக்யவதி
Magnificent	மாக்னிஃப்பீசெண்ட்
Baligh	பாலிக்
Vaigai	வைகை
Reservoir	ரிசர்வாயர்
Napoleon	நெப்போலியன்
Bonaparte	போனபார்ட்
Refugee	ரெஃப்யூஜீ
Char	சார்
Darvesh	தர்வேஷ்
Maa	மா
Ki	கி
Saugandh	செளகந்த்
Marghoob	மர்கூப்
Rashid	ரஷித்
Patel	பட்டேல்
John	ஜான்
Jameson	ஜேம்ஸன்
Chand	சந்த்
Siau	சியாவு
Sanghod	சங்கோத்
Stephan	ஸ்டிஃபன்
Vin	வின்
Khanna	கண்ணா
Sir	சர்
Garry	கேரி
Sobers	சோபர்ஸ்
Swanson	ஸ்வான்சன்
Compugen	காம்பூஜென்
Fipple	ஃபிப்பில்
Milwaukee	மில்வாவ்கி
Sulakshana	சுலக்ஷனா
Elle	எல்
Hum	ஹம்
Dono	தோனோ
Laurel	லாரல்
Fiorello	ஃபியோரெல்லோ
Haadsa	ஹாட்சா
Obayashi	ஓபேயாஷி
Viribus	விரிபஸ்
Unitis	யூனிடிஸ்
Bewafai	பேவஃப்பை
Marvin	மர்வின்
Governor	கவர்னர்
General's	ஜெனரல்ஸ்
Award	அவார்ட்
Manzoor	மன்சூர்
Elahi	இலாஹி
Prem	பிரேம்
Ki	கி
Devi	தேவி
Paraas	பராஸ்
Ek	ஏக்
Teri	தேரி
Nishani	நிஷானி
Ewa	ஈவா
Detroj	தேட்ரோஜ்
Kimber	கிம்பர்
Eknath	எக்னாத்
Solkar	சோல்கார்
British	ப்ரிட்டிஷ்
Chromium	க்ரோமியம்
Dyan	த்யான்
Panesar	பனேசர்
Jahangir	ஜஹாங்கிர்
Shah	ஷா
Pyaara	பியாரா
Tarana	தரானா
Jeevankala	ஜீவன்கலா
Abhir	அபிஹிர்
Oriana	ஓரியானா
Bing	பிங்
Crosby	க்ராஸ்பி
Achand	அசந்த்
Shariqah	ஷரிகா
Desh	தேஷ்
Premee	பிரேமீ
Him	ஹிம்
Gyan	ஞான்
Kodaganar	கோடகனர்
Reservoir	ரிசர்வாயர்
Koi	கொய்
Ghulam	குலாம்
Nahin	நாஹின்
Bellsouth	பெல்சௌத்
Andar	அந்தர்
Bahar	பாஹர்
Samrat	சம்ரத்
Chandragupt	சந்திரகுப்த்
Miss	மிஸ்
Toofan	டூஃப்பன்
Mail	மெயில்
Haskell	ஹாஸ்கெல்
Vilmaris	வில்மாரிஸ்
Brittany	பிரிட்டனி
Foolan	ஃபூளான்
Fynn	ஃபின்
Shabri	ஷப்ரி
Redpath	ரெட்பாத்
Museum	மியூஸியம்
Prita	ப்ரீதா
Lancaster	லான்காஸ்டர்
Pakkhoke	பக்கோகே
Bahlawan	பஹல்வான்
Erie	ஈரி
Hum	ஹம்
Tere	தேரே
Ashiq	ஆஷிக்
Hain	ஹெயின்
Milan	மிலன்
Ki	கி
Raat	ராத்
Do	தோ
Ustaad	உஸ்தாத்
Bhola	போலா
Shankar	ஷங்கர்
Khasgiwale	காஸ்கிவாலே
Robin	ராபின்
Brown	ப்ரவுன்
Gujrat	குஜராத்
Chakk	சாக்
Appu	அப்பு
Raja	ராஜா
Qayamat	கயாமத்
Ki	கி
Raat	ராத்
National	நேஷனல்
Musem	மியூஸியம்
Of	ஆஃப்
Korea	கொரியா
Jawara	ஜவாரா
Balaraam	பலராம்
Everly	எவர்லி
Ganga	கங்கா
Tera	தேரா
Pani	பாணி
Amrit	அம்ரித்
Badhada	பதாடா
Lin	லின்
Valora	வலோரா
Score	ஸ்கோர்
Bowden	பெளடென்
Deshmukh	தேஷ்முக்
Wally	வாலி
Bagula	பகுலா
Bhagat	பகத்
Karorepati	கரோர்பதி
Tassos	டாஸோஸ்
Heeraa	ஹீரா
Kashmakash	கஷ்மகஷ்
Sundarbans	சுந்தர்பான்ஸ்
Dildar	தில்தர்
Della	டெல்லா
Keer	கீர்
Sher	ஷேர்
Shivaji	ஷிவாஜி
Yeshiva	யெஷிவா
University	யூனிவர்சிட்டி
Museum	மியூஸியம்
Jawani	ஜவானி
Ke	கே
Gunah	குணா
Bargarh	பர்கார்
Road	ரோட்
Menard	மெனார்ட்
Vera	வெரா
Arad	அராத்
fort	ஃப்போர்ட்
Joanne	ஜோன்னி
Koruna	கோருனா
Fort	ஃப்போர்ட்
grange	கிரான்ஜ்
Baalamani	பாலமணி
Marietta	மரீட்டா
Banasandra	பானாசண்ட்ரா
Ghumman	கும்மன்
Kaun	கோன்
Apana	அபானா
Kaun	கோன்
Paraya	பராயா
Freddie	பிரட்டி
Mac	மேக்
Alvarion	அல்வாரியான்
Masood	ஃபைசால்
Iqbal	இக்பால்
Champa	சம்பா
Kathmandu	காத்மண்டு
Ujaalaa	உஜாலா
Pritzker	ப்ரிட்ஸ்கெர்
Prize	ப்ரைஸ்
Borneo	பார்னியோ
Hera	ஹிரா
Gurudwara	குருத்வாரா
Bibeksar	பிபேக்சர்
Dharnaoda	தர்னோடா
Taruna	தருணா
Ek	ஏக்
Duje	துஜே
Ke	கே
Liye	லியே
Maa	மா
Bahen	பாஹென்
Aur	அவுர்
Biwi	பீவி
Rane	ரானே
Brake	ப்ரேக்
Reprisal	ரிபிரைசல்
Carlisle	கார்லிஸ்லெ
Kalra	கல்ரா
Dalmia	டால்மியா
Cement	சிமெண்ட்
Shabash	ஷபாஷ்
Daddy	டாடி
Doiwala	டோய்வாலா
Hena	ஹெனா
Muhammadee	முஹம்மதி
Mark	மார்க்
Benson	பென்சன்
Beed	பீட்
Kera	கேரா
Fort	ஃப்போர்ட்
borstal	பொர்ஸ்டல்
Niggly	நிக்லி
Dohollah	டோஹோல்லா
IndusInd	இண்டஸ்இண்ட்
Bank	பேங்க்
Yatishwar	யதிஷ்வர்
Burdah	புர்தா
Fort	ஃப்போர்ட்
rigolet	ரிகோலெட்
Aiye	ஆயே
Lenawee	லினாவீ
Suru	சுரு
Nayak	நாயக்
Baghi	பாகி
Sipahi	சிபாஹி
Achalendra	அச்சலேந்திரா
American	அமெரிக்கன்
International	இன்டர்நேஷனல்
Building	பில்டிங்
Do	தோ
Qaidi	கய்தி
Ashivan	அஷ்வான்
Dehlo	டெஜ்லோ
Parveen	பர்வீன்
Ek	ஏக்
Baar	பார்
Chale	சாலே
Aao	ஆவோ
Morphy	மார்ஃபி
Richards	ரிச்சர்ட்ஸ்
Jaayen	ஜாயேன்
To	தோ
Jaayen	ஜாயேன்
Kahan	கஹான்
Bhende	பெந்தே
Kyushu	கியூஷு
Delhi	டெல்லி
Cantonment	கண்டோன்மெண்ட்
George	ஜார்ஜ்
Kolbe	கோல்ப்
Museum	மியூஸியம்
Tapan	தபன்
Aaqib	அகிப்
Javed	ஜாவெத்
Balearic	பலியேரிக்
Thunderer	தன்டெரர்
Dow	டொவ்
Chemical	கெமிக்கல்
Apne	அப்னே
Dushman	துஷ்மன்
Paaras	பாரஸ்
Chakri	சக்ரி
Nareubet	நாரேய்பெட்
Winfield	வின்ஃபீல்ட்
Kusumavati	குசுமாவதி
Kunjar	குஞ்சர்
putree	புத்ரீ
Roti	ரோட்டி
Kapada	கபாடா
Aur	அவுர்
Makan	மகான்
Pearse	பியர்ஸ்
Museum	மியூஸியம்
Shameem	ஷமீம்
Sudeshna	சுதேஷ்னா
Dinesh	தினேஷ்
Karthik	கார்த்திக்
Dil	தில்
Leda	லேடா
Aligarh	அலிகார்
Junction	ஜங்ஷன்
Warangal	வாராங்கல்
Fionnula	ஃபியோனுலா
Hathyaar	ஹத்யார்
Aayushman	ஆயுஷ்மான்
Chapada	சாபாடா
dos	டாஸ்
Guimaraes	குய்மாரேஸ்
Mahindra	மஹிந்த்ரா
United	யுனைடெட்
World	வோர்ல்ட்
College	காலேஜ்
of	ஆஃப்
India	இண்டியா
Chamila	சமிலா
Gamage	கமகே
Hum	ஹம்
Kahan	கஹான்
Ja	ஜா
Rahe	ராஹே
Hain	ஹெயின்
Poonam	பூனம்
Theodore	தியோதர்
Dreiser	ட்ரீசர்
Chemancheri	செம்மஞ்சேரி
Chandan	சந்தன்
Nagar	நகர்
Pothohar	போதோஹர்
Sundha	சுந்தா
Ambup	அம்புப்
Ambur	ஆம்பூர்
Dell	டெல்
Satywan	சத்யவான்
Savitri	சாவித்ரி
Abhayananda	அபயானந்தா
Chalis	சாலிஸ்
Baba	பாபா
Ek	ஏக்
Chor	சோர்
Pamelia	பமீலியா
Rajendra	ராஜேந்திர
Mohan	மோஹன்
Bhatnagar	பட்னாகர்
Little	லிட்டல்
fort	ஃப்போர்ட்
Patang	பதங்
Meitnerium	மெய்ட்னெரியம்
Kal	கல்
Hamara	ஹமாரா
Hai	ஹை
Mishima	மிஷிமா
Yukio	யூக்கியோ
Prize	ப்ரைஸ்
Hum	ஹம்
Se	சே
Na	நா
Jeeta	ஜீதா
Koi	கோய்
Heriot-Watt	ஹெரியோட்-வாட்
University	யூனிவர்சிட்டி
Cliff	கிளிஃப்
Dhanakya	தனக்யா
Dewalgaon	தேவல்காவுன்
Olesia	ஓலிஷியா
Keitha	கேய்தா
Paheli	பஹெலி
Fender	ஃபெண்டர்
Rhodes	ரோட்ஸ்
Ujjain	உஜ்ஜைன்
Sandhyanand	சந்தியானந்த்
Jadu	ஜாடு
Mahal	மஹல்
Do	தோ
Khiladi	கிலாடி
Bexar	பெக்ஸார்
Dion	டியான்
Ebrahim	இப்ராஹிம்
Order	ஆர்டர்
of	ஆஃப்
the	தி
White	ஒயிட்
Lion	லயன்
Kustubh	குஸ்துப்
Anandpur	ஆனந்த்பூர்
Sahib	சாஹிப்
Navin	நவீன்
Ved	வேத்
maatrakaa	மாத்ரகா
Fort	ஃப்போர்ட்
bij	பிஜ்
asperen	ஆஸ்பெரென்
Vajraachaary	வஜ்ராசாரி
Jeevan	ஜீவன்
Mrityu	மிருத்யு
Dhirganj	தீர்கஞ்ச்
Gayda	கய்டா
Gunwanti	குன்வன்தி
Jnyaneshwar	ஞானேஸ்வர்
Vishaya	விஷயா
Fort	ஃப்போர்ட்
dix	டிக்ஸ்
Ranaveer	ரனவீர்
Gopinath	கோபிநாத்
Mohanti	மொஹந்தி
San	சன்
Francisco	பிரான்சிஸ்கோ
Oakland	ஓக்லேண்ட்
Bay	பே
Khadakwasla	கடக்வஸ்லா
Bela	பேலா
Ritvik	ரித்விக்
Fort	ஃப்போர்ட்
marlborough	மார்ல்போராக்
Ajooba	அஜூபா
Dassault	டசவுல்ட்
Systems	ஸிஸ்டம்ஸ்
Taliesin	டாலிஸின்
Saggu	சாகு
Saint	செயிண்ட்
Stanislaus	ஸ்டானிஸ்லாஸ்
High	ஹை
School.	ஸ்கூல்,
Mumbai	மும்பை
Paapi	பாபி
Sansar	சன்ஸார்
Jasodhara	ஜஸோதரா
Giriraaj	கிரிராஜ்
Agape	அகபே
Eric	எரிக்
Upashantha	உபஷாந்தா
Nasia	நாஸியா
Fort	ஃப்போர்ட்
henry	ஹென்ரி
Mena	மேனா
Barqi	பார்கி
Atri	அட்ரி
Love	லவ்
In	இன்
Simla	சிம்லா
Northwood	நார்த்வுட்
University	யூனிவர்சிட்டி
Peace	பீஸ்
Lutheran	லுதெரன்
Chosla	சோஸ்லா
Shataayu	ஷதாயு
Anupam	அனுபம்
Wolf	உல்ஃப்
Prize	ப்ரைஸ்
in	இன்
Arts	ஆர்ட்ஸ்
The	த
asian	ஏஷியன்
age	ஏஜ்
Takeda	தகேடா
Award	அவார்ட்
Vraksharaaj	விரக்ஷராஜ்
Ajmani	அஜ்மானி
Do	தோ
Shikari	ஷிகாரி
Jeff	ஜெஃப்
Mahaaksh	மஹாக்ஷ்
Jeff	ஜெஃப்
Bridges	பிரிட்ஜஸ்
Step	ஸ்டெப்
Quraybah	குரேபாஹ்
Julien	ஜூலியன்
Wiener	வியனெர்
Naqid	நாகித்
Rhiannon	ரயன்னன்
Cairbre	கைர்ப்ர்
Aajinky	ஆஜிங்கி
Sadanand	சதானந்த்
Neil	நேய்ல்
Fairbrother	ஃப்பேர்பிரதர்
Channery	சான்னெரி
In'am	இன்'ஆம்
Abhr	அப்ஹ்ர்
Jawhar	ஜவஹர்
Albert	அல்பர்ட்
Canara	கனரா
Bank	பேங்க்
Cherry	செர்ரி
Carl	கார்ல்
Bulfin	பலஃப்பின்
Balance	பேலன்ஸ்
Beam	பீம்
Karnik	கார்னிக்
Mah	மஹிந்த்ரா
Seamless	சீம்லெஸ்
Rishta	ரிஷ்டா
Kagaz	காகாஸ்
Ka	கா
Devastation	டிவெஸ்டேஷன்
Ghungroo	குங்ரூ
Ki	கி
Awaz	ஆவாஸ்
Dalai	டலாய்
Lama	லாமா
Spector	ஸ்பெக்டர்
General	ஜெனரல்
George	ஜார்ஜ்
Castro	கேஸ்ட்ரோ
Amara	அமரா
Azra	அஸ்ரா
Niranjana	நிரஞ்சனா
Mera	மேரா
Munna	முன்னா
Denise	டெனிஸ்
Trieste	ட்ரையஸ்டெ
Football	ஃபுட்பால்
Takiuddeen	தக்கியுதீன்
Andralyn	ஆன்டிராலின்
Badriyah	பத்ரியா
Dev	தேவ்
kumar	குமார்
Gurudwara	குருத்வாரா
Falahi	ஃபலாஹி
Sahib	சாஹிப்
Toofan	தூஃப்பன்
Rani	ராணி
Aryankavu	ஆரியன்காவு
Nityanand	நித்யானந்த்
Jajpur	ஜஜ்பூர்
Ciel	சியல்
Akutagawa	அகூடகாவா
Prize	ப்ரைஸ்
Bratsk	பிரத்ஸ்க்
Guntur	கூன்டூர்
Subhashini	சுபாஷினி
Australian	ஆஸ்ட்ரேலியன்
Open	ஓபன்
champions	சாம்பியன்ஸ்
Advaki	அத்வாகி
Yamamah	யமமா
Vaageeshvar	வாகீஷ்வர்
Ryan	ரியான்
Ramdass	ராம்தாஸ்
Jupiter	ஜூப்பிட்டர்
Edwin	எட்வின்
Allegheny	அல்லேகேனி
Jaipur	ஜெய்பூர்
Tariqah	தாரிகா
Diwankhavati	திவான்காவதி
Hosanna	ஹோஸன்னா
Lutheran	லுதெரன்
Chand	சந்த்
Chakori	சகோரி
Madras	மெட்ராஸ்
Jasrah	ஜஸ்ரா
Achaarynandanaa	ஆசார்யானான்தனா
Zakhmi	ஸாக்மி
Sher	ஷெர்
Kaaran	காரன்
Nadir	நாதிர்
Malise	மேலிஸ்
Pierrette	பியரெட்
Cellebes	செல்லபெஸ்
Phazom	ஃபாஸூம்
Chanpatia	சன்பாடியா
Nishan	நிஷான்
Danka	தன்கா
Ray	ரே
Illingworth	இல்லிங்வர்த்
Naspers	நாஸ்பெர்ஸ்
Limited	லிமிடெட்
Maharashtra	மஹாராஷ்ட்ரா
Fil	ஃபில்
Donnanview	டோனன்வியூ
Vincent	வின்சென்ட்
Alan	அலன்
Wells	வெல்ஸ்
Ponkshe	பொன்ஷே
Dampati	தம்பதி
Pyar	பியார்
Ke	கே
Do	தோ
Char	சார்
Din	தின்
Aanandini	ஆனந்தினி
Chetan	சேட்டன்
Chauhan	சவ்ஹான்
Jagte	ஜக்தே
Raho	ராஹோ
Singaar	சிங்கார்
Gurbachan	குர்பாச்சான்
Peruvaripallam	பெருவாரிபள்ளம்
Aap	ஆப்
Ki	கி
Parchhaiyan	பரிச்சாயின்
Rekhaa	ரேகா
Cathedral	கத்தீட்ரல்
and	அண்ட்
John	ஜான்
Connon	கனான்
School,	ஸ்கூல்,
Mumbai	மும்பை
Flamel	பிளேமல்
Technologies	டெக்னாலஜீஸ்
Devprayag	தேவ்பிரயாக்
Suffren	சாஃப்பிரென்
Sajid	சஜித்
Ali	அலி
Zamane	ஸமானெ
Ko	கோ
Dikhana	டிகானா
Hai	ஹை
Traci	ட்ராசி
Publix	பப்ளிக்ஸ்
Super	சூப்பர்
Markets	மார்க்கெட்ஸ்
Indraprastha	இந்த்ரப்ரஸ்தா
Albina	அல்பினா
Tiaa	தியா
Cref	கிரெப்
Bonnet	போனட்
Plume	பிளம்
Night	நைட்
Bird	பேர்ட்
Fort	ஃப்போர்ட்
buchanan	புச்சானான்
Clementine	கிளெமண்டைன்
Tuscarora	டஸ்வாரோரா
War	வார்
Haafiz	ஹாஃபிஸ்
Shahid	ஷாஹித்
Sarakatsanoi	சராகோட்சனாய்
Folklore	ஃப்போக்லோர்
Museum	மியூஸியம்
Fausta	ஃபாஸ்டா
Stillman	ஸ்டில்மன்
Lander	லான்டெர்
Samadhi	சமாதி
Latika	லதிகா
Robbie	ராபி
Hart	ஹார்ட்
Angarikaa	அங்கரிக்கா
Aurelia	ஆரேலியா
Chhatrapati	சத்திரபதி
Shivaji	சிவாஜி
Diler	திலேர்
Hanwha	ஹான்வா
Abey	அபே
Kuruvilla	குருவில்லா
Banarasi	பனாரசி
Thug	துக்
Is	இஸ்
Paar	பார்
Ya	யா
Us	உஸ்
Paar	பார்
Laalakamal	லாலகமல்
Central	சென்ட்ரல்
Michigan	மிச்சிகன்
University	யூனிவர்சிட்டி
Yaatna	யாத்னா
Felis	ஃபெலிஸ்
Shelf	ஷெல்ஃப்
Qiagen	கியாஜென்
Algiers	அல்ஜியர்ஸ்
Sagar	சாகார்
Ka	கா
Sher	ஷெர்
Paying	பேயிங்
Guest	கெஸ்ட்
Kainji	கைன்ஜி
dam	டேம்
Andheri	அந்தேரி
Thaminah	தமீனா
Meri	மேரி
Zubaan	ஸுபான்
Khulud	குலுத்
Gehra	கெஹ்ரா
Raaz	ராஸ்
David	டேவிட்
Gower	கோவெர்
Bolangir	பொலான்கிர்
Raat	ராத்
Ke	கே
Andhere	அன்தேரே
Mein	மேன்
Lavina	லவினா
Bhagwat	பகவத்
Mahima	மஹிமா
Bombay	பாம்பே
Town	டவுன்
Sanath	சனத்
Kaluperuma	கலுபெருமா
Devnath	தேவ்நாத்
Lut	லுத்
Krone	க்ரோன்
Murchison	முர்சிசன்
Falls	ஃபால்ஸ்
Krona	க்ரோணா
Do	தோ
Premee	பிரேமீ
Dhadial	தாதியால்
Order	ஆர்டர்
of	ஆஃப்
Industrial	இண்டஸ்ட்ரியல்
Merit	மெரிட்
Michael	மைக்கல்
Slater	ஸ்லேடர்
Fujitsu	ஃபுஜிட்ஸு
Meritorious	மெரிடோரியஸ்
Service	சர்வீஸ்
Medal	மெடல்
Pakhewal	பகேவால்
Mandape	மன்டபே
Perrier	பெர்ரியர்
Comedy	காமெடி
Award	அவார்ட்
Karunamay	கருணாமாய்
Hum	ஹம்
Ek	ஏக்
Hain	ஹெயின்
Oud	ஔட்
Misbah	மிஸ்பா
Nanda	நந்தா
Devi	தேவி
Abdul	அப்துல்
muhaymeen	முஹாய்மீன்
Sri	ஸ்ரீ
Adhikari	அதிகாரி
Bhawani	பவானி
Bhattacharya	பட்டாச்சார்யா
Awara	ஆவாரா
Baap	பாப்
Prakaash	பிரகாஷ்
Deanna	டீயனா
Aulad	ஔலத்
Ke	கே
Dushman	துஷ்மன்
Gangsar	கங்ஸார்
Jaitu	ஜெய்டூ
Onkar	ஒன்கார்
Narendra	நரேந்திரா
Hirwani	ஹிர்வானி
Bhoke	போக்கே
El	எல்
Horria	ஹோரியா
Michael	மைக்கேல்
Crichton	க்ரிச்டன்
Akeel	அகீல்
Hamdard	ஹம்தார்த்
Fdederated	பெட்டரேட்டட்
Dept	டெப்ட்
Stor	ஸ்டோர்
Indika	இண்டிகா
de	டி
Saram	சரம்
Lilac	லிலக்
Guide	கைட்
Arab	அரப்
Ka	கா
Sitara	சிதாரா
Gaddu	காட்டு
Shiela	ஷீலா
Sonpur	சோன்பூர்
Valli	வாலி
Main	மேன்
Chup	சுப்
Rahungi	ரஹூங்கி
Sukhija	சுகிஜா
Michael	மைக்கேல்
Mason	மேசன்
Ahmed	அஹ்மத்
ar-Rifai	அர்-ரிஃப்பை
Bilhaur	பில்ஹாவுர்
Dheera	தீரா
Ammarah	அம்மாரா
Evelia	ஈவ்லியா
Madam	மேடம்
Zapatta	ஸாபாட்டா
Cranfield	க்ரான்ஃபீல்ட்
University	யூனிவர்சிட்டி
Dheena	தீனா
Umeed	உமீத்
Seanna	சியன்னா
Phool	ஃப்பூள்
Khile	கிளே
Hain	ஹைன்
Gulshan	குல்ஷான்
Gulshan	குல்ஷான்
Haleef	ஹலீஃப்
Pavitr	பவித்ர
Yogeey	யோகீ
Night	நைட்
Club	கிளப்
Prabodh	ப்ரபோத்
Chandra	சந்திரா
Darrin	டாரின்
Murray	முர்ரே
Dilawarnagar	திலவார்நகர்
Caradoc	காரடாக்
Agasti	அகஸ்தி
Afasara	அஃபசாரா
Vitankar	விதன்கர்
Stride	ஸ்ட்ரைட்
Arcolab	ஆர்கோலேப்
Guddi	குத்தி
Dixon	டிக்சன்
Kismat	கிஸ்மத்
Ka	கா
Sitara	சிதாரா
Diane	டையேன்
Mark	மார்க்
Higgs	ஹிக்ஸ்
Navrangpur	நவ்ராங்பூர்
Fitness	ஃபிட்னஸ்
Sodium	சோடியம்
Haneef	ஹனீஃப்
Barks	பார்க்ஸ்
Atreya	அட்ரேயா
Seymour	செய்மோர்
Jansatta	ஜான்சாட்டா
Dyani	ட்யானி
Feinstein	ஃபெயின்ஸ்டின்
Mel	மெல்
Gibson	கிப்சன்
Beti	பேடி
Bete	பேடி
Santushti	சந்துஷ்டி
Indubriht	இந்துபிரிஹ்த்
China	சீனா
Grentech	கிரென்டெக்
Corporation	கார்ப்பரேஷன்
Limited	லிமிடெட்
Jaureguiberry	ஜவ்ரேகுபெர்ரி
Tim	டிம்
Bresnan	பிரெஸ்னான்
Kirayedar	கிராயெதார்
Abdul	அப்துல்
barr	பார்
Jeetan	ஜீட்டன்
Patel	பட்டேல்
Dholka	தோல்கா
Buqayrah	புகாய்ரா
Rehana	ரெஹானா
Hum	ஹம்
Do	தோ
Daku	தாக்கு
Eicher	ஐச்சர்
Lauderdale	லாடெர்டேல்
Percy	பெர்சி
Lierre	லியெர்
Ghanauli	கனௌலி
Mathura	மதூரா
Matthew	மாத்யூ
Hoggard	ஹோக்கார்ட்
Chaubees	சௌபீஸ்
Ghante	கண்டே
Praneet	ப்ரனீத்
Mekhalin	மேகலின்
Umar	உமர்
Gul	குல்
Saarang	சாரங்
Waqt	வக்த்
Waqt	வக்த்
Ki	கி
Baat	பாத்
Allaudin	அலாவுதின்
Ka	கா
Beta	பேட்டா
Tirucherai	திருச்சேரை
Dhindsa	திண்ட்ஸா
Khushboo	குஷ்பு
San	சான்
Jacinto	ஜாசின்டோ
Hind	ஹிந்த்
Oil	ஆயில்
Explor	எக்ஸ்ப்ளோர்
Bhuvan	புவன்
Anantpur	அனன்த்பூர்
Gunung	குனுங்
Gede	கீடே
Pangrango	பங்ரங்கோ
Bhaarat	பாரத்
Nishtha	நிஷ்தா
Marathi	மராத்தி
Alan	அலன்
Butcher	பட்சர்
Shyamasri	ஷியாமஸ்ரீ
Suren_dar	சுரேந்தர்
Elvis	எல்விஸ்
Presley	ப்ரெஸ்லி
Jheel	ஜீல்
Ke	கே
Us	உஸ்
Paar	பார்
Clemenceau	கிளிமென்சியா
Deevaan	தீவன்
Moles	மோல்ஸ்
Nityanath	நித்யநாத்
Shyaamalataa	ஷியாமலதா
Uppar	உப்பார்
Reservoir	ரிசர்வாயர்
Abhilashaa	அபிலாஷா
Wyeth	வியத்
STATS	ஸ்டேட்ஸ்
ChipPAC	சிப்பாக்
The	த
afternoon	ஆஃப்டர்னூன்
Robert	ராபர்ட்
Mitcham	மிட்சாம்
Millionaire	மில்லியனேர்
Suparn	சுபர்ன்
Balsamand	பல்சாமண்ட்
Bhagavat	பகவத்
Laparwah	லபாவாஹ்
Filght	ஃபிளைட்
To	டு
Assam	அஸாம்
Aud	ஔத்
Roshni	ரோஷ்னி
Maroke	மரோகே
Sonakshi	சோனாக்ஷி
Hamara	ஹமாரா
Desh	தேஷ்
O^kaar	அவ்கார்
Jethani	ஜெதானி
Nilima	நீலிமா
Studio	ஸ்டூடியோ
Museum	மியூஸியம்
in	இன்
Harlen	ஹார்லென்
Aap	ஆப்
Ka	கா
Pyar	பியார்
Phool	ஃப்பூள்
Aur	அவுர்
Insaan	இன்சான்
Agra	ஆக்ரா
Cantonment	கண்டோன்மெண்ட்
Thambalahalli	தம்பலஹல்லி
Reservoir	ரிசர்வாயர்
Athena	ஏதேனா
Clarence	கிளாரென்ஸ்
Somkanta	சோம்கந்தா
Ram	ராம்
Vivah	விவாஹ்
Bhrashtachar	பிரஷ்டசார்
Bev	பெவ்
Congdon	காங்டன்
Lloyd	லாய்ட்
Bridges	ப்ரிட்ஜஸ்
Foolwati	ஃபூல்வாதி
Aadharshila	ஆதர்ஷிலா
Mutha	மூட்டா
Saheli	சஹேலி
Jennica	ஜெனிகா
Boond	பூண்ட்
Jo	ஜோ
Ban	பன்
Gayee	கயீ
Moti	மோடி
Crédit	கிரெடிட்
Agricole	அக்ரிகோல்
Nottingham	நாட்டிங்காம்
Trent	ட்ரெண்ட்
University	யூனிவர்சிட்டி
National	நேஷனல்
Medal	மெடல்
of	ஆஃப்
Technology	டெக்னாலஜி
Parvin	பர்வின்
Euridice	இயுரிதிஸ்
Khufia	குஃப்பியா
Mahal	மஹால்
Tapti	தபதி
Purna	பூர்ணா
Mort	மார்ட்
Kevina	கெவினா
Gohpur	கோஹ்பூர்
Johan	ஜோஹன்
Straus	ஸ்ட்ராஸ்
Batch	பேட்ச்
Kevalkishore	கேவால்கிஷோர்
Southern	சதர்ன்
sea	சீ
Insaan	இன்சான்
Dhanera	தனேரா
Alan	அலன்
Igglesden	இக்லெஸ்டென்
China	சீனா
Medical	மெடிக்கல்
Technologies	டெக்னாலஜீஸ்
Kirloskar	கிர்லோஸ்கர்
Bros	ப்ரதர்ஸ்
Sigourney	சிகோர்னி
Weaver	வீவர்
Woody	உட்டி
Allen	ஆலன்
Dhekne	தேக்னே
Bhitiwala	பிடிவாலா
Orteig	ஆர்டீக்
Prize	ப்ரைஸ்
Bouzouki	பொசௌக்கி
Dost	தோஸ்த்
Dehrabad	தேஹ்ராபாத்
Silesian	சிலெஷியன்
War	வார்
Resham	ரேஷாம்
Ki	கி
Dori	தோரி
Fort	ஃப்போர்ட்
mandan	மான்டென்
Ceram	செரம்
Ahraura	அஹ்ரவுரா
Road	ரோட்
Jalwa	ஜால்வா
Andy	ஆன்டி
Roberts	ராபர்ட்ஸ்
Khatavkar	கதவ்கர்
Foudre	ஃப்பவ்டிர்
Gursharan	குர்ஷாரான்
Singh	சிங்
Bosch	போஷ்
Chassis	சேசிஸ்
Kaiser	கைஸர்
Friedrich	ஃபிரைட்ரிச்
III.	III.
Ankola	அங்கோலா
Kenosha	கெனோஷ
Bible	பைபிள்
Afaroze	அஃபரோஸ்
Wheelchair	வீல்சேர்
Basketball	பேஸ்கட்பால்
Randy	ராண்டி
Dum	டம்
Dum	டம்
Cantonment	கண்டோன்மெண்ட்
Glatton	கிளாட்டன்
Renata	ரெனதா
Moser	மோசர்
Baer	பியர்
Banka	பங்கா
Balachandra	பாலசந்திரா
Kandhari	கன்தாரி
Mastana	மஸ்தானா
Mashooq	மாஷூக்
Stabroeck	ஸ்டாப்ரோயெக்
Akhil	அகில்
Dhanari	தனாரி
Krodh	குரோத்
Bulerias	புலேரியாஸ்
Reshma	ரேஷ்மா
Falakata	ஃபலக்கட்டா
Puranjay	புரஞ்சய்
Quentin	குயின்டின்
Yadon	யாதோன்
Ki	கி
Zanjeeer	ஸன்ஜீர்
Badmaash	பத்மாஷ்
Bernard	பெர்னார்ட்
Julien	ஜூலியன்
Tiruvanantpuram	திருவனந்தபுரம்
Dharamdeep	தரம்தீப்
Vijayshree	விஜய்ஸ்ரீ
Jalabala	ஜலபாலா
Borkar	போர்கர்
Order	ஆர்டர்
of	ஆஃப்
Saint	செயிண்ட்
Andrew	ஆண்ட்ரூ
Vadan	வதன்
Jiyo	ஜியோ
Raja	ராஜா
Amoha	அமோஹா
State	ஸ்டேட்
Farm	பார்ம்
Insurance	இன்ஷூரன்ஸ்
Kirit	கிரித்
Shatru	ஷத்ரு
Adarsha	ஆதர்ஷி
Dibrugarh	திப்ரூகார்
Lalita	லலிதா
Baglama	பக்லாமா
Priyam	ப்ரியம்
Craig	க்ரெய்க்
Evans	இவான்ஸ்
Kundanika	குன்டனிகா
Husn	ஹஸன்
Banoo	பனூ
Pankaj	பங்கஜ்
Bank	பேங்க்
Of	ஆப்
America	அமெரிக்கா
Corporate	கார்ப்பரேட்
Centre	சென்டர்
Tazwell	டாஸ்வெல்
Navroz	நவ்ரோஸ்
Naimisharanya	நய்மிஷர்ண்ய
Unicoi	யுனிகோய்
Christian	கிறிஸ்டியன்
Akhlaaq	அக்லாக்
Devyani	தேவயாணி
Dripping	டிரிப்பிங்
Springs	ஸ்பிரிங்ஸ்
Community	கம்யுனிட்டி
Fellowship	பெல்லோஷிப்
Cathy	கேத்தி
Betts	பெட்ஸ்
Lilka	லில்கா
Bhavan	பவன்
Abdul	அப்துல்
zalil	ஸாலில்
Babupeth	பாபுபேட்
Koc	கோக்
Holding	ஹோல்டிங்
Bandhan	பந்தன்
Conde	கோன்ட்
Nast	நாஸ்ட்
building	பில்டிங்
P'yongyang	பியோங்கியாங்
Fort	ஃப்போர்ட்
charlotte	சார்லட்
Ridhdhi	ரித்தி
Bhawanipur	பவானிபூர்
Kalan	காலன்
Bakht	பக்த்
Maurizio	மௌரிஸியோ
Gruta	க்ரூட்டா
de	டி
Almonda	அல்மோண்டா
Alfred	ஆல்ஃபிரட்
Hitchcock	ஹிச்காக
Minna	மின்னா
Gondhalekar	கோந்தலேகர்
Sarabdev	சரப்தேவ்
Aanandmayi	ஆனந்தமாயி
Maple	மேப்பிள்
Museum	மியூஸியம்
Thea	தியா
Main	மேன்
Shadi	ஷாதி
Karne	கார்னே
Chala	சாலா
Shoaib	ஷோயப்
Akhtar	அக்தர்
Ameya	அமேயா
SUNDAY	சன்டே
Communications	கம்யூனிக்கேஷன்ஸ்
Limited	லிமிடெட்
Pati	பதி
Pawan	பாவன்
Marvi	மார்வி
Kooner	கூனெர்
Kepler	கெப்லர்
Wessels	வெஸ்ஸல்ஸ்
Painter	பெயிண்டர்
Babu	பாபு
Ghalibah	காலிபா
Fennella	ஃபெனெல்லா
Centex	சென்டெக்ஸ்
Maninder	மனிந்தர்
James	ஜேம்ஸ்
Cook	குக்
University	யூனிவர்சிட்டி
Sameera	சமீரா
Dirac	டிராக்
Prize	ப்ரைஸ்
Shivaprataap	ஷிவபிரதாப்
Bhaanumukhee	பானுமுகி
Tirath	திராத்
London	லண்டன்
Luton	லூடன்
Gujarat	குஜ்ராத்
samachar	சமாச்சர்
Sans	சான்ஸ்
Pareil	பாரேயில்
Justice	ஜஸ்டிஸ்
Chibhabha	சிபாபா
Thermax	தெர்மேக்ஸ்
Saras	சரஸ்
Williamite	வில்லியமைட்
war	வார்
in	இன்
Ireland	ஐயர்லாண்ட்
Raghad	ரகத்
Lower	லோயர்
Nirar	நிரர்
Reservoir	ரிசர்வாயர்
Dhanakwada	தனக்வாடா
Ludwig	லுத்விக்
Pinson	பின்சன்
Park	பார்க்
Baptist	பேப்டிஸ்ட்
Zimbabwe	ஜிம்பாப்வே
Piggott	பிக்காட்
Qabool	காபூல்
Wally	வாலி
Edwards	எட்வர்ட்ஸ்
Order	ஆர்டர்
of	ஆஃப்
the	தி
Crown	க்ரவுன்
Research	ரிசர்ச்
in	இன்
Motion	மோஷன்
Limited	லிமிடெட்
Sundari	சுந்தரி
Ariane	அரியான்
Aurat	ஔரத்
Teri	தேரி
Yehi	யேஹி
Kahani	கஹானி
Char	சார்
Dil	தில்
Char	சர்
Raahen	ராஹேன்
Praseodymium	பிராசியோடிமியம்
David	டேவிட்
Capel	காபெல்
Joshila	ஜோஷிலா
Bikaner	பிகான்நெர்
Handball	ஹேண்ட்பால்
Adriano	அட்ரியானோ
Pembrokeshire	பெம்ப்ரோக்‌ஷைர்
Coast	கோஸ்ட்
Suhayb	சுஹயிப்
Labrador	லாப்ரடார்
Halwarvi	ஹல்வார்வி
Sew	சியூ
Shivnarine	ஷிவ்நாராய்ண்
Orchid	ஆர்க்கிட்
Chemical	கெமிக்கல்
Yadon	யாதோன்
Ki	கி
Kasam	கஸம்
Martha	மார்தா
Stewart	ஸ்டூவர்ட்
Barchi	பார்ச்சி
Road	ரோட்
Khatkadkala	காட்காட்கலா
Yvonne	யுவோன்
Bahadur	பஹதுர்
Lutera	லுதேரா
Anuva	அனுவா
Nafisah	நஃபீஸா
Sahalpur	சஹல்பூர்
Trevor	ட்ரெவோர்
Madondo	மடோண்டோ
World	வோர்ல்ட்
Heart	ஹார்ட்
Corporation	கார்ப்பரேஷன்
Kaneez	கனீஸ்
Jalaja	ஜலஜா
Mera	மேரா
Dost	தோஸ்த்
Husnee	ஹுஸ்னீ
Abdul	அப்துல்
qahhar	கஹ்ஹர்
Abhinandaa	அபினான்தா
Locket	லாக்கெட்
Wilona	விலோனா
Beraham	பெராஹம்
Daku	தாக்கு
Webster	வெப்ஸ்டர்
Asuncion	அசுன்சியன்
Jabalpur	ஜபல்பூர்
BackWeb	பேக்வெப்
Technologies	டெக்னாலஜீஸ்
Doyel	டோயல்
Chris	கிரிஸ்
Read	ரீட்
Soin	சோயின்
Nitsa	நித்ஸா
Bhuvan	புவன்
Shome	ஷோம்
Indranuj	இந்திரானுஜ்
Haren_dr	ஹரேந்தர்
Chlorine	க்லோரின்
Lloyds	லாய்ட்ஸ்
Steel	ஸ்டீல்
Baudh	பவுத்
Chhoti	சோட்டி
Si	சி
Baat	பாத்
Bahaadur	பஹதூர்
Kumari	குமாரி
Abdul	அப்துல்
hayy	யேய்
Noor	நூர்
Jataa	ஜடா
shankaree	ஷங்கரி
Gamini	காமினி
Wickremasinghe	விக்ரமசிங்கே
Sarnath	சார்நாத்
David	டேவிட்
Carpenter	கார்பெண்டர்
Pitamah	பிதாமஹ்
United	யுனைடெட்
Western	வெஸ்டர்ன்
Government	கவர்ன்மெண்ட்
Model	மாடல்
Higher	ஹையர்
Secondary	செகண்டரி
School,	ஸ்கூல்,
Thiruvananthapuram	திருவனந்தபுரம்
Khosha	கோஷா
Park	பார்க்
Place	பிளேஸ்
Baptist	பேப்டிஸ்ட்
Ryugyong	ரியுக்யோங்
Hotel	ஹோட்டல்
Bal	பால
Bharati	பாரதி
Public	பப்ளிக்
School	ஸ்கூல்
Jhootha	ஜூதா
Sach	சச்
Ghufran	குஃப்ரன்
Jane	ஜானே
Bhi	பி
Do	தோ
Yaaron	யாரோன்
Chandrika	சந்திரகா
Khwaja	க்வாஜா
Mir	மிர்
Dard	தார்த்
Carry	கேரி
Grant	கிராண்ட்
Bhoot	பூத்
Mera	மேரா
Saathi	சாதி
French	ஃப்ரெஞ்ச்
Open	ஓபன்
champions	சாம்பியன்ஸ்
Jagran	ஜக்ரன்
Julfikar	ஜுல்ஃபிகர்
The	தி
Australian/Vogel	ஆஸ்ட்ரேலியன்/வோகல்
Literary	லிட்ரரி
Award	அவார்ட்
Adie	ஆடி
Wachovia	வாசோவியா
Corp	கார்ப்
Fort	ஃப்போர்ட்
bliss	பிலிஸ்
Abdul	அப்துல்
nasir	நாஸிர்
Baahi	பாஹி
Dharam	தரம்
Kanta	காந்தா
Barney	பார்னே
Rogers	ரோஜர்ஸ்
Michael	மைக்கேஸ்
Papps	பாப்ஸ்
Florina	ஃப்பிளோரினா
Museum	மியூஸியம்
of	ஆஃப்
Modern	மாடர்ன்
Art	ஆர்ட்
Prix	ப்ரிக்ஸ்
de	டி
Rome	ரோம்
Boschbeek	போஷ்பீக்
fort	ஃப்போர்ட்
Tawakkal	தாவாக்கால்
Mastan	மஸ்தான்
Shah	ஷா
Saharwardy	ஸாஹார்வார்டி
Aadamkhor	ஆதம்கோர்
Massenhoven	மாஸ்ஸென்ஹோவென்
Alisa	அலிஸா
Ukhrul	உக்ரூல்
Buddy	பட்டி
Holly	ஹோலி
Patterson	பேட்டர்சன்
Thompson	தாம்சன்
Banmankhi	பன்மங்கி
Junction	ஜங்ஷன்
Rashida	ரஷிதா
Chandan	சந்தன்
Ka	கா
Palna	பால்னா
Aldona	அல்டோனா
Opera	ஓபெரா
House	ஹவுஸ்
Baghi	பாகி
Xel-ha	ஜெல்-ஹா
Lagoon	லகூன்
Conte	கான்டி
Verde	வெர்டி
Alia	அலியா
Bada	படா
Chris	கிரிஸ்
Broad	பிராட்
Kanhaiyalal	கன்ஹையால்
Ramgadia	ராம்காதியா
Sadeed	சதீத்
Ahmadnagar	அஹ்மத்நகர்
Accident	ஆக்சிடெண்ட்
Jagdeesh	ஜகதீஷ்
Shunbhanaashinee	சன்பனாஷினீ
Federal	ஃபெடரல்
Express	எக்ஸ்பிரஸ்
Ogan	ஓகன்
Florence	ஃப்ளோரன்ஸ்
Shel	ஷெல்
Pran	பிரான்
Jaye	ஜாயே
Par	பர்
Vachan	வசன்
Na	னா
Jaye	ஜாயே
Khudai	குதாய்
Khidmatgar	கித்மாட்கர்
Door	தூர்
Desh	தேஷ்
John	ஜான்
Hancock	ஹன்காக்
Center	சென்டர்
Junglee	ஜங்லீ
Gemma	ஜெம்மா
Olinda	ஓலிந்தா
Arshad	அர்ஷத்
Khan	கான்
Michelle	மிஷேல்
Jordan	ஜார்டன்
Glenveagh	க்ளென்வேக்
John	ஜான்
Milton	மில்டன்
Rakhi	ராக்கி
Ki	கி
Saugandh	செளகந்த்
Veronique	வெரோனிக்
Acharysuta	ஆசார்யாசுதா
Steven	ஸ்டீவன்
Hawking	ஹாகிங்
Barve	பார்வே
Raajamani	ராஜாமணி
Limazah	லிமஸா
Madhumita	மதுமிதா
Arafura	அராபுரா
Order	ஆர்டர்
of	ஆஃப்
Military	மிலிட்டரி
Merit	மெரிட்
Romantic	ரோமான்டிக்
India	இண்டியா
Hatimtai	ஹதிம்தய்
Ki	கி
Beti	பேட்டி
Ek	ஏக்
Ke	கே
Baad	பாத்
Ek	ஏக்
Vimogh	விமோக்
Yogaanand	யோகானந்த்
Phir	பிர்
Subhah	சுபா
Hogi	ஹோகி
York	யோர்க்
Vasanta	வஸந்தா
Charbagh	சர்பாக்
Railway	ரெயில்வே
Station	ஸ்டேஷன்
Indeever	இந்தீஎவர்
Vasanti	வஸந்தி
Sumanolata	சுமனோலதா
Mardangi	மார்தாங்கி
Cambridge	கேம்பிரிட்ஜ்
School,	ஸ்கூல்,
Indirapuram	இந்திராபுரம்
Emmy	எம்மி
Award	அவார்ட்
New	நியூ
York	யார்க்
Historical	ஹிஸ்டாரிக்கல்
Society	சொசைட்டி
Neepa	நீபா
Zhukov	ஸுகோவ்
Prix	ப்ரிக்ஸ்
Goncourt	கான்கோர்ட்
Stella	ஸ்டெல்லா
Thane	தானே
Udaipur	உதைபூர்
Yafi	யஃபி
Jewel	ஜுவல்
Amar	அமர்
Pyar	பியார்
Cisco	சிஸ்கோ\
Dainik	டைனிக்
samayik	சமயிக்
prasanga	பிரசங்கா
Pratik	ப்ரதிக்
Bansilal	பன்ஸீலால்
Rhenium	ரேனியம்
Darien	டாரியன்
War	வார்
Neel	நீல்
Kamal	கமல்
Saharanpur	சாஹாரன்பூர்
Tawqeer	தௌக்கீர்
Art	ஆர்ட்
Sunje	சுன்ஜே
Museum	மியூஸியம்
Pati	பதி
Parmeshwar	பர்மேஷ்வர்
Pali	பாலி
Do	தோ
Raaste	ராஸ்தே
Ilzaam	இல்ஸாம்
Ranchi	ரான்சி
express	எக்ஸ்பிரஸ்
Mueez	முயீஸ்
Dion	டியோன்
Nash	நாஷ்
Pari	பரி
Grasim	கிராஸிம்
Industries	இண்டஸ்ட்ரிஸ்
Aislin	ஐஸ்லின்
Marcus	மார்க்கஸ்
Brendon	பிரெண்டன்
Bracewell	பிரேஸ்வெல்
Ignatius	இக்னேஷியஸ்
Rolando	ரொலாண்டோ
Bheempura	பீம்பூரா
Sileas	சிலியாஸ்
Farrukh	ஃபரூக்
Shakuni	ஷகுனி
LanOptics	லான்அப்டிக்ஸ்
Amanjeet	அமன்ஜீத்
Ghalib	காலிப்
Navare	நவாரே
Pour	போர்
le	லே
Merite	மெரிட்
Waiz	வெயிஸ்
Varuna	வருணா
Brad	பிராட்
Haddin	ஹாட்டின்
Barwadih	பார்வாடி
Junction	ஜங்ஷன்
Chori	சோரி
Chori	சோரி
Eudora	இயுதோரா
Christ	கிறிஸ்ட்
United	யுனைட்டெட்
Methodist	மெதோடிஸ்ட்
Sharanyu	ஷரண்யு
Hotton	ஹோட்டன்
Malonne	மாலோன்னெ
Ragi	ராகி
Shrilata	ஸ்ரீலதா
Requinto	ரேக்விண்டோ
London	லண்டன்
City	சிட்டி
Raashid	ராஷித்
Malai	மாலை
malar	மலர்
Sujala	சுஜலா
Bilhar	பில்ஹார்
Ghat	காட்
Yaasmeen	யாஸ்மீன்
Devpura	தேவ்பூரா
Sabine	சபைன்
Sujaya	சுஜயா
Murde	முர்தே
Ki	கி
Jaan	ஜான்
Khatre	காத்ரெ
Main	மைன்
Starr	ஸ்டார்
Peder	பெடர்
Skram	ஸ்க்ராம்
Kessel	கெஸ்ஸெல்
Dhanbad	தன்பாட்
Junction	ஜங்ஷன்
David	டேவிட்
Colley	கோல்லே
Amar	அமர்
asom	அஸோம்
Arissa	அரிஸ்ஸா
Mediceo	மெடிசியோ
Holdings	ஹோல்டிங்க்ஸ்
Lokamaan_y	லோகமான்ய
Abdul	அப்துல்
baaqi	பாகி
Sheesh	ஷீஷ்
Itihaas	இதிஹாஸ்
Inayat	இனாயத்
Kendra	கென்ந்த்ரா
Haddock	ஹாட்டாக்
Dunkerque	டன்கர்கியூ
Gurudwara	குருத்வாரா
Heera	ஹீரா
Ghat	காட்
Spiel	ஸ்பீல்
des	டெச்
Jahres	ஜாரெஸ்
Wadi	வாதி
Yaasameen	யாசமீன்
Dharmanagar	தர்மாநகர்
Saat	சாத்
Hindustani	ஹிந்துஸ்தானி
Granville	க்ரான்வில்லே
De	டி
Silva	சில்வா
Xing	ஸிங்
Universal	யூனிவர்சல்
Telephone	டெலிபோன்
Fort	ஃப்போர்ட்
ashby	ஆஷ்பை
War	வார்
Museum	மியூஸியம்
of	ஆஃப்
Athens	ஏத்தென்ஸ்
Boot	பூட்
Polish	பாலிஷ்
John	ஜான்
Reid	ரேய்ட்
Indrakanta	இந்திரகன்தா
Alcatel	அல்கட்டல்
Dharmapuri	தர்மபுரி
Urian	யுரியன்
Habeeburarahamaan	ஹபீபுராராஹமான்
Baankebihari	பாங்கேபிஹாரி
Vari	வாரி
Ivory	ஐவரி
Huntsville	ஹண்ட்ஸ்வில்லே
Christian	கிறிஸ்டியன்
Argentinian	அர்ஜென்டினியன்
tango	டாங்கோ
Abdul	அப்துல்
Qadir	காதிர்
Suraag	சுராக்
Ryan	ரியான்
Higgins	ஹிக்கின்ஸ்
Sea	சீ
of	ஆப்
Crete	கிரெடி
Prasham	ப்ரஷாம்
Cicada	சிகதா
Runako	ருனாகோ
Morton	மார்டன்
Garrett	காரெட்
Pradeep	ப்ரதீப்
Jayaprakashdaran	ஜெயப்ரகாஷ்தரண்
Camden	கான்டென்
Anuhyaa	அனுஹ்யா
Jogindra	ஜோகிந்த்ரா
Wheaton	வீட்டன்
Amararaj	அமர்ராஜ்
Euro	யூரோ
Tech	டெக்
Holdings	ஹோல்டிங்க்ஸ்
Company	கம்பனி
Limited	லிமிடெட்
Wainganga	வெயின்கங்கா
Mera	மேரா
Dost	தோஸ்த்
Mera	மேரா
Dushman	துஷ்மன்
Shulka	ஷுல்கா
Kailaash	கைலாஷ்
Barkur	பர்கூர்
Totie	டோஸி
Munaf	முனாஃப்
Kumano	குமானோ
Maru	மாரு
Hani	ஹனி
Lakshmi	லக்ஷ்மி
Order	ஆர்டர்
of	ஆஃப்
the	தி
Sword	ஸ்வார்ட்
Prem	பிரேம்
Vivah	விவாஹ்
West	வெஸ்ட்
Bengal	பெங்கால்
Katherine	கேத்தரீன்
Aayush	அய்ஷா
Walihah	வாலிஹா
Ankh	அன்க்
Ka	கா
Nasha	நஷா
Ghunghat	குந்கத்
Wali	வாலி
Triguni	த்ரிகுணி
Trikon	டிரைகோன்
Ka	கா
Chautha	செளதா
Kon	கோன்
Patthar	பத்தர்
Sandhar	சாந்தர்
Polly	பாலி
Sipaahi	சிப்பாஹி
Palar	பாலாறு
Porandalar	பொறண்டலாறு
Reservoir	ரிசர்வாயர்
Apradhi	அப்ராதி
Kaun	கோன்
Gajendra	கஜேந்திரா
Kali	காளி
Raat	ராத்
Purnia	பூர்னியா
Freeman	ஃப்ரீமேன்
Indium	இன்டியம்
University	யூனிவர்சிட்டி
of	ஆஃப்
Minnesota	மின்னசோட்டா
Aa'idah	ஆ'தா
Behan	பெஹன்
Bebus	பேபஸ்
Grammy	க்ராம்மி
Award	அவார்ட்
Sananda	சனந்தா
Shahi	ஷாஹி
Chor	சோர்
Saan	சான்
Naaz	நாஸ்
Sanduri	சந்தூரி
Kali	காளி
Basti	பஸ்தி
Daily	டெய்லி
aikya	ஆய்கயா
Neelgiri	நீல்கிரி
jagannath	ஜகன்நாத்
puri	புரி
Agricultural	அக்ரிக்கல்சூரல்
Bank	பேங்க்
of	ஆப்
China	சைனா
Trinity	டிரினிட்டி
Biotech	பையோடெக்
Benbow	பென்போ
Haitian	ஹைடியன்
Revolution	ரெவல்யூஷன்
Lucille	லுசிலி
Origin	ஆரிஜின்
Agritech	அக்ரிடெக்
Limited	லிமிடெட்
Inaam	இனாம்
Goliath	கோலியாத்
Bindiya	பிந்தியா
Chamkegi	சம்கேகி
Raan	ரான்
Reginald	ரெஜினால்ட்
Rupinder	ருபிந்தர்
Insaaf	இன்சாஃப்
Kaun	கோன்
Karega	கரேகா
Larry	லாரி
Swapnali	ஸ்வப்னாலி
Cybill	சிபில்
Mard	மார்த்
Ki	கி
Zabaan	ஸபான்
Major	மேஜர்
League	லீக்
Lacrosse	லக்ரோஸ்
Offensive	அஃபன்சிவ்
player	ப்ளேயர்
of	ஆஃப்
the	தி
Year	இயர்
Award	அவார்ட்
Bhagwanti	பகவந்தி
Sadiqah	சதிகா
Owais	ஓவைஸ்
Shah	ஷா
Dhyanesh	த்யானேஷ்
Awara	ஆவாரா
Zindagi	ஜிந்தகி
Phool	ஃப்பூள்
Bane	பனே
Angarey	அங்காரே
Hanste	ஹன்ஸ்டே
Khelte	கேல்டே
Ashwa	ஆஷ்வ
Kranta	கிரந்தா
Naseem	நஸீம்
Spectramind	ஸ்பெக்ட்ராமைண்ட்
Ziarre	ஜியாரே
Dominion	டொமினியன்
Manku	மன்கு
Brookings	புரூகிங்ஸ்
Wesleyan	வெச்லேயன்
Yehiam	யெஹியாம்
fort	ஃப்போர்ட்
Parth	பர்த்
Kumar	குமார்
Steve	ஸ்டீவ்
Harmison	ஹார்மிசன்
Gautier	கவ்ஷியர்
Tad	டாட்
Turner	டர்னர்
Nabhij	நபிஜ்
Chalis	சாலிஸ்
Chor	சோர்
Deshpande	தேஷ்பாண்டே
Northrop	நார்திராப்
Grumman	குரூமேன்
Bhulon	புலோன்
Sodexho	சோடெக்ஸ்ஹோ
Alliance	அலையண்ஸ்
Torie	டோரி
World	வோர்ல்ட்
Series	சீரிஸ்
National	நேஷனல்
Museum	மியூஸியம்
of	ஆஃப்
the	த
Morgan	மார்கன்
Horse	ஹார்ஸ்
Gurudwara	குருத்வாரா
Data	தாதா
Bandi	பண்டி
Chhod	சாஹிப்
Nani	நானி
Strawberry	ஸ்டிராபெர்ரி
Fields	ஃப்பீல்ட்ஸ்
World	வோர்ல்ட்
School	ஸ்கூல்
Dharam	தரம்
Naji	நாஜி
Biswan	பிஸ்வான்
Abdul	அப்துல்
waajid	வாஜித்
Fritz	ஃப்ரிட்ஸ்
Yahan	யாஹான்
Se	சே
Shaher	ஷஹர்
Ko	கோ
Dekho	தேக்கோ
Gaayatree	காயத்ரீ
Khera	கெரா
Florida	ஃப்பிளோரிடா
Armina	அர்மினா
Ken	கென்
Wadsworth	வாட்ஸ்வர்த்
Provence	பிரோவென்ஸ்
Karunamayi	கருணாமாயி
Sledge	ஸ்லெட்ஜ்
Hockey	ஹாக்கி
Alakanandaa	அலகானன்தா
Asansol	அசான்சோல்
Junction	ஜங்ஷன்
Kal	கல்
Aaj	ஆஜ்
Aur	ஔர்
Kal	கல்
Elinor	எலினார்
Fishing	ஃபிஷிங்
Astro	அஸ்டிரோ
Bankata	பங்காடா
Ganeshganj	கணேஷ்கஞ்ச்
Prachetas	ப்ரசேடாஸ்
Husam	ஹுசம்
Ahmed	அஹ்மத்
al-Buni	அல்-புனி
Punita	புனிதா
Tanganyika	தன்கன்யிகா
Private	பிரைவெட்
Life	லைஃப்
Matav-Cable	மட்டவ்-கேபிள்
Systems	சிஸ்டம்ஸ்
Media	மீடியா
Banjaran	பஞ்சரன்
Shaanxi	ஷான்க்ஸி
History	ஹிஸ்டரி
Museum	மியூஸியம்
Shu'aa	ஷுவா
Ghataka	கட்டாகா
Varana	வரணா
Kismatwali	கிஸ்மத்வாலி
Japan	ஜப்பான்
Tobacco	டோபாக்கோ
Abdul	அப்துல்
jabbaar	ஜப்பார்
Kamajit	காமாஜித்
Mathew	மத்தேயு
Sinclair	சின்கிளேய்ர்
Amadeus	அமதேஸ்
Anshi	அன்ஷி
Bahurup	பஹருப்
Thiruvazhunthoor	திருவழுந்தூர்
Makki	மக்கி
Farz	ஃபர்ஸ்
Sarojini	சரோஜினி
Naidu	நாயுடு
Konkar	கொன்கர்
Aitbaar	அயித்பார்
Khiri	கிரி
Faiz	ஃபாயிஸ்
Port	போர்ட்
Moody	மூடி
Station	ஸ்டேஷன்
Museum	மியூஸியம்
Zeroun	ஜெரௌன்
Mednipur	மெத்னிபூர்
Hukaymah	ஹுகாய்மா
Minas	மினாஸ்
Gerais	கெராய்ஸ்
Aaminah	ஆமினா
Qadam	கடம்
Heera	ஹீரா
Panna	பன்னா
Neelabja	நீலாப்ஜா
Dawi	டாவி
Jaan	ஜான்
Pantanal	பாண்டலால்
Matogrossense	மட்டக்ரோசென்ஸ்
Ajanta	அஜந்தா
Ellora	எல்லோரா
Crispin	கிரிஸ்பின்
Bilaspur	பிலாஸ்பூர்
Dorcas	டார்கஸ்
Qanit	கானித்
Surkhiyaan	சுர்கியான்
Palki	பால்கி
Bromo	ப்ரோமோ
Tengger	டெங்கர்
Thuml	துமல்
Gari	காரி
Sienna	சியன்னா
The	த
oriya	ஒரியா
samaja	ஸமாஜா
Lutfi	லுத்ஃபி
Bighapur	பிகாபூர்
Hague	ஹேக்
Fadeelah	ஃபதீலா
Srirangam	ஸ்ரீரங்கம்
Meerut	மீரட்
Tambe	தாம்பே
Fort	ஃப்போர்ட்
honswijk	ஹான்ஸ்விஜ்க்
Taryn	டாரின்
Payasvinee	பயஸ்வினி
Iliamna	லியம்ன
Jump	ஜம்ப்
Rope	ரோப்
Gurudwara	குருத்வாரா
Gaoo	கவு
Ghat	காட்
Vibhas	விபாஸ்
Kamini	காமினி
Bachwara	பச்வாரா
Rock	ராக்
climbing	க்ளைம்பிங்
Raviprabha	ரவிபிரபா
Uruguay	உருகுவே
Shim	ஷிம்
sham	ஷாம்
Saint	செயிண்ட்
Olavs	ஒலாவ்ஸ்
medal	மெடல்
with	வித்
Oak	ஓக்
Branch	ப்ரான்ச்
Bhakt	பக்த்
Dhruv	துருவ்
Kumar	குமார்
Gumman	கும்மான்
Siju	சிஜூ
Dobhakol	டோபாகோல்
Sridevi	ஸ்ரீதேவி
Chugach	சுகாச்
Amrah	அம்ரா
Zeus	ஜூஸ்
Alvin	அல்வின்
Gatana	கடனா
Reservoir	டேம்
Aandhi	ஆந்தி
Aur	அவுர்
Toofan	தூஃபன்
Sharafat	ஷாராஃப்பத்
Chhod	சோத்
Di	தி
Maine	மைனே
Fidelio	ஃபிடெலியோ
Zelda	ஜெல்டா
Chandigadia	சண்டிகாடியா
Aanchal	ஆன்சால்
Dharap	தாரப்
Venkatapathy	வெங்கடாபதி
Raju	ராஜூ
Suvaas	சுவாஸ்
Mangesh	மங்கேஷ்
Bethel	பெதேல்
Apostolic	அபோஸ்தொலிக்
Shrinivas	ஸ்ரீநிவாஸ்
Abdul	அப்துல்
tawwab	தாவ்வாப்
Aage	ஆகே
Badho	படோ
Nilay	நிலய்
Court	கோர்ட்
University	யூனிவர்சிட்டி
of	ஆஃப்
Technology	டெக்னாலஜி
Fakhruddin	ஃப்பக்ருத்தீன்
Iraqi	ஈராக்கி
Sirmaur	சிர்மவூர்
Pyar	பியார்
Ka	கா
Mandir	மந்திர்
Arvi	ஆர்வி
Mary	மேரி
Antoinette	ஆண்டோய்னெட்டி
Abdus	அப்துஸ்
subbooh	சுப்பூ
Fort	ஃப்போர்ட்
snelling	ஸ்னெல்லிங்
Elham	எல்ஹாம்
Rakhdian	ரக்தியன்
Diler	திலேர்
Daku	தாக்கு
Indian	இந்தியன்
International	இன்டர்நேஷனல்
School	ஸ்கூல்
Abdul	அப்துல்
muzanni	முஸானி
Yaounde	யாவுன்டே
Anjhi	அஞ்சி
Doosra	தூஸ்ரா
Aadmi	ஆத்மி
Qadim	காடிம்
Abdul	அப்துல்
wahab	வாஹப்
Easau	ஈசா
Parthasarathi	பார்த்தசாரதி
Faysal	ஃபேஸல்
Jiyo	ஜியோ
To	தோ
Aise	அய்சே
Jiyo	ஜியோ
Protection	ப்ரொடெக்க்‌ஷன்
of	ஆஃப்
Natural	நேச்சுரல்
Amenities	அமினிட்டிஸ்
Medal	மெடல்
Surana	சுரானா
Gomer	கோமெர்
Tumucumaque	துமுகுமாகுயே
Degana	தேகனா
Junction	ஜங்ஷன்
Mahanagar	மஹாநகர்
Gas	கேஸ்
LeoNardo	லியோனார்டோ
Di	டி
Caprio	காப்ரியோ
Jagdeep	ஜகதீப்
Gajarupa	கஜாரூபா
Lutaaoo	லுதாவூ
Jimut	ஜிமுத்
Franco-British	ஃப்பிரான்கோ-பிரிட்டிஷ்
War	வார்
Ghar	கர்
Ki	கி
Bahu	பாஹு
Nancy	நான்சி
Reagan	ரீகன்
Cape	கேப்
Frontier	ஃப்பிரான்டியர்
War	வார்
Shake	ஷேக்
Hands	ஹாண்ட்ஸ்
Jakadia	ஜகாடியா
Godavari	கோதாவரி
Fertilizers	ஃபெர்டிலைசர்ஸ்
and	அண்ட்
Chemicals	கெமிக்கல்ஸ்
Kanch	கன்ச்
Aur	ஔர்
Heera	ஹீரா
Duddhinagar	துட்டிநகர்
Padmal	பத்மல்
Arne	அர்ன்
Chitrarath	சித்ராராத்
Steven	ஸ்டீவன்
Jack	ஜாக்
Dil	தில்
Tera	தேரா
Diwana	திவானா
Gurudwara	குருத்வாரா
Maal	மால்
Tekri	டேக்ரி
Deepaprabha	தீபபிரபா
Hariprasad	ஹரிபிரசாத்
chaurasia	சௌராசியா
Eagle	ஈகிள்
La	லா
Porte	போர்டெ
Belthara	பேல்தாரா
Road	ரோட்
Sachcha	ஸச்சா
Jhutha	ஜூதா
Popli	போப்லி
Faolan	ஃபாவுலான்
Maan	மான்
Anubhav	அனுபாவ்
Vishwesh	விஷ்வேஷ்
Cosmo	கோஸ்மா
Kahin	கஹின்
Aar	ஆர்
Kahin	கஹின்
Paar	பார்
Trevor	டிரெவர்
Laughlin	லாஃப்லின்
Milind	மிலிந்த்
Allie	அல்லி
Jyoti	ஜோதி
Bane	பனே
Jwala	ஜ்வாலா
Hidayat	ஹிதாயாத்
Inayat	இனாயாத்
Khan	கான்
Subansiri	சுபன்சிரி
Strait	ஸ்டிரெயிட்
of	ஆப்
Otranto	ஒட்ரான்டோ
Ray	ரே
Price	ப்ரைஸ்
Kaliyan	கலியாண்
Randhawa	ராந்த்வா
Walter	வால்டர்
Scott	ஸ்காட்
Wedlock	வெட்லாக்
Maati	மாட்டி
Manas	மானாஸ்
Rudolf	ருடாலஃப்
Nurway	நூர்வே
Sahl	சஹ்ல்
Qameer	கமீர்
Warren	வார்ரன்
Lees	லீஸ்
Rain	ரெயின்
Calcining	காலிசினிங்
Antu	அன்டு
Ladwa	லாத்வா
Sanvali	சன்வலி
Lencois	லென்காய்ஸ்
Maranhenses	மாரன்ஹென்சஸ்
Niyati	நியதி
Bilwai	பில்வாய்
Chamoli	சாமோளி
Nimat	நிமத்
Balavaan	பலவான்
Malcolm	மால்கம்
Balj	பால்ஜ்
Jawan	ஜவான்
Mard	மர்த்
Lucie	லுசி
Lucia	லுசியா
Prince	ப்ரின்ஸ்
Albert	ஆல்பர்ட்
Hakim	ஹாகிம்
Bey	பே
Jolene	ஜோலீன்
Boy	பாய்
Friend	ஃபிரண்ட்
Khushal	குஷால்
Ali	அலி
Hujwiri	ஹுஜ்விரி
Ekchari	ஏக்சாரி
Phoolendu	ஃபூளேந்து
Hasan	ஹசன்
Raza	ராஸா
Chawla	சாவ்லா
Gurudwara	குருத்வாரா
Doulatpur	தௌலத்பூர்
Sahib	சாஹிப்
Tarakeshwari	தாரகேஷ்வரி
Tess	டெஸ்
Suramaee	சுரமயி
Faridah	ஃபரீதா
Fakhrabad	ஃபக்ராபாத்
Zubair	ஜுபேர்
Shodh	ஷோத்
Dammika	டம்மிக்கா
Ranatunga	ரனதுங்கா
Deeptimoy	தீப்திமாய்
Aaj	ஆஜ்
Ka	கா
Daur	தவுர்
Bangalore	பெங்களூர்
City	சிட்டி
Junction	ஜங்ஷன்
Naya	நயா
Din	தின்
Nai	நை
Raat	ராத்
Bimala	பிமலா
Farlington	ஃப்பாலிங்டன்
redoubt	ரீடவுட்
Fort	ஃப்போர்ட்
george	ஜார்ஜ்
Choron	சோரோன்
Ki	கி
Baraat	பாராத்
Ayyappa	அய்யப்பா
Fort	ஃப்போர்ட்
uitermeer	உய்தெர்மீர்
Halim	ஹலிம்
Jewel	ஜுவெல்
Thief	தீஃப்
Rama	ராம
Lingeshwara	லிங்கேஷ்வர
Dharti	தர்தி
Ki	கி
God	கோத்
Mein	மெயின்
Murshidabad	முர்ஷிதாபாத்
Prix	ப்ரிக்ஸ்
des	டிஸ்
Deux-Magots	டியுக்ஸ்-மகோட்ஸ்
Laureus	லாரஸ்
World	வோர்ல்ட்
Sports	ஸ்போர்ட்ஸ்
Awards	அவார்ட்ஸ்
Xanto	ஜாண்டோ
Xanti	ஜாண்டி
Shrigeeta	ஸ்ரீகீதா
Carlos	கார்லோஸ்
Castaneda	காஸ்டனேடா
Rob	ராப்
Comfort	கம்ஃபோர்ட்
Roy	ராய்
Sharafat	ஷராஃபத்
Hyundai	ஹுண்டாய்
Fort	ஃப்போர்ட்
bij	பிஜ்
tienhoven	தேய்ன்ஹோவென்
Maadhuree	மாதுரீ
Abdul	அப்துல்
khabeer	காபீர்
Begunah	பெகுனா
Qaidi	கய்தி
Earlene	இயர்லீன்
Reporter	ரிப்போர்ட்டர்
Raju	ராஜூ
Danka	டன்கா
Giulio	கியூலியோ
Yvon	யுவோன்
Intl	இன்டல்
Business	பிஸினஸ்
Machines	மெஷின்ஸ்
Alicante	அலிகன்டே
Maida	மேடா
Hal	ஹல்
Aur	ஔர்
Bandook	பன்தூக்
Letitia	லெதிதியா
Laila	லைலா
Majnu	மஜ்னு
Tom	டாம்
Sangeeta	சங்கீதா
Qatl	கத்ல்
Vinchurkar	வின்சுர்கர்
Sati	சதி
Pingala	பிங்காலா
Bhatel	பட்டேல்
Bijrotha	பிஜ்ரோத்தா
Shamita	ஷமிதா
Coligny	கோலிக்னி
Gracie	கிரேஷி
Vinod	வினோத்
Mishra	மிஷ்ரா
Bilqis	பில்கிஸ்
Bakhtiyar	பக்தியார்
Painleve	பெயின்லேவ்
Khaufnak	கௌஃப்ன்க்
Aankhen	ஆங்கேன்
Kalkin	கல்கின்
Won	வன்
Alpesh	அல்பேஷ்
Vadher	வாதெர்
Rajgeer	ராஜ்கீர்
Vernon	வெர்னான்
Pyar	பியார்
Ki	கி
Raat	ராத்
Bindra	பிந்த்ரா
Bhatinda	பட்டிண்டா
Junction	ஜங்ஷன்
Neurochem	நியூரோகெம்
Sacchidanand	சச்சிதானந்த்
Gohad	கோஹாத்
Road	ரோட்
Chris	கிரிஸ்
Martin	மார்ட்டின்
Abdullah	அப்துல்லா
Kail	கைல்
Ek	ஏக்
Jhalak	ஜாலக்
Kishen	கிஷென்
Kanhaiya	கன்ஹையா
Sahebzade	சாஹெப்ஸாதே
Ghalodi	காலோடி
Bichia	பிச்சியா
Mountrail	மவுன்டிரெய்ல்
Laird	லயிர்ட்
University	யூனிவர்சிட்டி
of	ஆஃப்
Texas	டெக்சாஸ்
Filipina	ஃபிலிபினா
Alger	ஆல்கர்
Hiss	ஹிஸ்
Avadhesh	அவதேஷ்
Keerthi	கீர்த்தி
Ranasinghe	ரனசிங்கே
Aluabari	அலுவாபாரி
Road	ரோட்
Dohrighat	தோரிகாட்
Ruby	ருபி
Pixelplus	பிக்ஸல்பிலஸ்
Lagunas	லகுனாஸ்
de	டீ
Chacachua	சாச்சாசுவா
Lagunas	லகுனாஸ்
de	டீ
Montebello	மாண்டேபெல்லோ
Sherdil	ஷேர்தில்
Dharmendu	தர்மேந்த்ரு
Rod	ராட்
Serling	செர்லிங்
Maine	மேனெ
Jeena	ஜீனா
Seekh	சீக்
Liya	லியா
Zulqarnain	ஜுல்கார்நயின்
Ramish	ரமிஷ்
Ekavali	எகாவலி
Cape	கேப்
Town	டவுன்
Guruvayur	குருவாயூர்
Dionysius	டயோனிசியஸ்
Jivitesh	ஜிவிதேஷ்
Goti	கோட்டி
puas	புவாஸ்
Vrashal	விராஷல்
Matkari	மத்காரி
Barium	பேரியம்
Ramesh	ரமேஷ்
Powar	போவார்
Marvin	மார்வின்
H	எச்
McIntyre	மெக்கின்டைர்
Pimparikar	பிம்பாரிகர்
Dil	தில்
Ek	ஏக்
Mandir	மந்திர்
Chhaila	சஹைலா
Babu	பாபு
Sati	சதி
Sulochana	சுலோச்சனா
Indian	இந்தியன்
Oil	ஆயில்
Sohni	சோஹ்னி
Mahiwal	மஹிவால்
Sean	சீன்
Williams	வில்லியம்ஸ்
Patki	பத்கி
Bhawabhooti	பாவாபூட்டி
Dysis	டைசிஸ்
Bangarapet	பங்கார்பேட்
Axcan	ஆக்ஸன்
Pharma	பார்மா
The	தி
Ashes	ஆஷஸ்
Mahaan	மஹான்
Sunset	சன்செட்
Hills	ஹில்ஸ்
Nothe	நோதே
fort	ஃப்போர்ட்
Hamajoli	ஹமஜோலி
Nicole	நிகோல்
Brown	பிரவுன்
Simpson	சிம்சன்
Piratenpriset	பிரான்டென்ப்ரீஸ்ட்
Hammam	ஹம்மம்
Randilyn	ராண்டில்யன்
General	ஜெனரல்
Dynamics	டைனமிக்ஸ்
Preyasi	ப்ரேயஸி
Medak	மெதாக்
Shola	ஷோலா
Jo	ஜோ
Bhadke	பாட்கே
Meri	மேரி
Awaaz	ஆவாஸ்
Suno	சுனோ
Wilhem	வில்ஹென்
Busch	புஷ்
Museum	மியூஸியம்
Ram	ராம்
Darshan	தர்ஷன்
Anakapalle	அனாகபல்லே
Ajendra	அஜெந்திரா
Tonback	டோன்பேக்
Ashtkarna	அஷ்த்கர்னா
Astra	ஆஸ்ட்ரா
Microwave	மைக்ரோவேவ்
Chuck	சவுக்
Barry	பேரி
Nidhi	நிதி
Al	அல்
Biradhwal	பிராத்வால்
Beas	பீஸ்
Gurudwara	குருத்வாரா
Chhiharta	சிஹர்டா
Sahib	சாஹிப்
Basmat	பாஸ்மத்
Maunath	மவுனத்
Bhanjan	பன்ஜன்
Kouchibouguac	கோச்சிபவுகாக்
Saint	செயிண்ட்
Michael's	மைக்கெல்ஸ்
Academy,	அகாடெமி,
Chennai	சென்னை
National	நேஷனல்
herald	ஹெரால்ட்
Bhavani	பவானி
Nagar	நகர்
Purbi	புர்பி
Wayne	வாய்னே
Diar	தியார்
Yitzhak	யிட்ஷாக்
Robin	ராபின்
Manzana	மன்ஸானா
Havells	ஹாவெல்ஸ்
India	இந்தியா
Melbourne	மெல்போர்ன்
Purba	புர்பா
Nahida	நாஹிடா
Takhat	தகத்
Shri	ஸ்ரீ
Kesgarh	கேஸ்கர்
Sahib,	சாஹிப்,
Anandpur	ஆனந்த்பூர்
Sahib	சாஹிப்
(Punjab)	(பஞ்சாப்)
Forbes	ஃப்போர்ப்ஸ்
galleries	கேலரீஸ்
Anish	அனீஷ்
Din	தின்
Dahade	தஹாதே
Gourie	கெளரை
Mansukh	மன்சுக்
Balyogi	பாலயோகி
Upmanyu	உபமன்யு
Thirunavukkarasu	திருனாவுக்கரசு
Kumaran	குமரன்
Kane	கேன்
Anokha	அனோகா
Milan	மிலன்
Megan	மேகன்
Tenerife	டெனரிப்
South	செளத்
Reina	ரேயினா
Sofia	சோஃபியா
Dekhi	தேக்கி
Teri	தேரி
Bambai	பம்பாய்
Mehandiratta	மெஹாதிராட்டா
World	வோர்ல்ட்
Association	அசோசியேஷன்
of	ஆஃப்
Newspapers's	நியூஸ்பேப்பர்ஸ்
Golden	கோல்டன்
Pen	பென்
of	ஆஃப்
Freedom	ஃப்ரீடம்
Award	அவார்ட்
Samuel	சாமுவேல்
Taylor	டெய்லர்
Coleridge	கோலேரிட்ஜ்
Lindy	லின்டி
hop	ஹாப்
Vic	விக்
Marks	மார்க்ஸ்
New	நியூ
tavern	டாவர்ன்
fort	ஃப்போர்ட்
Sridharan	ஸ்ரீதரண்
Jeganathan	ஜெகநாதன்
Agra	ஆக்ரா
City	சிட்டி
Sherlock	ஷெர்லாக்
Fort	ஃப்போர்ட்
smith	ஸ்மித்
Jane	ஜேன்
Sumnah	சும்னா
Maanakalaal	மானகலால்
Gholam	கோலாம்
Nousher	நவ்ஷர்
Kopran	கோப்ரான்
Friedland	ஃபிரைட்லாண்ட்
Bengali	பெங்காளி
Taconic	டாகோனிக்
Cox	காக்ஸ்
Sabihah	சபிஹா
Mela	மேளா
Humam	ஹுமம்
Nikhat	நிகாத்
Marcs	மார்க்ஸ்
Mcguire	மெக்குரே
Phil	பில்
DeFreitas	டிஃப்பிரேடாஸ்
Beaverhead	பீவர்ஹெட்
Warwick	வார்விக்
De	டி
Montfort	மாண்ட்ஃபோர்ட்
University	யூனிவர்சிட்டி
Sant	சன்த்
Ravidas	ரவிதாஸ்
Ki	கி
Amar	அமர்
Kahani	காஹானி
Saint	செயிண்ட்
John's	ஜான்ஸ்
High	ஹை
School,	ஸ்கூல்,
Chandigarh	சண்டிகர்
Fort	ஃப்போர்ட்
mackay	மாக்கே
Inkaar	இன்கார்
Tarantella	டாரன்டெல்லா
Rushil	ருஷில்
Mahaveer	மஹாவீர்
School	ஸ்கூல்
Lakshmi	லக்‌ஷ்மி
Machine	மெஷின்
Anantaraam	அனன்த்தாராம்
Mustafeed	முஸ்தாஃபீத்
Badle	பட்லே
Ki	கி
Aag	ஆக்
Lorena	லோரினா
Dance	டேன்ஸ்
Dance	டேன்ஸ்
Neelanjana	நீலஞ்சனா
Abduh	அப்துஸ்
shahid	ஷாஹித்
Daaku	தாகு
Dot	டாட்
Alaknandaa	அலக்னன்தா
Kasam	கசம்
Dhande	தண்டே
Ki	கி
Bambai	பம்பை
Ki	கி
Billi	பில்லி
Bland	பிளாண்ட்
King	கிங்
Faisal	ஃபைசல்
Foundation	ஃபவுண்டேஷன்
Prize	ப்ரைஸ்
Vidyashankar	வித்யாஷங்கர்
Dighwara	திக்வாரா
Barsoi	பார்சோய்
Junction	ஜங்ஷன்
Owais	ஓவைஸ்
Jamie	ஜாமி
Dalrymple	டால்ரிம்பிள்
Naya	நயா
Rasta	ராஸ்தா
Xavier	ஜேவியர்
Marshall	மார்ஷல்
Ostroh	ஓஸ்டிராஹ்
Bhagyawati	பாக்யவதி
Saz	சாஸ்
Bhupalsagar	பூபால்சாகர்
Geetanjali	கீதாஞ்சலி
Kurnul	குர்னூல்
Daleville	தலேவில்லே
Baptist	பேப்டிஸ்ட்
Djembe	டிஜெம்பே
Menai	மெனை
Ram	ராம்
Calix	காலிக்ஸ்
Nantie	நேண்டி
Hayward	ஹேவர்ட்
Rae	ரேய்
Missouri	மிஸ்ஸோரி
Qabeel	காபீல்
Freedom	ஃப்ரீடம்
Award	அவார்ட்
Hum	ஹம்
Nahin	நஹின்
Sudhrenge	சுத்ரேங்கே
Awaragardi	ஆவாராகர்தி
Abbasi	அப்பாஸி
Delfina	டெல்ஃபினா
Algernon	அல்கெர்னான்
Vishnu	விஷ்ணு
Bharat	பரத்
Arun	அருண்
Scailex	ஸ்கைலெக்ஸ்
Corporation	கார்ப்பரேஷன்
Food	ஃபுட்
Corporation	கார்ப்பரேஷன்
of	ஆஃப்
India	இந்தியா
Clayland	கிளேலாண்ட்
Pinta	பிண்டா
Sarangi	சாரங்கி
Ujung	உஜுங்
Kulon	குலுன்
John	ஜான்
F.	எஃப்.
Kennedy	கென்னடி
Chaure	சௌரே
Bazar	பஜார்
Asomiya	அஸோமியா
khabor	காபோர்
Mad	மாட்
Bhare	பரே
Nain	நய்ன்
Nidhish	நிதிஷ்
Dacait	தகயித்
Arthur	ஆர்தர்
haley	ஹேலி
Saparna	சபர்னா
Firdausi	ஃபிர்டௌசி
Lu	லு
luah	லுவா
Rahole	ரஹோலே
Lakkhewali	லாக்கெவாலி
Abdul	அப்துல்
malik	மாலிக்
Mave	மவே
Chandisar	சண்டிசார்
Belfast	பெல்பாஸ்ட்
City	சிட்டி
Forbesganj	ஃபோர்பெஸ்கஞ்ச்
Uzma	உஸ்மா
Schnieder	ஷ்னைடர்
Electric	எலக்ட்ரிக்
Alaska	அலாஸ்கா
Baisakhi	பைசகி
Amelie	அமாலீ
Daku	தாக்கு
Hasina	ஹசினா
Kapoor	கபூர்
Enel	எனல்
Avril	அவ்ரில்
Aaj	ஆஜ்
Ki	கி
Awaaz	ஆவாஸ்
Ikhlas	இக்லாஸ்
Bridgeport	பிரிட்ஜ்போர்ட்
Christian	கிறிஸ்டியன்
Hanash	ஹனாஷ்
Jawani	ஜவானி
Diwani	திவானி
Vandanaa	வந்தனா
Precious	ப்ரெஷியஸ்
Aacharya	ஆசார்யா
Van	வன்
Mangat	மங்கத்
Kanker	கன்கர்
Jamini	ஜாமினி
Trump	ட்ரம்ப்
Feleti	ஃபெலேடி
Crenshaw	கிரென்ஷா
Fort	ஃப்போர்ட்
frederica	ஃப்பிரெட்ரிக்கா
Savoie	சாவோயி
Wind	விண்ட்
River	ரிவர்
Laith	லைத்
Munimji	முனிம்ஜி
Akash	அகாஷ்
Alakananda	அலகானன்தா
Sundargarh	சுந்தர்கர்
Saugandh	சோகாந்த்
Vijeti	விஜேதி
Baha	பஹா
al	அல்
din	தின்
Robert	ராபர்ட்
Browning	ப்ரௌனிங்
Instrumental	இன்ஸ்ட்ருமெண்டல்
Rock	ராக்
Guitar	கிட்டார்
Hall	ஹால்
Of	ஆஃப்
Fame	ஃபேம்
Acharyasuta	ஆசார்யாசுதா
Sanjay	சஞ்சய்
Bangar	பங்கர்
Premnath	ப்ரேம்நாத்
Bajaj	பஜாஜ்
Philpot	பில்போட்
Aimee	ஐமீ
Do	தோ
Gulab	குலாப்
Samant	சமன்த்
Abdur	அப்துர்
Rauf	ரௌஃப்
Murlin	முர்லின்
munro	மண்ரோ
Safeway	சேப்வே
Grindwell	க்ரைண்ட்வெல்
Norto	நார்டோ
Pindus	பிண்டஸ்
Shalaakaa	ஷலாகா
Cynara	சைனாரா
Desh	தேஷ்
Ke	கே
Dushmann	துஷ்மன்
Schooten	ஷூடென்
Schell	ஷெல்
Creek	கிரீக்
Rajanigandha	ரஜனிகந்தா
Dundlod	துண்ட்லோட்
Guler	குலேர்
Kat	கேட்
Mayur	மயூர்
Gopikrushna	கோபிகிருஷ்ணா
Wildewood	வைல்ட்வுட்
Christian	கிறிஸ்டியன்
Pyar	பியார்
Ka	கா
Bandhan	பந்தன்
Tulasidas	துளசிதாஸ்
Deutsche	டச்
Telekom	டெலிகாம்
Heckenberg	ஹெக்கென்பெர்க்
Leonard	லியோனார்ட்
Neemuch	நீமச்
Klang	க்லங்
Gates	கேட்ஸ்
Maddock	மேட்டாக்
Aan	ஆன்
Aur	அவுர்
Shaan	ஷான்
Farishta	ஃபரிஷ்டா
Ya	யா
Qatil	காதில்
Koparkar	கோபர்கர்
Royal	ராயல்
Academy	அகாடெமி
of	ஆஃப்
Arts	ஆர்ட்ஸ்
Agni	அக்னி
Rekha	ரேகா
Avani	அவானி
Alibagh	அலிபாக்
Bhoun	பெளன்
Krashnapingaakshan	க்ராஷ்னாபிங்காக்ஷான்
Bhadan	பாதன்
Durgapura	துர்காபூரா
Dhamni	தாமினி
Gurtej	குர்தேஜ்
Awara	ஆவாரா
Dana	தனா
Pani	பாணி
Chowkidaar	சௌகிதார்
Baba	பாபா
Bulleh	புல்லெஹ்
Shah	ஷா
Medal	மெடல்
of	ஆஃப்
Ushakov	உஷாகோவ்
Gujral	குஜ்ரால்
Christiana	கிரிஸ்டியானா
Hajar	ஹஜர்
United	யூனைடெட்
America	அமெரிக்கா
Indemnity	இன்டெம்னிட்டி
Agnikaal	அக்னிகால்
Giovanna	ஜியோவினா
Vezina	வெஸீனா
Trophy	ட்ராஃபி
Tower	டவர்
Place	பிளேஸ்
Three	த்ரி
Sibelius	சிபெலியஸ்
Prize	ப்ரைஸ்
Nitin	நிதின்
Kanun	கனூன்
Khatoon	காதூன்
Ketaki	கேடாகி
Groupe	குரூப்
Danone	டானோன்
Agro	ஆக்ரோ
Tech	டெக்
Foods	ஃபுட்ஸ்
Nadaniyan	நாதானியன்
shark	ஷார்க்
Dil	தில்
Tujh	துஜ்
Ko	கோ
Diya	தியா
Pramiti	ப்ரமிதி
Nick	நிக்
Knight	நைட்
City	சிட்டி
Union	யூனியன்
Bank	பேங்க்
Gurudwara	குருத்வாரா
Sahibdewa	சாஹிப்தேவா
Jai	ஜெய்
Ho	ஹோ
Mohabbat	மொஹபத்
Ki	கி
Hanste	ஹன்ஸ்டே
Zakhm	ஸகம்
Garfield	கர்ஃபீல்ட்
Ranjanee	ரஞ்சனீ
Aurat	ஔரத்
Aur	ஔர்
Parinda	பரிந்தா
Gul-e-rana	குல்-இ-ரானா
Gurudwara	குருத்வாரா
Raada	ராடா
Sahib	சாஹிப்
Asmita	அஸ்மித்தா
Ek	ஏக்
Dil	தில்
Sau	சௌ
Afsane	அஃப்சனே
Gaurang	கெளராங்
Tina	டீனா
Phaansi	பான்ஸி
Ke	கே
Baad	பாத்
Grizelda	கிரிஸெல்டா
Nao	நாவ்
Popular	பாப்புலர்
Shyamali	ஷியாமளி
Gratiana	கிரேஷியானா
Jasmin	ஜாஸ்மின்
Atonement	அடோன்மெண்ட்
Lutheran	லுதெரன்
Abington	அபிங்டன்
Mark	மார்க்
Haslam	ஹஸ்லம்
Marubeni	மாருபெனி
Eeckeren	ஈக்கெரன்
Grey	க்ரே
Cup	கப்
Saint	செயிண்ட்
Xaviers's	ஸேவியர்ஸ்
School,	ஸ்கூல்,
Chandigarh	சண்டிகர்
Jaipur	ஜெய்பூர்
fort	ஃபோர்ட்
Abdus	அப்துஸ்
sabur	சாபுர்
Cartoon	கார்டூன்
Museum	மியூஸியம்
Siberut	சிபேருட்
Ian	ஐயன்
Kantimoy	கான்டிமாய்
Trevor	டிரெவர்
Chappell	சாப்பெல்
Galaxy	காலாக்ஸி
Fort	ஃப்போர்ட்
wellington	வெல்லிங்டன்
Pearl	பேர்ல்
Tslima	ட்சிலிமா
Nasreen	நஸ்ரின்
Atulya	அட்டூல்யா
Jaamdar	ஜாம்தர்
Mazdoor	மஸ்தூர்
Zindabad	ஸிந்தாபாத்
Parimal	பரிமல்
Bijli	பிஜ்லி
Yomiuri	யோமியுரி
Prize	ப்ரைஸ்
for	ஃபார்
Literature	லிட்ரேச்சர்
Shilaajeet	ஷிலாஜீத்
Bhola	போலா
Bhala	பாலா
Central	சென்ட்ரல்
European	யூரோப்பியன்
Media	மீடியா
Enterprises	என்டர்பிரைசஸ்
Chaudhvin	சௌத்வின்
Ka	கா
Chand	சந்த்
Sophia	சோஃபியா
Krashn	கிருஷான்
Bharat	பாரத்
samachar	சமாச்சர்
Norm	நார்ம்
Brahmachari	பிரஹ்மச்சாரி
Abhijeet	அபிஜீத்
Alamnagar	அலம்நகர்
Dwarka	துவாரகா
Chalte	சல்தே
Chalte	சல்தே
Rocco	ரோக்கோ
Adecco	அடெக்கோ
James	ஜேம்ஸ்
Ormond	ஆர்மண்ட்
Clark	கிளார்க்
Harmony	ஹார்மோனி
Baptist	பேப்டிஸ்ட்
Clara	கிளாரா
Abdul	அப்துல்
hafeed	ஹாஃபீத்
Shaitani	ஷைத்தானி
Ilaaka	இலாகி
Judamnah	ஜுதாம்னா
Devar	திவார்
Band	பேண்ட்
Master	மாஸ்டர்
Kajji	கஜ்ஜி
Bal	பால்
Kuhad	குஹாத்
Rollo	ரோல்லோ
Hyderabad	ஹைதெராபாத்
Public	பப்ளிக்
School	ஸ்கூல்
Kevin	கெவின்
Spacey	ஸ்பேசி
Chloris	கிளோரிஸ்
Sanjukta	சஞ்சுக்தா
Vijaynagar	விஜய்நகர்
Ek	ஏக்
Tha	தா
Ladka	லட்கா
Trethewey	டிரெதேவே
Hida	ஹிடா
Karuna	கருணா
Mae	மாயீ
Mac	மேக்
Mab	மாப்
Maa	மா
Leopold	லியோபோல்ட்
Debra	டெப்ரா
Winger	விங்கர்
Kamilah	கமிலா
Donnica	டோனிக்கா
Mawana	மவானா
Sugar	சுகர்
Susane	சுஸன்
Amar	அமர்
Singh	சிங்
Rathod	ரதோட்
Premala	ப்ரேமலா
Desai	தேசாய்
Vaparaiso	வபரைசோ
Church	சர்ச்
of	ஆப்
Christ	கிறிஸ்ட்
Order	ஆர்டர்
of	ஆஃப்
the	தி
Lion	லயன்
of	ஆஃப்
Finland	ஃபின்லேண்ட்
Chankanab	சங்கநாப்
Bay	பே
Tulayhah	துளாய்ஹா
Vaishali	வைஷாலி
Montagu	மான்டாகு
Ramkumar	ராம்குமார்
First	ஃபர்ஸ்ட்
Chinese	சைனீஸ்
Komatsu	கோமட்சு
Nayana	நயனா
Jahdamah	ஜதாமா
Lunglei	லுங்லே
Layyah	லய்யா
Napoleon	நெப்போலியன்
Gaj	காஜ்
Olfert	ஓலஃப்பெர்ட்
Fischer	ஃப்பிஷ்ஷர்
Ranjith	ரஞ்சித்
Madurasinghe	மதுரசிங்கே
Berchtesgaden	பெர்ச்டெஸ்கார்டன்
Love	லவ்
Corine	கோரின்
Udayshankar	உதய்சங்கர்
Door	தூர்
Wadiyon	வடியோன்
Mein	மெயின்
Kahin	கஹின்
Fort	ஃப்போர்ட்
brown	பிரவுன்
Clifford	கிளிஃப்ஃபோர்ட்
Warithah	வரிதா
Mitesh	மிதுல்
Dost	தோஸ்த்
Garibon	கரிபோன்
Ka	கா
Courtney	கோர்ட்னி
Browne	ப்ரவுன்
Geoff	ஜியோஃப்
Cope	கோப்
Jagadeep	ஜகதீப்
Ma	மா
as-sama	அஸ்-சமா
Sadiq	சாதிக்
Mohammad	மொஹம்மத்
Chhidgaon	சிட்காவுன்
Minakshi	மீனாட்சி
Sundareshvara	சுந்தரேஸ்வரர்
Colombo	கொழும்பு
Nazli	நஸ்லி
Bolero	போலெரோ
Community	கம்யூனிட்டி
of	ஆஃப்
Christ	க்றைஸ்ட்
International	இண்டர்நேஷனல்
Peace	பீஸ்
Award	அவார்ட்
Bandhan	பந்தன்
Anjana	அஞ்சனா
Kumar	குமார்
Bhanudas	பானுதாஸ்
Graham	கிராஹாம்
Lloyd	லாய்ட்
Gumtala	கும்டாலா
Lajwanti	லஜ்வந்தி
Pendse	பென்த்சே
Cecelia	செசிலியா
Aag	ஆக்
Khartoum	கர்தவும்
Karah	காரா
Open	ஓபென்
Text	டெக்ஸ்ட்
Corporation	கார்ப்பரேஷன்
Karan	கரன்
Bhaalachandr	பாலசந்தர்
Mayuri	மயூரி
Pilibhit	பிலிப்ஹ்த்
Fort	ஃப்போர்ட்
op	ஆப்
de	டி
ruigenhoeksedijk	ரூய்ஜென்ஹோக்ஸெடிஜ்க்
University	யூனிவர்சிட்டி
of	ஆஃப்
New	நியூ
England	இங்க்லேண்ட்
Vikramjit	விக்ரம்ஜித்
Pascal	பாஸ்கல்
Danone	டானோன்
International	இண்டர்நேஷனல்
Prize	ப்ரைஸ்
for	ஃபார்
Nutrition	ந்யூட்ரீஷன்
Raton	ராதோன்
Ka	கா
Raja	ராஜா
Bakarah	பகரா
Nida	நிடா
Depalsar	தெபால்சர்
Lecea	லெசியா
Banseelaal	பன்ஸீலால்
Kaalkunja	கால்குஞ்ஜா
Abrolhos	அப்ரோல்ஹோஸ்
Marine	மெரைன்
Mahakutta	மஹாகுதா
Greening	க்ரீனிங்
Ghutai	கூட்டாய்
Drupad	த்ருபாத்
Abdul	அப்துல்
khaaliq	காலிக்
Police	போலிஸ்
Station	ஸ்டேஷன்
Mud	முட்
Mud	முட்
Ke	கே
Na	நா
Dekh	தேக்
Abodh	அபோத்
Allendale	அலென்டேல்
Ellesmere	எல்ஸ்மேர்
Gurudwara	குருத்வாரா
khandur	கண்டூர்
Sahib	சாஹிப்
Thanedaar	தானேதார்
Argheshwara	அர்கேஷ்வரா
Chris	கிரிஸ்
Smith	ஸ்மித்
Rumesh	ருமேஷ்
Ratnayake	ரத்னாயகே
Maha	மஹா
Sangram	சங்கிரம்
Synclair	சின்கிளைர்
Kamod	கமோத்
Kronprinz	கிரான்பிரின்ஸ்
Wilhelm	வில்ஹெம்
Ashapurna	ஆஷாபூர்ணா
Devi	தேவி
Tulsidas	துள்சிதாஸ்
Shabnam	ஷப்னம்
Syed	சயத்
Akhtar	அக்தர
Imam	இமாம்
Quadri	காத்ரி
Raghuraaee	ரகுராயி
Abhiveer	அபிவீர்
Kunal	குனால்
Menara	மேனரா
Maybank	மேபேங்க்
Ingersoll	இங்கர்சால்
Rand	ரேண்ட்
Gail	கெய்ல்
Sheehy	ஷீஹி
Nand	நந்த்
Kumar	குமார்
Haree	ஹரீ
Naujawan	நவ்ஜவான்
Lancers	லான்செர்ஸ்
Farasat	ஃபராசத்
Shatarupa	ஷதருபா
Natchez	நாட்செஸ்
Trace	டிரேஸ்
Parkway	பார்க்வே
Charumati	சாருமதி
Noguchi	நோகுச்சி
Museum	மியூஸியம்
Zahrah	ஜாரா
Baqir	பாக்கிர்
More	மொரே
Mera	மேரா
Suhag	சுஹாக்
Forrester	ஃபாரஸ்டர்
Petra	பெட்ரா
Nyckelharpa	நிக்கெல்ஹார்பா
REEDSPORT	ரீட்ஸ்போர்ட்
CHRISTIAN	கிறிஸ்டியன்
United	யுனைடெட்
Phosphorous	ஃபாஸ்பரஸ்
Diwana	திவானா
Pink	பிங்க்
Taybah	தைபா
Vlora	விளோரா
Abdur	அப்துர்
raheem	ரஹீம்
Diya	தியா
Summayyah	சுமய்யா
Laxman	லக்ஷ்மன்
Sivaramakrishnan	சிவராமாகிருஷ்ணன்
Ehsanul	எஹ்சானுல்
Haque	ஹக்
Taurus	டாரஸ்
Dipa	திபா
Mudrikaa	முத்ரிகா
Badminton	பேட்மிண்டன்
Parker	பார்கெர்
Monty	மோண்டி
Raigarh	ரைகார்
Izhar	இஸ்ஸார்
Manimuthar	மணிமுத்தாறு
Reservoir	ரிசர்வாயர்
Jai	ஜெய்
Jawan	ஜவான்
Jai	ஜெய்
kisan	கிஸான்
Dil	தில்
Ki	கி
Basti	பஸ்தி
Darbar	டர்பார்
Peter	பீட்டர்
Martin	மார்ட்டின்
Intercontinental	இண்டர்காண்டினண்டல்
Cup	கப்
Zulm	ஸுல்ம்
Ko	கோ
Jala	ஜாலா
Doonga	டூங்கா
Etna	எட்னா
Angus	ஆங்கஸ்
Mackay	மக்காய்
Shirlyn	ஷிர்லின்
Snehal	ஸ்னேஹல்
Samosir	சாமோசிர்
Bade	படே
Ghar	கர்
Ki	கி
Beti	பெடி
Habibul	ஹபிபுல்
Bashar	பாஷர்
Jaal	ஜால்
Saaz	சாஸ்
Messinia	மெசினியா
Firoza	ஃபிரோஸா
Tulayb	துளாய்ப்
Prabodhan	ப்ரபோதன்
Akela	அகேலா
Nai	நயி
Umar	உமர்
Ki	கி
Nai	நை
Fasal	ஃப்பைசல்
Archit	அர்சித்
Richard	ரிச்சர்ட்
Blakey	பிலேகே
Vaikom	வைக்கம்
Mahadevar	மஹாதேவர்
Azaadeh	அஸாதேஹ்
Raghunath	ரகுநாத்
Timothy	டிமோதி
Shripad	ஸ்ரீபத்
Pewar	பேவார்
Abdul	அப்துல்
baaqee	பாகீ
Narsimha	நர்ஸிம்ஹா
Avtar	அவ்தார்
Viveca	விவேகா
Jazbaat	ஜஸ்பாத்
Laurent	லாரன்ட்
Carnegie	கார்னீஜீ
Medal	மெடல்
Shahenshah	ஷாஹென்ஷா
Bhiwani	பிவானி
Hero	ஹீரோ
Motors	மோட்டார்ஸ்
Fauve	ஃபாவே
Jadui	ஜாடுய்
Bansari	பன்சாரி
Nandana	நந்தனா
Kelvingrove	கெல்வின்குரூவ்
Art	ஆர்ட்
Gallery	கேலரி
and	அண்ட்
Museum	மியூஸியம்
Anandtandavpur	ஆனந்ததாண்டவபூர்
Kardawiyah	கார்டவியா
Organ	ஆர்கன்
Lychnostatis	லைக்னாஸ்டைடிஸ்
Open-air	ஓபன்-ஏர்
Museum	மியூஸியம்
Norman	நார்மேன்
Gifford	கிஃப்போர்ட்
Gurjit	குர்ஜித்
Mere	மேரெ
Arman	அர்மான்
Mere	மேரா
Sapne	ஸப்னே
Avinash	அவினாஷ்
Pavitra	பவித்ரா
Papi	பாபி
Agniprav	அக்னிப்ரவ்
Achalda	அசால்டா
Deeg	தீக்
Shriram	ஸ்ரீராம்
Cuddalore	கூடலூர்
Port	போர்ட்
Stu	ஸ்டூ
Gillespie	கில்லெஸ்பி
Dvoyanka	த்வோயாங்கா
Kevin	கெவின்
Duers	டுயர்ஸ்
Deere	டீரி
Shravastinagar	ஷ்ரவஸ்திநகர்
Pingala	பிங்காலா
Sikta	சிக்தா
Indushekhar	இந்துஷேக்கர்
Roger	ரோஜர்
Harper	ஹார்ப்பர்
Phir	பிர்
Kab	கப்
Milogi	மிலோகி
Khattkar	காட்கர்
Shehryaar	ஷெஹ்ரியார்
Angara	அங்காரா
Zairah	ஜேரா
Dhamaka	தமாகா
Davis	டேவிஸ்
Museum	மியூஸியம்
and	அண்ட்
Cultural	கல்ச்சுரல்
Art	ஆர்ட்
Capellen	காபெல்லன்
fort	ஃப்போர்ட்
Arav	அரவ்
Abhivir	அபிவிர்
Dungar	துங்கார்
Junction	ஜங்ஷன்
Medals	மெடல்
of	ஆஃப்
Honor	ஹானர்
Narragansett	நராகன்செட்
Kisi	கிஸி
Kiyaad	கியாத்
Ramprasad	ராம்பிரசாத்
Satyadev	சத்யதேவ்
Kamla	கம்லா
Alexia	அலெக்ஸியா
Weymark	வேமார்க்
Badrudin	பத்ருதின்
Golden	கோல்டன்
Klarika	கிளாரிகா
Eisa	ஐஸா
Shiv	ஷிவ்
Ganga	கங்கா
Abdus	அப்துஸ்
sattaar	சத்தார்
Cassara	கஸ்ஸாரா
Tierney	டியர்னி
Kaun?	கோன்?
Kaisey?	கெய்சே?
Naveena	நவீனா
Damien	டாமியன்
Martyn	மார்டைன்
Ajit	அஜித்
Agarkar	அகர்க்கர்
Sawan	சாவன்
Aya	அயா
Re	ரே
Ark	ஆர்க்
Royal	ராயல்
Charusheela	சாருஷீலா
Giraftaar	ஜிராஃப்தார்
Countrywide	கன்ட்ரிவைட்
Financial	ஃபினான்ஷியல்
Sompo	சோம்போ
Japan	ஜப்பான்
Insurance	இன்ஷூரன்ஸ்
Chittesh	சித்தேஷ்
Ajeeb	அஜீப்
Ittefaq	இட்டேஃபக்
Minto	மிண்டோ
Cup	கப்
Analaa	அனலா
Alibaug	அலிபாக்
fort	ஃப்போர்ட்
Yelena	எலேனா
Bhale	பாலே
Unimak	யூனிமேக்
Shambhu	ஷாம்பு
The	த
Museon	மியூஸியான்
Azeem	அஸீம்
AhmedNagar	அஹ்மெத்நகர்
Brisbon	பிரிஸ்பன்
Gurudwara	குருத்வாரா
Punjokhara	பஞ்சோக்ரா
Sahib	சாஹிப்
Fort	ஃப்போர்ட்
halifax	ஹாலிஃப்பாக்ஸ்
Navabharat	நவபாரத்
Ferro	ஃபெர்ரோ
Alloys	அல்லாய்ஸ்
Prithviraj	பிரித்விராஜ்
Sayogita	சயோகிதா
Samasya	சம்ஸ்யா
Licia	லிசியா
Arni	ஆரணி
Road	ரோட்
Flying	ஃபிளையிங்
Circus	சர்க்கஸ்
Briscoe	பிரிஸ்கோ
Hawaiian	ஹவாயன்
Baazi	பாஸி
Amanda	அமான்டா
William	வில்லியம்
nagar	நகர்
Sardar	சர்தார்
Patel	பட்டேல்
Vidyalaya,	வித்யாலயா,
New	நியூ
Delhi	டெல்லி
Paramjeet	பரம்ஜீத்
Port	போர்ட்
Elizabeth	எலிசபத்
Gumthal	கும்தால்
Keith	கேய்த்
Wyomina	வயோமினா
Park	பார்க்
Baptist	பேப்டிஸ்ட்
Prince	ப்ரின்ஸ்
Harry	ஹேரி
Mirza	மிர்ஸா
Ghalib	காலிப்
Nawada	நவாத்
Rumba	ரும்பா
Princess	பிரின்செஸ்
Saba	சபா
Ross	ராஸ்
Sea	சீ
Gangtok	கேங்க்டாக்
Khoon	கூன்
Ki	கி
Keemat	கீமத்
Medal	மெடல்
of	ஆஃப்
Heroism,	ஹீரோயிசம்,
Military	மிலிட்டரி
Wavde	வாவ்தே
Orrin	ஓரின்
Larissa	லரிஸ்ஸா
Thalia	தாலியா
Lakshmidhar	லக்ஷ்மிதர்
Zarrah	ஜரா
Sainath	சாய்நாத்
Asian	ஏசியன்
Paints	பெயிண்ட்ஸ்
Ambika	அம்பிகா
Kalna	கல்னா
Ansoo	அன்ஸூ
Ki	கி
Duniya	துனியா
Daniel	டானியல்
Vettori	வெட்டோரி
Kafan	கஃபன்
Surjot	சுர்ஜோத்
Morna	மார்னா
Gandak	கன்டக்
Dakshata	தக்ஷதா
Ihtiram	இஹ்திராம்
Aadityvardhan	ஆதித்வர்தன்
Chintamani	சிந்தாமணி
Surdaas	சுர்தாஸ்
Jaraah	ஜரா
Nick	நிக்
Mingan	மிங்கன்
Archipelago	ஆர்சிபெலாகோ
David	டேவிட்
Murray	முர்ரே
Fridhem	ஃபிரிதெம்
Lutheran	லுதெரன்
Crookhorn	க்ரூக்ஹார்ன்
redoubt	ரீடவுட்
Ghoradongri	கோராடோங்ரி
Hessen	ஹெஸ்ஸென்
Sej	சேர்
Piya	பியா
Ki	கி
Vatsa	வத்ஸா
Partner	பார்ட்னர்
Basabi	பர்ஸாபி
Nymox	நைமோக்ஸ்
Pharmaceutical	பார்மாசெட்டிக்கல்
Corporation	கார்ப்பரேஷன்
Raj	ராஜ்
Ratan	ராதன்
Fort	ஃப்போர்ட்
malden	மால்டென்
Shrimat	ஸ்ரீமத்
Kansas	கன்ஸாஸ்
Muntasir	முண்டாஸீர்
Durdanah	தர்தனா
Vishalgad	விஷல்காத்
Khudrah	குத்ரா
Bains	பைன்ஸ்
