Hajgiri	हजगिरी
Chekov	चेकॉव
Chettinad	चेत्तिनाद
Thomson	थॉम्सन
Hanumaan	हनुमान
Abhinetri	अभिनेत्री
Kamalesh	कमलेश
Roxy	रॉक्सी
Cadee	केडी
Madihah	मदिहाह
Ahlad	आह्लाद
Abhisok	अभिशोक
Aaditya	आदित्य
Savitashri	सवितश्री
Zapata	ज़पाटा
Bhanvarasinh	भंवरसिंह
Raahi	राही
Juaari	जुआरी
Ellenabad	इलेनाबाद
Meijer	मैज़र
Thayer	थायेर
Sekhwa	सेखवा
Azam	आज़म
Shakti	शक्ति
Goradhan	गोरधन
Chandresh	चंद्रेश
Duggirala	दुगिराला
Kanak	कनक
Paatekar	पाटेकर
Rebaba	रेबाबा
Shark	शार्क
Mesosphere	मीसोस्फीयर
Fuel-Tech	फ़्यूल-टेक
Ghanashyam	घनश्याम
Ambardekar	आंबर्डेकर
Ghaare	घारे
Asambhav	असंभव
Mevaaraam	मेवाराम
Divarath	दिवारथ
Guljar	गुल्जार
Rajendramohan	राजेंद्रमोहन
Sadanand	सदानन्द
Dhaulpur	धौलपुर
Nasrin	नसरीन
Zamana	ज़माना
Pakaraima	पाकाराइमा
Jatan	जतन
Gurjeet	गुरजीत
Elsass	एल्सास
Sevier	सेवियर
Crittenden	क्रिटेंडन
Belgium	बेल्जियम
Mahageet	महागीत
Shayla	शैला
Anuvaa	अनुवा
Maqil	मक़िल
Liona	लियोना
Banujah	बनुजाह
Basmah	बस्माह
Zander	ज़ैंडर
Pinquillo	पिंक्वीलो
Gahmar	गेहमर
Priyasha	प्रियशा
Teleri	टेलेरी
Malik	मलिक
Raffaello	रैफेलो
Broadwater	ब्रॉडवाटर
Niramay	निरामय
Amaanat	अमानत
Ichhita	इच्छिता
Vinodini	विनोदिनी
Amlai	अम्लाई
Debashish	देबाशीश
Kaushik	कौशिक
Somaanshu	सोमांशु
Nimish	निमिश
Quenacho	क्वेनाचो
Lokesh	लोकेश
Aabheer	आभीर
Hwange	हवांगे
Lysander	ल्यूसेंडर
Formidable	फोर्मिडेबल
Jody	जोडी
Kanhaiyalal	कन्हैयालाल
Keene	कीन
Khidki	खिड़की
Kuntee	कुंती
Keena	कीना
Yasmin	यास्मिन
Madhuchanda	मधुचन्दा
Jawad	जवाद
Jawan	जवान
Moskva	मोस्क्वा
Kaviraj	कविराज
Hionis	हॉयनिस
Bhilwara	भीलवाड़ा
Zandra	ज़ैंड्रा
Nagama	नगमा
Banani	बननी
Sudrashan	सुदर्शना
Tayyibah	तय्यिबाह
Banahi	बनाही
Bhagwanpura	भगवानपुरा
Pommern	पॉमर्न
Tarkas	तरकस
Harare	हरारे
Jerold	जेरॉल्ड
Seaborgium	सीबोर्जियम
Lalitkishore	ललितकिशोर
Sugateey	सुगतीय
Sabak	सबक
Hatyare	हत्यारे
Khemchand	खेमचंद
NALCO	नाल्को
Bayer	बायर
Badawi	बदावी
Devgam	देवगम
Hinge	हिंगे
Fhaninath	फणिनाथ
Edeline	एडलिन
Raghavendra	राघवेंद्र
Naatu	नातू
Chakob	चेकोब
Aakaasha	आकाश
Franc	फ़्रैंक
Larkin	लार्किन
Ryann	रियान
Vanamaataa	वनमाता
Anadyant	अनाद्यंत
Gujjar	गुज्जर
Bamba	बैंबा
Amarap	अमरप
Lawaaris	लावारिस
Fakhr	फख्र
Detective	डिटेक्टिव
Janoo	जानू
Anise	एनीज
BHEL	भेल
Nerys	नेरीस
Chunauti	चुनौती
Ghatprabha	घाटप्रभा
Shubhang	शुभांग
Thompson	थॉमसन
Ajey	अजेय
Krashnaa	कृष्णा
Saransh	सारांश
Elita	एलिटा
Azmat	अज़्मत
Julinka	जूलिन्का
Bates	बेट्स
Suwo	सूवो
Khubgaonkar	खुबगावकर
Prabhas	प्रभास
Nalayak	नालायक
Dhruv	ध्रुव
Indrakarman	इंद्रकर्मण
Shreemayi	श्रीमयी
Glacier	ग्लेशियर
Magdala	मग्दला
Sarfarosh	सरफरोश
Bhopatkar	भोपटकर
Bhadresh	भद्रेश
Annapurna	अन्नपूर्णा
Baqee	बकी
Bhemswadi	भेमस्वादी
Bezubaan	बेज़ुबान
Cornelia	कोर्नेलिया
Krishnakanta	कृष्णकांता
Katelynn	कैटलिन
Dundun	डुनडुन
Bland	ब्लांड
Sarojini	सरोजिनी
Adil-E-Jahangir	आदिल-ए-जहाँगीर
Sheep	शीप
Naunihaal	नौनिहाल
Saugat	सौगात
Nida	निदा
Afshan	अफ्शां
Suvarchalaa	सुवर्चला
Easter	ईस्टर
Sharanya	शरण्या
Rosina	रोज़ीना
Adil	अदिल
Natwar	नटवर
Kantele	कैनटिले
Butte	बट
Panchmahal	पंचमहल
Bhadrachalam	भद्राचलम
Kalelkar	कालेलकर
Vedic	वैदिक
Snow	स्नो
Shyaamalataa	श्यामलता
Keenan	कीनन
Lopamudra	लोपमुद्रा
Custer	कस्टर
Offenpest	ऑफेनपेस्ट
Caterpillar	केटरपिलर
Shiva	शिवा
Gamma	गामा
Fuller	फुलर
Hatya	हत्या
Bareerah	बरीरह
Madhuri	माधुरी
Abhiman	अभिमान
Dabholkar	दाभोलकर
Leighanna	लैग़ना
Sevaraam	सेवाराम
Balee	बाली
Sevaaraam	सेवाराम
Ainslie	ऐंस्ली
Ridhdhi	रिद्धि
Elata	इलेटा
Muqaddar	मुकद्दर
Proffitt	प्रोफिट
Jagat	जगत
Chizarira	चिज़ारिरा
Shag	शैग
Maghavaajit	मघवाजित
Chakra	चक्र
Fazalpur	फज़लपुर
Despina	डेस्पिना
Valdemar	वाल्देमर
Creighton	क्रेगटन
Jaldeep	जलदीप
Yaaminee	यामिनी
Galena	गेलेना
Marasi	मरासी
Narayani	नारायणी
Manusela	मानुसेला
Rutgers	रट्‍जर्स
Elisa	एलिसा
March	मार्च
Latona	लैटोना
Atulya	अतुल्य
Solferino	सोल्फेरिनो
Abhinanda	अभिनन्दा
Yelena	येलेना
Ganadhyaksha	गणाध्यक्ष
Safiyy	सफीय
Barabanki	बाराबंकी
Faunia	फॉनिया
Wayland	वेलैंड
Jamnagar	जामनगर
Somakaantaa	सोमकांता
Thurayya	थुरय्या
Thracian	थ्रासियन
Amalsad	अमलसद
Bhitiwala	भिटीवाला
Govindgarh	गोविंदगढ़
Gurbhagat	गुरभगत
Mashhud	मश्हुद
Azraaq	अज़राक
Alwaye	ऑल्वे
Divakar	दिवाकर
Nageenah	नगीना
Tabalah	तबालाह
El-marees	अल-मरीस
Maine	मेन
Jinelle	जिनेल
Wahidah	वहीदाह
Ganeshvar	गणेश्वर
Nanowalia	नानोवालिया
Kailashnath	कैलाशनाथ
Colton	कोल्टन
Mazloom	मज़लूम
Sankul	संकुल
Ullas	उल्लास
Audacious	ऑडाशियस
Ramavatar	रामावतर
Sadr	सद्र
Ethiopia	एथियोपिआ
Nurani	नुरानी
Balvindar	बलविंदर
Omaprakaash	ओमप्रकाश
Rachana	रचना
Jalangi	जलंगी
Lahi'ah	लहियाह
Bhandardara	भंडारदरा
Cerium	सीरियम
Isaura	इसौरा
Vishvaas	विश्वास
Belfast	बेलफास्ट
SaintGobain	सेंटगॉबैन
Tirukkottiyur	तिरुक्कोत्तियूर
Damascus	दमास्कस
Jabir	जबीर
Nayagarh	नयागढ़
Jovita	जोविता
Badel	बडेल
Baden	बाडेन
Naldurg	नलदुर्ग
Elroy	एलरॉय
Indianapolis	इंडियानापोलिस
Kolhatkar	कोल्हटकर
Vishven_dr	विश्वेन्द्र
Xaviera	ज़ेविएरा
Kafeel	कफील
Rakeeb	रकीब
Ramswaroop	रामस्वरूप
Aanandi	आनंदी
Deven_dr	देवेन्द्र
Shrinath	श्रीनाथ
Trini	ट्रीनी
Nitin	नितिन
Hanover	हैनोवर
Jahdamah	जहदमाह
Kaziranga	काज़ीरंगा
Janan	जैनन
Latangi	लतांगी
Nerina	नेरिना
Stavita	स्तविता
Dulcimer	डलसाइमर
Svaati	स्वाति
Vair	वैर
Forint	फ़ोरिंट
Guinivere	गुइनिवेर
Prajavani	प्रजावाणि
Valeria	वेलेरिया
Devahuti	देवाहुति
Puri	पुरी
Anaadyant	अनाद्यंत
Madani	मदनी
Vaable	वाबले
Prabhaa	प्रभा
Badriprasad	बद्रीप्रसाद
Achandaa	अचंदा
Dwarkaganj	द्वारकागंज
Sudi	सुदी
Sharda	शारदा
January	जैन्युअरी
Panduranga	पांडुरंग
Saujan_y	सौजन्य
Chirkey	चिरकी
Suri	सूरी
Naugaon	नौगाँव
Cendant	सेडेंट
Maanakalaal	माणकलाल
Manjaree	मंजरी
Awen	एवेन
Elburz	एल्बुर्ज़
Shree	श्री
Camila	कैमिला
Ladaaku	लड़ाकू
Dozakh	दोज़ख
Doug	डूग
Tajammul	ताजम्मुल
Loman	लोमैन
Sampat	सम्पत
Eliot	ईलियट
Donny	डोनी
Godhuli	गोधुली
Belwalkar	बेलवलकर
Longas	लॉन्गास
Swarnalata	स्वर्णलता
Kaler	कलेर
Shyaamakanth	श्यामकंठ
Ermina	एर्मिना
Shachi	शचि
Durgauti	दुर्गौती
Achanda	अचंदा
Maina	मैना
Savera	सवेरा
Datia	दतिया
Lohitaashv	लोहिताश्व
Sene	सेन
Murabbi	मुरब्बी
Irene	इरेने
Sirmilik	सिरमिलिक
Bhagavaan	भगवान
Tyrone	टायरॉन
Kawkab	कवकाब
Esme	एस्मी
Chawa	चावा
Sylvia	सिल्विया
Kamalaj	कमलज
Yashodha	यशोधा
Deepesh	दीपेश
Idalee	इडेली
Eldon	एल्डन
Khalidah	खलिदाह
Lankaapati	लंकापति
Shishiraant	शिशिरांत
Euro	युरो
Attala	अटाला
Xerxes	ज़ेरक्सेस
Geratpur	गेरतपुर
Dang	डंग
Cybille	सायबिल
Surasakhaa	सुरसखा
Kirkwood	कर्कवुड
Daag	दाग
Bainchi	बाइंची
Nadr	नद्र
Vadvekar	वडवेकर
Berhampur	बरहमपुर
Hollington	हॉलिंगटन
Jainism	जैनिज़्म
Baawri	बावरी
Gulabpura	गुलाबपुरा
Laconia	लेकोनिया
Chandana	चन्दना
Panna	पन्ना
Ghaso	घासो
Aathalekar	आठलेकर
Jania	जैनिया
Jahangir	जहाँगीर
Hinsdale	हिंस्डेल
Liyaakat	लियाकत
Vash	वश
Eolande	इओलैंड
Nixie	निक्सी
Dai'ei	दैई
Danish	दानिश
Aatank	आतंक
Sharad	शरद
Shatrumardan	शत्रुमर्दन
Selena	सेलेना
Lamisah	लैमिसाह
Veeravrat	वीरव्रत
Leann	लीन
Genero	जेनेरो
Sahani	साहनी
Everett	एवरेट
Bakr	बक्र
Elvin	एल्विन
Karate	कराटे
Badr	बद्र
Duddhinagar	दुधीनगर
Soory	सूर्य
Bihar	बिहार
Samarpan	समर्पण
Marilee	मैरिली
Nuri	नूरी
Osmium	ऑस्मियम
Murshida	मुर्शिदा
Angaraaj	अंगराज
Fariyaad	फरियाद
Elle	एलीन
Darritola	दरीतोला
Hilal	हिलाल
Jawani	जवानी
Diksha	दीक्षा
Salt	सल्त
Sant	संत
Mamaji	मामाजी
Chanpak	चंपक
Chitrani	चित्राणि
Chitrali	चित्राली
Tryna	ट्रायना
Cwen	स्वेन
Ummayyah	उम्मय्याह
Sanne	सैनी
Chakradharpur	चक्रधरपुर
Gautam	गौतम
Irfan	इरफान
Murti	मूर्ति
Kaanade	कानडे
Ghiyath	गियाथ
Liberace	लिब्रेस
Pooranasinh	पूरनसिंह
Chirai	चिरई
Ossie	ओसी
Kaveri	कावेरी
Chandolkar	चांदोरकर
Elsie	एल्सी
Xadrian	ज़ेड्रियन
Faizabad	फ़ैज़ाबाद
Athmah	अतमाह
Moonsilver	मूनसिल्वर
Rajendra	राजेंद्र
Hewlett - Packard	ह्यूलेट-पैकर्ड
Mela	मेला
Arlen	अर्लेन
Aachaarysuta	आचार्यसुता
Tristram	ट्रिस्ट्रम
Madhav	माधव
Gwyn	ग्वायन
Cerelia	सेरेलिया
Vibhooshan	विभूषण
Nene	नेने
Baalajee	बालाजी
Abhilasha	अभिलाषा
Stacie	स्टेसी
Muni	मुनि
Cottle	कॉटल
Mahatma	महात्मा
Dasna	दसना
Agathaa	अगाथा
Shair	शायर
Gavan	गैवान
Damia	डेमिया
Amoghaa	अमोघा
Vinod	विनोद
Rockford	रॉकफ़ोर्ड
Ashtyn	एश्टीन
Urshita	उर्शिता
Jennessa	जेनेसा
Kuaybah	कुयबाह
Dreama	ड्रीमा
Bihari	बिहारी
Nabhan	नभन
Badnapur	बदनापुर
Balraam	बलराम
Anandmayi	आनंदमयी
Bankebihaari	बांकेबिहारी
Forever	फॉरएवर
Umarah	उमराह
Bidar	बिदर
Aachaaryanandanaa	आचार्यनंदना
Horatio	होराशियो
Vritti	वृत्ति
Mckile	मैककिले
Tristana	त्रिस्तना
Fuji	फूजी
Thorium	थोरियम
Mercia	मेर्किया
Khusbakht	खुशबख्त
Vidor	विडोर
Rohtak	रोहतक
Ghaziyah	ग़ाज़ियाह
Florrie	फ्लोरी
Zola	ज़ोला
Democratie	डेमोक्रेटी
Zagiri	ज़ागीरी
Roseanne	रोज़ीन
Hyde	हाइड
Sonikaa	सोनिका
Majaal	मजाल
Verrill	वेरिल
Khaleeq	खली़क
Sanyukta	संयुक्ता
Pannagesh	पन्नागेश
Vivek	विवेक
Kusum	कुसुम
Hokkaido	हॉकाइडो
Aachaarynandan	आचार्यनंदन
Hiking	हाइकिंग
Favian	फैवियन
Bhatti	भट्टी
Grahan	ग्रहण
Matsendra	मत्सेंद्र
Stillman	स्टिलमैन
Wein	वेन
Sahir	साहिर
Mitra	मित्रा
Damnagar	दामनगर
Nirgude	निरगुडे़
Qamar	कमर
Aneesh	अनीश
Calista	कैलिस्ता
Mabel	मबेल
Dhoble	ढ़ोबले
Iren	इरेन
Rushil	रुशिल
Areeb	अरीब
Madhyamam	मध्यामम
Ameeri	अमीरी
Yasmina	यास्मिन
Luxor	लक्ज़र
Shaarangikaa	शारंगिका
Lel	लेल
Aadmi	आदमी
Cianna	सियाना
Heeraa	हीरा
Ervin	इर्विन
Bahira	बहिरा
Sharafat	शराफत
Eryk	एरिक
Padmavati	पद्मावती
Mufti	मुफ़्ती
Shuchita	शुचिता
Onex	ऑनेक्स
Luzon	लुज़ॉन
Harda	हरदा
Byadarahalli	ब्यादराहली
Lagos	लेगॉस
Hashid	हशीद
Lucas	लुकास
Tamburitza	तम्बुरिट्‍ज़ा
Gangrar	गंग़्रार
Indrajit	इंद्रजीत
Chandrabhan	चंद्रभान
Ambarish	अंबरीश
Jawharah	जवाहराह
Swatantra	स्वतंत्र
Lokmat	लोकमत
Rajeshwari	राजेश्वरी
Belrayan	बेलरेयान
Family	फ़ैमिली
Balajee	बालाजी
Jerry	जेरी
Dezso	देज़्सो
Baijayanthi	बैजयंती
Mirra	मिर्रा
Manjusha	मंजूषा
Ayyub	अय्यूब
Balsamand	बलसामंद
Lataa	लता
Vidhan	विधान
Gandhali	गांधाली
Girindra	गिरींद्र
Baghel	बघेल
Rasbihari	रासबिहारी
Adimoorti	आदिमूर्ति
Ratnamala	रत्नमाला
Lajja	लज्जा
Makhijani	माखीजानी
Isa	इसा
Jalendr	जलेंद्र
Nripinder	नृपिंदर
Pharmacology	फार्माकोलॉजी
Jalendu	जलेंदु
Austral	ऑस्ट्रल
Gillian	गिल्लिअन
Arunachal	अरुणाचल
Kaamanaa	कामना
Vaageeshaa	वागीशा
Puranik	पुराणिक
Sandhaar	संधार
Jogdand	जोगदंड
Arun	अरुण
Ghaniyah	ग़नियाह
Patjhad	पतझड़
Junayd	जुनैद
Jaisukh	जयसुख
Mudrika	मुद्रिका
Mufeed	मुफीद
Nikunj	निकुंज
Sasural	ससुराल
Adhiwar	अधिवर
Beckham	बेकहैम
Khayrah	खैराह
Balotra	बालोत्रा
Truda	ट्रूडा
Acaryatanaya	अकर्यतनया
Konkani	कोंकणी
Mujaffarnagar	मुज़फ़्फ़रनगर
Santan	संतान
Asranada	अस्रांदा
Kassia	कैसिया
Chitra	चित्रा
Roster	रोस्‍टर
Shabib	शबीब
Ashwatthama	अश्वत्थामा
Irma	इर्मा
Nagpal	नागपाल
Sihlsee	सिहल्सी
Muflih	मुफ़्लीह
Shyla	शाइला
Thirukkulunkunram	तिरुक्कलुन्कुंरम
Akbarganj	अकबरगंज
Parakram	पराक्रम
Oojam	ऊजाम
Jeanne	जीनी
Awaam	आवाम
Angoori	अंगूरी
Corine	कोरिन
Sharadini	शारदिनी
Deeptendu	दीप्तेंदु
Smriti	स्मृति
Shinano	शिनानो
Kan_haiyaalaal	कन्हैयालाल
Anuradhaa	अनुराधा
Chidaksh	चिदाक्ष
Amritash	अमृताश
Krishnamurthy	कृष्णमूर्ति
Lovers	लवर्स
Arulchelvan	अरुलचेलवन
Adolfo	एडोल्फो
Ballia	बालिया
Valletta	वेलिट्टा
Wimborn	विम्बॉर्न
Jota	जोटा
Harsingaar	हरसिंगार
Achaleshvara	अचलेश्वर
Lemhi	लेम्ही
Janani	जननी
Indrani	इंद्राणी
Burrows	बॉरोज
Manchester	मॅन्चेस्टर
Goonj	गूँज
Baalagopaal	बालगोपाल
Anju	अंजु
Jolie	जोली
Dwarka	द्वारका
Babboo	बब्बू
Jet-skiing	जेट-स्कीइंग
Tanuj	तनुज
Tunis	ट्यूनिस
Sajni	सजनी
Misal	मिसाल
Mukti	मुक्ति
Lopa	लोपा
Fitzwilliam	फिट्ज़विलियम
Bhanuprasad	भानुप्रसाद
Mushtaq	मुश्ताक़
Eyre	येरी
Sayid	सईद
Badshahnagar	बादशाहनगर
Anandi	आनंदी
Bishan	बिशन
Mutawassit	मुतावस्सित
Aahwaanit	आह्वानित
Pyaremohan	प्यारेमोहन
Duer	ड्यूएर
Pelagia	पेलागिया
Mahabalipuram	महाबलीपुरम
Lawrence	लॉरेंस
Apte	आप्टे
Khoj	खोज
Arya	आर्य
Mradaa	मृदा
Kudrat	कुदरत
Zahreelay	ज़हरीले
Meliora	मेलिओरा
Aria	एरिया
Galib	गालिब
Nalanda	नालन्दा
Ajamal	अजमल
Diella	डिएला
Eamon	ईमॉन
Urdu	उर्दू
Chandrika	चंद्रिका
Gorakh	गोरख
Aparajita	अपराजिता
Vidrumalataa	विद्रुमलता
Hud	हुद
Moroni	मोरोनी
Emanuele	इमानुएल
Aankhen	आँखें
Vishwendra	विश्वेंद्र
Dhavle	ढवले
Brinda	बृन्दा
Gauna	गौना
Laurentian	लॉरेन्शियन 
Shabanam	शबनम
Beohari	बेवहारी
Alwar	अलवर
Barfleur	बार्फ्लेयर
Erna	एर्ना
Erma	एर्मा
Apurvaa	अपूर्वा
Sevilla	सिविला
Raanchi	रांची
Kapila	कपिला
Modesty	मोडेस्टी
Centimos	सेंटीमोस
Chauncey	चांसी
Mahaabhuj	महाभुज
Grundy	ग्रंडी
Tirupati	तिरुपती
Centimes	सेंटाइम्स
Lut	लुत
Shyama	श्यामा
Wilkin	विल्किन
Darwin	डार्विन
Yateem	यतीम
Amriteshaya	अमृतेशय
Bellerophon	बेलरोफोन
Sudesh	सुदेश
Ghamand	घमंड
Juma'	जुमा
Centurion	सेंचूरियन
Wilmet	विल्मेट
Gora	गोरा
Ritu	ऋतु
Bewafa	बेवफ़ा
Barnett	बार्नेट
Vedagy	वेदज्ञ
Parvaiz	परवेज़
Gohpur	गोहपुर
Chunneelaal	चुन्नीलाल
Bansuri	बांसुरी
Anadyr	एनाडायर
Katak	कटक
Michelin	मिशेलिन
Wirt	वर्ट
Gullpur	गुल्लपूर
Britt	ब्रिट
Impero	इंपेरो
Jagran	जागरण
Sampreet	सम्प्रीत
Flores	फ्लोरस
Dalel	दलेल
Savannah	सवान्ना
Chandril	चंद्रिल
Hishaam	हिशाम
Balawali	बलावाली
Siddheshwari	सिद्धेश्वरी
Kaash	काश
Yashima	यशिमा
Millicent	मिलिसेंट
Dhanvant	धनवंत
Glide	ग्लाइड
Steven	स्टीवन
Playwin	प्लेविन
Abhijvalaa	अभिज्वाला
Phoebe	फोएबे
Pinjra	पिंजरा
Jacqui	जैकी
Devdharkar	देवधरकर
Hasan	हसन
Adhikar	अधिकार
Acharysutaa	आचार्यसुता
Sooraj	सूरज
Gyanda	ज्ञानदा
Abhayaprad	अभयप्रद
Tirupatisaram	तिरुपतीसराम
Tripta	तृप्ता
Raveesh	रवीश
Kashef	कशेफ
Manthan	मंथन
Akram	अकरम
Sawaal	सवाल
Ayyappan	अय्यप्पन
Kelkar	केलकर
Chelsia	चेल्सिया
Zizi	ज़िज़ी
Jeeval	जीवल
Vaasantee	वासंती
Glenys	ग्लेनिस
Tejaa	तेजा
Tejal	तेजल
Giorgio	ज्यार्जियो
Osmond	ओसमंड
Nebraska	नेब्रास्का
Bhadran	भद्रन
Jackie	जैकी
Dun	डन
Duf	डफ
Gourde	गौरडे
Lele	लेले
Darbar	दरबार
Muttee	मुत्ती
Abdus	अब्दुस
Guy	गाय
Afasanaa	अफसाना
Schlesien	स्लेसेन
Abdul	अब्दुल
Gus	गस
Shungare	शुंगारे
Kaheesha	कहीशा
Shekel	शेकेल
Players	प्लेयर्स
Pawaskar	पावसकर
Itochu	इतोचु
Sapna	सपना
Taysir	तैसिर
Abhisoka	अभिशोक
Irawati	इरावती
Maxima	मक्सिमा
Pryor	प्रयॉर
Sumitra	सुमित्रा
Vishaya	विषया
Hind	हिन्द
Edakkad	इदाक्क्ड़
Hirve	हिरवे
Riverside	रिवरसाइड
Jagmohan	जगमोहन
Sanjivan	संजीवन
Magnesium	मैग्निशियम
Randhawa	रंधावा
Louisa	लुइसा
Fa'atete	फाटेट
Muqabala	मुकाबला
Abhimand	अभिमन्द
Lynelle	लाइनेल
Jurrat	जुर्रत
Hekla	हेक्ला
Glora	ग्लोरा
Jaisudha	जयसुधा
Siberut	सिबेरुट
Hamdi	हम्दी
Jind	जींद
Mrinmayi	मृण्मयी
Niharika	निहारिका
Tanbur	तान्बूर
Sagami	सगामी
Jihan	जिहान
Abheer	अभीर
Thermopylae	थर्मोपाइली
Lu'lu	लु'लु
Utah	उटाह
Rajit	राजित
Subros	सुब्रोस
Satna	सतना
Triborough	त्रिबोरघ
Avian	एवियन
Kalsi	कलसी
Sidonie	सिडोनी
Sandhi	संधि
Bhairav	भैरव
Pinak	पिनाक
Swain	स्वैन
Mranaalinee	मृणालिनी
Jalandhar	जालंधर
Vijeti	विजेती
Husnaraa	हुस्नआरा
Hochteif	हॉचटिफ़ 
Balveer	बलवीर
Bennington	बेनिंग्टन
Mohiniatam	मोहिनीअट्टम
Snigdhaa	स्निग्धा
Malka-E-Noorjahan	मलका-ए-नूरजहाँ
Fatehgarh	फतेहगढ़
Spiro	स्पिरो
Ikshu	इक्षु
Jiyad	जियाद
Mursal	मुरसल
Zocha	ज़ोचा
Bihu	बीहू
Kesava	केसावा
Shreevabh	श्रीवल्लभ
Semuliki	सेम्युलिकी
Samrendru	समरेंदु
Kurde	कुरडे
Gajasya	गजस्या
Maurilio	मौरिलिओ
Ibtihal	इब्तिहल
Vivi	विवी
Prasham	प्राशम
Attunity	एट्टयूनिटी
Dwight	ड्वाइट
Humayrah	हुमयराह
Ramiz	रमीज़
Saatvik	सात्विक
Rocky	रॉकी
Ananyaa	अनन्या
Gevrai	गेवरई
Somkaantaa	सोमकांता
Exmoor	एक्समूर
Sanaubar	सनौबर
Amelie	एमेली
Pritikana	प्रीतिकाना
Fawzi	फावज़ी
Baalkrishna	बालकृष्ण
Rammohan	राममोहन
Kutumbe	कुटुंबे
Himaalay	हिमालय
Mahaashvetaa	महाश्वेता
Giverny	गिवेर्नी
Catrin	कैटरीन
Mahesh	महेश
Rajiyah	रजियाह
Girilal	गिरिलाल
Texas	टेक्सास
Kruger	क्रूगर
Faheemah	फहीमाह
Ekachitt	एकचित्त
Dholak	ढोलक
Akaar	आकार
Hizen	हाइज़न
Dhund	धुंद
Manjeet	मनजीत
Sindhi	सिंधी
Saket	साकेत
Nutan	नूतन
Cuica	क्युका
Jassi	जस्सी
Necia	नेकिया
Umika	उमिका
Shashiprabh	शशिप्रभ
Panavin	पनविन
Maryland	मेरीलैंड
Dipak	दीपक
Dabolim	दबोलिम
Pilani	पिलानी
Vachspati	वाचस्पति
Mekhalaadrijaa	मेखलाद्रिजा
Ayyoob	अय्यूब
Sanyasi	सन्यासी
Vishishat	विशिष्ट
Raine	रायने
Kashinath	काशीनाथ
Basra	बसरा
Hemaraj	हेमराज
Baudhdh	बौद्ध
Haytham	हैदम
Simone	सिमोन
Anjali	अंजलि
Foster	फॉस्टर
Avari	एवरी
Nagoya	नागोया
Samayapuram	समायापुरम
Pinaki	पिनाकी
Maalaa	माला
Bayonne	बायोने
Elamanur	इलामनूर
Muniya	मुनिया
Kabul	काबुल
Mallika	मल्लिका
Chhatwal	छटवाल
Nili	नीली
Girijaa	गिरिजा
Mahira	महिरा
Shu'a	शुआ
Mahika	महिका
Kusumlata	कुसुमलता
Neeladri	नीलाद्रि
Mohnish	मोहनीश
Maylin	मायलिन
Amoort	अमूर्त
Nanette	ननेटे
Paulina	पौलिना
Glenn	ग्लेंन
Arishtanemi	अरिष्टनेमि
Bundki	बंदकी
Kunjana	कुंजना
Bagalkot	बागलकोट
Aloysius	अलोयसियस
Harris	हैरीस
Foolan	फूलन
Sydney	सिडनी
Vajraabh	वज्राभ
Geordi	गेओर्डी
Shreekrashn	श्रीकृष्ण
Vaheedan	वहीदन
Faqih	फ़कीह
Cili	सीली
Angad	अंगद
Monisha	मोनिषा
Mahadane	महादाणे
Banthra	बंथरा
Millie	मिली
Kesoram	केज़ोरम
WiderThan	वाइडरदैन
Samraat	सम्राट
Gulbarga	गुलबर्गा
Paricutin	परिक्युटिन
Shimoga	शिमोगा
Bairagnia	बैरागनिया
Kampala	कंपाला
Antares	एंटेयर्स
Fahim	फहीम
Constitution	कंस्टीट्यूशन
Ukulele	युकुलेले
Finlay	फिनले
Sarajevo	सराजेवो
Sledding	स्लेडिंग
Deirdra	डैर्ड्रा
Nirdosh	निर्दोष
Dizi	डिज़ी
Phalke	फालके
Superb	सुपर्ब
Raani	रानी
Iskandar	इस्कन्दर
Raane	राणे
Bansi	बंसी
Chanpaa	चंपा
Khunays	खुनायस
Urdhvareshe	उर्ध्वरेशे
Rajani	रजनी
Walker	वॉकर
Swaha	स्वाहा
Cuthbert	कथबर्त
Kshanika	क्षणिका
Gizi	गिज़ी
Encana	एंकाना
Bamla	बमला
Akif	अकीफ
Gigi	गिगी
Ramuwalia	रामूवालिया
Neelmani	नीलमणि
Manmukhani	मनमुखानी
Fortune	फॉर्च्यून
Madanamohan	मदनमोहन
Badli	बदली
Fiji	फ़िजी
Digaru	दिगरु
Abhirup	अभिरूप
Fadil	फादिल
Nayantara	नयनतारा
Galen	गैलन
Champakali	चम्पकली
Allepi	अल्लेपी
Pierce	पियर्स
Bhinda	भिंडा
Antarctica	अंटार्टिका
Araafaat	अराफात
Yurupari	यूरूपरी
Pierre	पियरे
Thar	थार
Gupte	गुप्ते
Fakih	फकीह
Mridula	मृदुला
Khandani	खानदानी
Kamyab	कामयाब
Falna	फलना
Bagaha	बागाहा
Rasia	रेसिया
Murtaad	मुर्ताद
Manabhaavan	मनभावन
Afasara	अफसरा
Mukhtaar	मुख्तार
Seema	सीमा
Vafi	वाफी
Sushrut	सुश्रुत
Sarbajit	सरबजीत
Asuncion	एसुसिआन
Catriona	कैट्रीओना
Chihuahuan	चिहूआहूअन
Auyuittuq	औयुइक्ट
Pocono	पॉकॉनो
Lacrosse	लैक्रोस
Banwali	बनवाली
Suketu	सुकेतु
Chatrapur	छत्रपुर
Sheshashaayee	शेषशायी
Faysal	फैज़ल
Shyaam	श्याम
Ikraar	इकरार
Vanadevee	वनदेवी
Aglaia	एग्लेइया
Shapath	शपथ
Keely	कीली
Anuraag	अनुराग
Biniou	बिनिउ
Kameshwar	कामेश्वर
Rajnigandha	रजनीगंधा
Tirukkannankudi	तिरुक्कन्नानकुडी
Meadow	मीडो
Karlyn	कैर्लिन
Sooryapriyaa	सूर्यप्रिया
Yogeshvaree	योगेश्वरी
Sanghol	संघोल
Hani	हनी
Dudley	डुडली
Amuly	अमूल्य
Candida	कैंडिडा
Kavi	कवि
Bhangra	भाँगड़ा
Bharati	भारती
Archon	आर्कन
Matilde	मटिल्डे
Kargam	कर्गम
Quddusiyyah	कुद्दुसियाह
Shaheen	शाहीन
Ravij	रविज
Shaheed	शहीद
Dayita	दयिता
Andreas	आंद्रियास
Thallium	थैलियम
Ghosipura	घोसीपुरा
Vajhe	वझे
Brucklay	ब्रुक्ले
Mujaffarpur	मुज़फ़्फ़रपुर
Bhojpur	भोजपुर
Bangarapet	बंगरापेट
Atreya	अत्रेया
Wajihah	वजीहाह
Karah	कैराह
Chakrapani	चक्रपाणि
Juliet	जूलिएट
Asahi	असाही
Uranus	यूरेनस
Winifred	विनिफ्रेड
Zona	ज़ोना
Garcha	गरचा
Baare	बारे
Vilmos	विल्मोस
Vandan	वंदन
Mayoorashikhaa	मयूरशिखा
Chopan	चोपन
Burren	बरेन
Bajwa	बाजवा
Rupesh	रूपेश
Amalesh	अमलेश
Barasat	बारासात
Rajdrohi	राजद्रोही
Khurana	खुराना
Bridgestone	ब्रिजस्टोन
Ibrahim	इब्रहीम
Shikwa	शिकवा
Bhamini	भामिनी
Tarangire	तरांजिरे
Vivekaa	विवेका
Khawlah	खवलाह
Rochak	रोचक
Jahan aara	जहाँआरा
Dandiya	डांडिया
Mahavira	महावीर
Jaideep	जयदीप
Shekhar	शेखर
Guaracha	गुआराचा
Loharganj	लोहारगंज
Quintin	कुइंतिन
Jalsa	जलसा
Umeshwar	उमेश्वर
Altaaf	अल्ताफ
Kelli	केली
Arpana	अर्पणा
Budalur	बुदालुर
Sirsa	सिरसा
Sulwyn	सुल्विन
Hubaab	हुबाब
Mallah	मल्लाह
Dalila	डेलिला
Hoad	होड
Paresh	परेश
Amrit	अमृत
Agniprav	अग्निप्रव
Pavamaan	पवमान
Perdy	पर्डी
El-arabia	अल-अरेबिया
Kddi	कड्डी
Nivedita	निवेदिता
Ourra-tul-'ain	औरा-तुल-ऐन
Schwaben	स्वाबेन
Mauro	मौरो
Mriganayani	मृगनयनी
Cyprus	सायप्रस
Chawapall	चवापल
Fulki	फुलकी
Cher	चेर
Siyang	सियांग
Janelle	जैनेल
Mrinal	मृणाल
Babhnan	बाभनन
Soma	सोमा
Bahubali	बाहुबली
Chile	चिली
Sinai	सिनाई
Bhimashankar	भीमाशंकर
Ratnali	रत्नाली
Zafeerah	ज़फीराह
Damodar	दामोदर
Banner	बैनर
Edaline	एडलिन
Nawal	नवल
Chiplunkar	चिपलूणकर
Kaamna	कामना
Sulayk	सुलेक
Athabasca	अथाबास्का
Moscow	मॉस्को
Kroger	क्रोजेर
Mahijuba	महिजुबा
Anurodh	अनुरोध
Gautami	गौतमी
Kiyedh	कियेध
Ayushmaan	आयुष्मान
Amala	आमला
Kolthekar	कोलथेकर
Satyajit	सत्यजित
Samarth	समर्थ
Eunice	यूनिस
Sanjula	संजुला
Hotel	होटल
Ayodhyapati	अयोध्यापती
Bandhu	बंधु
Tosa	टोसा
Diphu	दिपु
Zeenat	ज़ीनत
GAIL	गेल
Sirohi	सिरोही
Hasmukh	हसमुख
Seemeen	सीमीन
BiJunctionor	बाइजंक्शनर
Fadi	फैदी
Bhabhar	भाभर
Questa	क्वेस्टा
Thyssenkrupp	थाइसेनकृप 
Barnagar	बारनगर
Pierrette	पिएरेटे
Netherlands	नीदरलैंड्‍स
Deepabali	दीपाबाली
Aarambh	आरंभ
Abaraar	अबरार
Aakaankshaa	आकांक्षा
Iali	इआली
Veerbhum	वीरभूम
Mukutadhar	मुकुटधर
Shahjehan	शाहजहाँ
Sampatti	सम्पत्ति
Simrit	सिमरित
Jaggi	जग्गी
Tanith	टेनिथ
Mitten	मिट्टन
Manager	मैनेजर
Satyanarayan	सत्यनारायण
Maputo	मेपटो
Raajakunvaree	राजकुंवरी
Bond	बॉन्ड
Clutterbuckganj	क्लटरबकगंज
Daurala	दौराला
Ghusun	ग़ुसन
Fateh	फतेह
Kota	कोटा
Tarulata	तरुलता
Pareeksha	परीक्षा
Aatik	आतिक
Conroy	कौनराय
Mawahib	मवाहिब
Junius	जूनियस
Ashirwad	आशीर्वाद
Troposphere	ट्रोपोस्फीयर
Bleach	ब्लीच
Mawaali	मवाली
Gwenllian	ग्वेनलियन
Penganga	पेनगंगा
Taaraa	तारा
Chelsea	चेल्सिया
Alamnagar	आलमनगर
Tiara	टियारा
Lovie	लोवी
Nongkrem	नॉन्गक्रेम
Pathak	पाठक
Baalachandra	बालचंद्र
Oberth	ऑबर्थ
Gold	गोल्ड
Parvarish	परवरिश
Fayruz	फैरुज़
Ratnaparkhi	रत्नपारखी
Tickner	टिक्नर
Hameed	हमीद
Amritkala	अमृतकला
Wellington	वेलिंग्टन
Supaul	सुपौल
Begham	बेग़म
Sahnewal	साहनेवाल
Simmons	सिमंस
Hindi	हिन्दी
Tommy	टॉमी
Omprakash	ओमप्रकाश
Indrayani	इंद्रायणी
Iffah	इफ्फह
Chittaswarup	चित्तस्वरूप
Ranjana	रंजना
Raghav	राघव
Nityagopal	नित्यगोपाल
Abhinath	अभिनाथ
Lokapaal	लोकपाल
Gajraj	गजराज
Vaaridhi	वारिधि
Nova	नोवा
Nadan	नादां
Ojas	ओजस
Brian	ब्रायन
Haboos	हबूस
Salila	सलिला
Nola	नोला
Yameen	यमीन
Volga	वोल्गा
Sareen	सरीन
Conner	कोनर
Karamgati	करमगति
Louie	लुई
Jogeeshvar	जोगीश्वर
Vasant	वसंत
Nayan	नयन
Nayak	नायक
Mamata	ममता
Rasikaa	रसिका
Aslana	अस्लाना
Kajwadkar	कजवाड़कर
Amartya	अमर्त्य
Azeemah	अज़ीमाह
Pramod	प्रमोद
Birambad	बिरामबाद
Cricketer	क्रिकेटर
Honeywell	हनीवेल
Angelica	एंजेलिका
Morocco	मोरक्को
Roffe	रॉफिल
Humber	हंबर
Nagar	नागर
Ardara	एर्डरा
Malli	मल्ली
Melvina	मेल्विना
Fakhtah	फख्ताह
Rafe	रैफ
Sabeeh	सबीह
Shelling	शैलिंग
Philomena	फिलोमेना
Bageshwar	वागेश्वर
Sitar	सितार
Mona	मोना
Callaway	कैलावे
Savage	सैवेज
Gadgil	गाडगिल
Nasia	नासिया
Bairaag	बैराग
Nasik	नासिक
Yadu	यदु
Dard-E-Dil	दर्द-ए-दिल
Mahaabodhi	महाबोधि
Chhabili	छबीली
Hawalat	हवालात
Pushkal	पुष्कल
Khalda	खालड़ा
Damurah	दमुराह
Ramdoot	रामदूत
Bighorn	बिगहॉर्न
Lawson	लॉसन
Skirrow	स्किरॉ
Najla	नजला
Arivalagan	अरिवलगन
Raghuraaee	रघुराई
Lowri	लोरी
Boliviano	बोलिवियानो
Freestone	फ्रीस्टोन
Mahaaraajaa	महाराजा
Bhagtanwala	भगतनवाला
Buddhdev	बुद्धदेव
Agra	आगरा
Sucharita	सुचरिता
Zahringen	ज़हरिंगन
Kiley	किले
Ally	एली
Gualtier	गॉल्टियर
Neelkanta	नीलकांता
Bhilai	भिलाई
Raunak	रौनक
Shatrughn	शत्रुघ्न
Bargadi	बरगाड़ी
Ratu	ऋतु
Aabid	आबिद
Cybill	सायबिल
Yamamah	यमामाह
Jaan-E-Wafa	जान-ए-वफा
Vinya	विनया
Aloarakh	अलौरख
Malhar	मल्हार
Naseer	नसीर
Aravankadu	अरावांकडु
Sundarbans	सुंदरबन्स
Aparnaa	अपर्णा
Connecticut	कनेक्टीकट
Prudence	प्रुडेंस
Bhagyaraj	भाग्यराज
Kate	केट
Dindori	डिण्डोरी
Edmund	एडमंड
Niagara	नायग्रा
Talib	तालिब
Gareth	गैरेथ
Sula	सुला
Mauna Loa	मौनालोआ
Siwar	सिवार
Siwan	सीवान
Camilla	कैमिला
Chate	चाटे
Janda	जांदा
Phyllis	फिलिस
Shailen_dr	शैलेन्द्र
Mahalakshmi	महालक्ष्मी
Ranade	रानाडे
Jeri	जेरी
Aarati	आरती
Mubin	मुबीन
Zakirah	ज़कीराह
Aasami	असमी
Elkhorn	एल्कहॉर्न
Chaitan	चैतन
Aitbaar	एतबार
Shalabh	शलभ
Minjonet	मिंजोनेट
Narayana	नारायण
Nutzotin	नुटज़ोटिन
Lapalikar	लपालीकर
Masada	मसाडा
Vasu	वसु
Manindra	मणिंद्र
Ratnajyouti	रत्नज्योति
Archanaa	अर्चना
Kathirah	कथिराह
Aadishvar	आदिश्वर
Akshay	अक्षय
Menard	मेनार्ड
Alice	एलिस
Koro	कोरो
Abhihit	अभिहित
Barrow	बैरॉ
Ilaaka	इलाका
Danniell	डेनियल
Nazih	नज़ीह
Sagina	सगीना
Fillmore	फिल्मोर
Jamshedpur	जमशेदपुर
Jogging	जॉगिंग
Lake	लेक
Shikhar	शिखर
Ameya	अमेय
Honey	हनी
Ray	रे
Maawi	मावी
Dayamayee	दयामयी
Bekrar	बेकरार
Butari	बुटारी
Akshaya	अक्षया
Ansar	अंसार
Pragun	प्रगुन
Gyaaniji	ज्ञानीजी
Indefatigable	इंडिफेटिजेबल
Antah	अंता
Mehboobnagar	महबूबनगर
Anilatmaj	अनिलात्मज
Ganapati	गणपति
Fattah	फतह
Jadu	जादू
Churk	चर्क
Tekla	टेक्ला
Verrazano-Narrows	वेराज़नो नॅरोज़
Manamaujee	मनमौजी
Svarnim	स्वर्णिम
Ferok	फेरोक
Pathanamthitta	पथानामथीट्‍टा
Daata	दाता
Balraaj	बलराज
Kalyani	कल्याणी
Tallis	टेलिस
Petronas	पेट्रोनस
Goa	गोवा
Pentasoft	पेंटासॉफ़्ट
Republique	रिपब्लिक
Akhila	अखिला
Nazeer	नज़ीर
Shabbeer	शब्बीर
Traci	ट्रेसी
Harvy	हार्वी
Mathura	मथुरा
Boxing	बॉक्सिंग
Yaagyik	याज्ञिक
Allemande	एलेमैंड
Ceri	सेरी
Halwani	हलवानी
Chitrarath	चित्ररथ
Pranav	प्रणव
Kirayedar	किराएदार
Anwar	अनवर
Dingwahi	दिंगवाही
Wrestling	रेस्लिंग
Badshah	बादशाह
Fahmida	फहमीदा
Choudhary	चौधरी
Bhalwan	भल्वान
Homer	होमर
Sunandini	सुनन्दिनी
Aradhana	आराधना
Myrilla	मायरिला
Kopargaonkar	कोपरगाँवकर
Ichha	इच्छा
Gallia	गैलिया
Pujit	पुजित
Bansilaal	बंसीलाल
Apache	अपैक
Dianne	डाएन
Wurttemburg	वूटेनबर्ग
Amarashree	अमराश्री
Kuvaleshay	कुवलेशय
Bissau	बिसौ
Dougal	डॉगल
Gotegaon	गोटेगांव
Puja	पूजा
Girik	गिरिक
Amaryllis	एमेरीलिस
Pahwa	पहवा
Dawood	दावूद
Cricket	क्रिकेट
Keelty	कील्टी
Kanchana	कंचना
Phiroza	फिरोज़ा
Rasheed	रशीद
Vaasavey	वासवेय
Chandrakin	चंद्रकिन
Karstadtquelle	कर्सटडक्वैले
Ghorpuri	घोरपुरी
Sonya	सोनिया
Washington	वॉशिंगटन
Ankai	अंकाई
Peetaabh	पीताभ
Jaclyn	जैकलिन
Satija	सतीजा
Balaaji	बालाजी
Ruma	रूमा
Paula	पौला
Raeanne	रेनी
Ferris	फेरिस
Punia	पूनिया
Bahu	बहू
Atman	आत्मन
Sudeep	सुदीप
Bandana	बन्दना
Peelaa	पीला
Haseena	हसीना
Bannerghatta	बानेरघटटा
Manmohan	मनमोहन
Mckesson	मैकेज़न
Zindagani	ज़िंदगानी
Dreadnought	ड्रेडनॉट
Manu	मनु
Magana	मगना
Oceana	ओशिएना
Koyel	कोयल
Emberlynn	एम्बरलीन
Jagadip	जगदिप
Rakesh	राकेश
Jajj	जज्ज
Mateenadaas	मतीनदास
Faustus	फॉस्टस
Sharaabi	शराबी
Dharmabad	धर्माबाद
Rahila	रहीला
Sudhaakar	सुधाकर
Glaxosmithkline	गलैक्सोस्मिथक्लाइन
Lethia	लेथिया
Hanifaah	हनीफाह
Nripesh	नृपेश
Akalmand	अकलमंद
Cura	क्युरा
Nao	नाव
Ellen	एलेन
Colum	कोलमैन
Bepanah	बेपनाह
Rijuta	ऋजुता
Ahamad	अहमद
Dujanah	दुजनाह
Rachna	रचना
Sheremetyevo	शेर्मटयेवो
Yusra	युस्रा
Mudra	मुद्रा
Kalindi	कालिन्दी
Alisha	अलिशा
Osaka	ओसाका
Anbar	अनबर
Akhtiyar	अख्तियार
Malaga	मलागा
Huma	हुमा
Madurai	मदुरै
Myron	मायरॉन
Bhagwanpur	भगवानपुर
Dauphin	डॉपिन
Dharamdeep	धरमदीप
Riyal	रियाल
Bhonsle	भोसले
Atmanand	आत्मानंद
Annigeri	अन्नीगेरी
Sparviero	स्पारविएरो
Dharmpal	धर्मपाल
Mahaavat	महावत
Muzzammil	मुज़्ज़म्मिल
Stu	स्टू
Ghunayn	गुनायन
Manana	मनना
Afsana	अफसाना
Ramesh	रमेश
Basbas	बसबस
Raamasakhaa	रामसखा
Cheri	चेरी
Alima	अलीमा
Vidya	विद्या
Balaghat	बालाघाट
Kaleem	कलीम
Eydie	ईदी
Advaakee	अद्‍वाकी
Alpha	अल्फा
Rajnandgaon	राजनन्दगाँव
Vishvaamitr	विश्वामित्र
Jouhikko	जोहिक्को
Lokadi	लोकादि
Dahshat	दहशत
Balj	बल्ज
Catskill	कैस्किल
Obalesh	ओबलेश
One-step	वन-स्टेप
Singla	सिंगला
Fuad	फॉड
Mandir	मंदिर
Coral	कोरल
Kayo	कायो
Chirag	चिराग
Saathe	साठे
Laboni	लबोनि
Howe	हॉवे
Grimes	ग्रिम्स
Nateeja	नतीजा
Musharraf	मुशर्रफ
Valerian	वेलेरियन
Suparnak	सुपर्णक
Prajit	प्रजित
Numa	नुमा
Poornayogee	पूर्णयोगी
Sall	सल्ल
Putli	पुतली
Dharmadas	धर्मदास
Aag	आग
Belsiri	बलसीरी
Preeti	प्रीति
Achinty	अचिंत्य
Hambada	हंबड़ा
Chhansara	छंसारा
Fatima	फातिमा
Mandla	मण्डला
Yogini	योगिनी
Hafsah	हफ्साह
Maltese	मैटलीज
Cuba	क्यूबा
Gadulka	गडुल्का
Damayanti	दमयंती
Bura	बूरा
Moira	मोइरा
Jerauld	जेरोल्ड
Jerrell	जेरेल
Nikunja	निकुंजा
Anurag	अनुराग
Farhanah	फरहानाह
Kishore	किशोर
Glorious	ग्लोरियस
Rawdah	रौदाह
Avarielle	एवरिएल
Tariq	तारि़क
Avariella	एवरीएला
Vengeance	वेंजिआंस
Metallophone	मेटैलोफोन
Vail	वाइल
Barkandi	बरकंदी
Celestine	सेलेस्टीन
Saranga	सारंग
Vilasini	विलासिनी
Raghubir	रघुबीर
Chandraleksha	चंद्रलेक्षा
Bhutto	भुट्टो
Ahlaadit	आह्लादित
Andralyn	एण्ड्रेलिन
Brahma	ब्रह्मा
Guma	गुमा
Madonna	मैडोना
Guna	गुना
Charitraheen	चरित्रहीन
Clarissa	क्लेरिसा
Laharen	लहरें
Zampona	ज़ैंपोना
Fausta	फॉस्टा
Wamil	वामिल
Gautamee	गौतमी
Murali	मुरली
Harachand	हरचंद
Shoesmith	शूस्मिथ
Sunayani	सुनयनी
Songadra	सोनगद्र
Bikram	बिक्रम
Yala	याला
Veerana	वीराना
Adair	अडायर
Morpheus	मॉर्फिअस
Megha	मेघा
Kail	कैल
Pearlie	पर्ली
Bhudev	भूदेव
Haimvat	हैमवत
Mackinac	मॅकिनॅक
Ita	ईटा
Nadee	नदी
Karmarkar	करमरकर
Manjubala	मंजुबाला
Atyachar	अत्याचार
Anwesha	अन्वेशा
Sana	साना
Wahid	वहीद
Sushamaa	सुषमा
Safa	सफा
Aadityakeshav	आदित्यकेशव
Asasia	असासिया
Narhari	नरहरि
Mushfiq	मुश्फीक़
Bahilpurwa	बाहिलपुरवा
Sawa	सावा
Aacharynandanaa	आचार्यनंदना
Kumudini	कुमुदिनी
Kanhere	कान्हेरे
Trey	ट्रे
Snowy	स्नोवी
Maulavee	मौलवी
Jadzia	जैडजिया
Farica	फैरिका
Wafadaar	वफ़ादार
Syngenta	सिन्जेंटा
Nairi	नैरी
Lilka	लिल्का
Jahanara	जहानारा
Sarala	सरला
Chata	चाता
Haryana	हरयाणा
Rangle	रैंगल
Amadhya	अमध्य
Gunther	गुंथर
Motocross	मोटोक्रॉस
Bambuca	बैंबूका
Taha	ताहा
Marlis	मार्लिस
Krishnamurari	कृष्णमुरारी
Goetze	गोएट्ज़
Darts	डार्ट्स
Winslow	विनस्लो
Gwalior	ग्वालियर
Meenar	मीनार
Prabuddha	प्रबुद्ध
Tara	टैरा
Maganalaal	मगनलाल
Paachpore	पाँचपोरे
Gopeekrashn	गोपीकृष्ण
Richa	ऋचा
Kaumajet	कोमाजेट
Thauban	थौबान
Ancon	एन्कन
Bijuri	बिजुरी
Dar Es Salaam	दार-ए-सलाम
Dakhineswar	दक्षिनेश्वर
Ajaibpur	अजायबपुर
Ghuzayyah	ग़ुज़य्याह
Tristan	ट्रिस्टन
Dubia	दुबिया
Izz	इज़्ज़
Charmaine	चर्मैने
Taranga	तरंग
Crystal	क्रिस्टल
Hemraj	हेमराज
Furqan	फु़र्कान
Kaustav	कौस्तव
Wajid	वाजिद
Shagird	शागिर्द
Shendaye	शेंडये
Chitrasen	चित्रसेन
Purkar	पूरकर
Shanna	शाना
Osman	उस्मान
Chamagram	चमाग्राम
Wedlock	वेडलॉक
Athiya	अथिया
Chittaprasad	चित्तप्रसाद
Boeing	बोईंग
Karvi	कार्वी
Avantika	अवंतिका
Niyati	नियति
Shamus	शमुस
Barlai	बरलाई
Shivadaan	शिवदान
Bharatmuni	भरतमुनि
Jett	जेट
Raitah	रैताह
Raajiv	राजीव
Verkhoyansk	वेर्खोयांस्क
Parivar	परिवार
Muraaree	मुरारी
Chodiala	चोडियाला
Iki	इकी
Sirius	सिरियस
Paramhansa	परमहंस
Surjewal	सुर्जेवाल
Donakonda	डोनाकोंडा
Appling	एप्लिंग
Kiglapait	किग्लापॅट
Bratindra	ब्रतिंद्र
Wendell	वेंडेल
Laddie	लैडी
Lita	लीटा
Tamilnadu	तमिलनाडू
Tungsten	टंगस्टन
Yudhisthir	युधिष्ठिर
Virgniaud	वर्जिनिऑड
Melva	मेल्वा
Shambhavi	शाम्भवि
Saladin	सलादिन
Yuvati	युवती
Nirvan	निर्वाण
Tamee	तमी
Party	पार्टी
Harindar	हरिन्दर
Salwa	सल्वा
Eta	एटा
Shandaar	शानदार
Darrin	डैरिन
Dahana	दहना
Parth	पार्थ
Manimekhala	मणिमेखला
Walmiki	वाल्मीकि
Khazanchi	खज़ानची
Drake	ड्रैको
Irrisistible	इर्रेरिस्टेबल
Abazila	अबाजिला
Gayatri	गायत्री
Robyn	रॉबिन
Bajva	बाजवा
Husam	हुसम
Golf	गोल्फ
Tucker	टकर
Napa	नैपा
Raichur	रायचूर
Mahasweta	महाश्वेता
Mhatre	म्हात्रे
Patty	पैटी
Prokofiev	प्रोकोफीव
Kavthekar	कवठेकर
Gumla	गुमला
Magoffin	मैगोफिन
Chitrakoot	चित्रकूट
Matlabi	मतलबी
Haragyaan	हरज्ञान
Parama	परमा
Colon	कॉलन
Ikrimah	इकरीमाह
Rianne	रियान्नी
Una	यूना
Sulekha	सुलेखा
Tushaar	तुषार
Progeon	प्रोज़ेन
Cira	सीरा
Farragut	फैरागट
Rais	रईस
Parvatinandan	पार्वतीनन्दन
Nasoor	नासूर
Shad	शाद
Betelsmann	बेटल्समन
Talibah	तालीबाह
Calum	कैलम
Potdar	पोतदार
Fallon	फैलन
Milun	मिलन
Cara	कारा
Solana	सोलेना
Turkana	टुर्काना
Saarth	सार्थ
Dhaura	धौरा
Alba	अल्बा
Alda	एल्दा
Sainath	साईनाथ
Bent	बेंट
Krashnapingaakshan	कृष्णपिंगाक्षं
Ona	ओना
Bata	बाटा
Tacey	टेसी
Nalvadi	नलवाडी
Pawana	पवाना
Gulnar	गुलनार
Abhiraam	अभिराम
Medzhybizh	मेझ्ही‍बिज़
Chittaranjan	चित्तरंजन
Krataaraam	कृताराम
Hindvee	हिंदवी
Volkhovskaya	वोल्खवस्काया
Mala	माला
Taber	ताबेर
Maha	महा
Actress	एक्ट्रेस
Analiese	एनालीज
Shridevi	श्रीदेवी
Daya	दया
North	नॉर्थ
Anitaa	अनिता
Rangoon	रंगून
Raipur	रायपुर
Dada	दादा
Alimaa	अलीमा
Makkhan	मक्खन
Pallav	पल्लव
Melina	मेलिना
Ranajay	रणजय
Sahaja	सहजा
Oslo	ऑस्लो
Bhargava	भार्गव
Anjaan	अंजान
Tregrosse	ट्रेंग्रोसी
Elda	एल्डा
Kailash	कैलाश
Mangalagiri	मंगलगिरी
Philpot	फिल्पोट
Mahamaya	महामाया
Sprague	स्प्रेगुए
Gharana	घराना
Chaman	चमन
Surabhi	सुरभि
Cyclewali	सायकलवाली
Gerald	गेराल्ड
Ghughuli	घुघुली
Aada	आडा
Buzdil	बुज़दिल
Richmond	रिचमंड
Sandhu	संधू
Pujari	पुजारी
Gerard	गेरार्ड
Somdev	सोमदेव
Clive	क्लाइव
Roland	रोलैंड
Bolarum	बोलारम
Jasapaal	जसपाल
Melba	मेल्बा
Ratnangi	रत्नांगी
Beqasoor	बेकसूर
Nagavahan	नगवाहन
Hayagreeva	हयाग्रीव
Chaggan	छगन
Mutasim	मुतासिम
Francois	फ्रेंकोइस
Damaad	दामाद
Vipra	विप्र
Aditynandan	आदित्यनंदन
Flugelhorn	फ्लजेलहॉर्न
Beawar	ब्यावर
Adwaakee	अद्‍वाकी
Subhaashachandr	सुभाषचंद्र
Parolkar	पारोलकर
Aagale	आगले
Angaara	अंगारा
Samara	सामरा
Eisa	ईज़ा
Qareeb	क़रीब
Kartikeya	कर्तिकेय
Kathy	कैथी
Mahindra	महिंद्र
Eara	ईरा
Vishwas	विश्वास
Mahadev	महादेव
Akora	अकोरा
Dhadvaiwale	धडवईवाले
Minhas	मिनहास
Sudipti	सुदीप्ति
Manaavee	मनावी
Sudipta	सुदीप्ता
Ana	एना
Abhimani	अभिमणि
Bottineau	बॉटिन्यू
Barsola	बरसोला
Lakde	लकडे
Wayne	वेन
Dobry	डॉबरी
Bhupinderpal	भूपिंदरपाल
Baxur	बक्सर
Chordophone	कॉरडोफोन
Ecuador	इक्वेडोर
Bahuroop	बहुरूप
Christianity	क्रिश्चियानिटी
Sarra	सारा
Barmer	बारमेर
Gaurish	गौरीश
Newstime	न्यूजटाइम
Vishram	विश्राम
Nuncio	नुंकिओ
Panchkula	पंचकुला
Landler	लैंडर
Balawala	बलावाला
Jabalah	जबालेह
Lynette	लिनेट
Hukumachan_d	हुकुमचन्द
Kuber	कुबेर
Fakeehah	फकीहाह
Tilak	तिलक
Truly	ट्रूली
Brahamdev	ब्रह्मदेव
Ovid	ओविड
Mimis	मिमिस
Malvarkar	मालवरकर
Sophie	सोफी
Leelamayee	लीलमयी
Dewey	डेवे
Girish	गिरीश
Tilottama	तिलोत्तमा
Mahananda	महानंदा
Gidarpindi	गिडरपिंडी
Tuteja	टुटेजा
Argheshwar	अर्घेश्वर
Bhajaraam	भजराम
Ungava	उगावा
Xander	ज़ेंडर
Samran	सामरन
Keshini	केशिणी
Aahlad	आह्लाद
Velankar	वेलणकर
Auzaar	औज़ार
Hammaam	हमाम
Sailing	सेलिंग
Pahu	पाहु
Amriteshvar	अमृतेश्वर
Saumarez	सौमारेज़
Malamkar	मलमकर
Wartsila	वर्टसिला
Adawi	अदावि
Mukand	मुकुंद
Trish	त्रिश
Mihir	मिहिर
Chandranath	चंद्रनाथ
Gazala	गज़ाला
Dhirendra	धीरेंद्र
Kalbi	कल्बि
Ossama	ओसामा
Tulika	तूलिका
Furious	फ्यूरियस
Grishma	ग्रीष्म
Baramua	बारामुआ
Katyayani	कात्यायनी
Agnee	अग्नि
Viresh	विरेश
Ramprasad	रामप्रसाद
Leala	लीला
Girgala	गिरगाला
Abhijat	आभिजात
Octavio	ओक्टाविओ
Seetaasaran	सीतासरन
Chakori	चकोरी
Dharwar	धरवार
Nocil	नॉसिल
Gokhle	गोखले
Pethe	पेठे
Mirzapur	मिर्ज़ापुर
Wratten	रैटन
Kalimantan	कलीमांटन
Arivumadhi	अरिवुमधि
Fineen	फिनीन
Nandurkar	नांदरुकर
Darius	डैरियस
Odelia	ओडेलिआ
Fabienne	फैबिएन
Sadeepan	सदीपन
Viklaant	विक्लांत
Valmai	वल्माई
Boston	बोस्टन
Cajon	कैजन
Namoona	नमूना
Seychelles	सेशेल्स
Khagadia	खगडिया
Pathyaa	पथ्या
Lorena	लोरेना
Qaylah	कयलाह
Arariya	अरारिया
Tawaif	तवायफ
Narapat	नरपत
Anantapur	अन्नतपुर
Rhonda	रोंडा
Cordoba	कॉरडोबा
Inderdeep	इन्दरदीप
Devendra	देवेंद्र
Safwah	सफ्वाह
Kajjali	कज्जलि
Raadheshyaam	राधेश्याम
Italia	इटालिया
Abhinav	अभिनव
Carla	कार्ला
Winfred	विनफ्रेड
Amravati	अमरावती
Weymouth	वेमाउथ
Mariel	मैरिएल
Raamalaal	रामलाल
Kausar	कौसर
Kalka	काल्का
Bhatkhede	भातखंडे
Chaukhandi	चौखंडी
Mahbub	महबूब
Lanbodar	लंबोदर
Fern	फर्न
Sadyojat	सद्योजात
Shachee	शची
Gangakher	गंगाखेर
Zoraster	ज़ोरास्टर
Inayat	इनायत
Begusarai	बेगूसराय
Leatrix	लीट्रिक्स
Atre	अत्रे
Parmameshwar	परमेश्वरि
Deergharaagaa	दीर्घरागा
Barua	बरुआ
Hampton	हैंप्टन
Canoe	कैनो
Abhayaa	अभया
Milonga	मिलोंगा
Maikhana	मैखाना
Garwah	गढ़वा
Prerna	प्रेरणा
Carnig	कार्निग
Vafia	वाफिया
Vishala	विशाला
Linore	लिनोर
Leila	लीला
Chitadhan	चितधन
Kanchanaa	कंचना
Dhanashri	धनश्री
Narendra	नरेंद्र
Danwar	डनवार
Eithne	एथन
Paraguay	पराग्वे
Marengo	मैरेंगो
Buxar	बक्सर
Johannesburg	जोहांसबर्ग
Shart	शर्त
Chakshu	चक्षु
Powerful	पावरफुल
Uzayr	उज़ैर
Tridev	त्रिदेव
Anandee	आनंदी
Maeve	मएवे
Khimsar	खिमसार
Sabiqah	सबि़काह
Rotterdam	रोटर्डम
Alastair	अलस्टेयर
Sambhddha	संबद्ध
Akhil	अखिल
Dixmude	डिक्सम्यूड
Adonis	एडोनिस
Aligarh	अलीगढ़
Dagmagpur	डगमगपुर
Nishani	निशानी
Shrikrishna	श्रीकृष्ण
Warnix	वॉरनिक्स
Arumugan	अरुमुगन
Padmalochana	पद्मलोचना
Vaaman	वामन
Gursimrah	गुरसिमराह
Treva	ट्रेवा
Natasha	नताशा
Lagan	लगन
Sachetan	सचेतन
Garron	गैरन
Axel	एक्सेल
Applebee	एपलबी
Neelambar	नीलाम्बर
Bahjoi	बहजोई
Safeenah	सफीनाह
Hainich	हाइंनीच
Sonipat	सोनीपत
Talika	तालिका
Shaw	शॉ
Malini	मालिनी
Arijit	अरिजित
Chinchpada	चिंचपाड़ा
Afasaanaa	अफसाना
Aafiya	आफिया
Almanij	अल्मनिज
Sangram	संग्राम
Waheed	वहीद
I^jeeniyar	इंजीनियर
Hussain	हुसैन
Gajavaan	गजवान
Gaddar	गद्दार
Vidler	विडलर
Bishakha	बिशाखा
Lepanto	लेपैंटो
Tayade	तायडे
Sarama	सरमा
Raikoti	रायकोटी
Adidas	एडीडास
Sarada	सारदा
Acharyasutaa	आचार्यसुता
Onkarpreet	ओंकारप्रीत
Golmaal	गोलमाल
Haneef	हनीफ
Bakkir	बकीर
Eyab	एयब
Laladu	लालड़ू
Pravesh	प्रवेश
Taseen	तसीन
Urvi	उर्वि
Simeon	सिमेओन
Sonalee	सोनाली
Tahina	टहिणा
Avanish	अवनीश
Fatinah	फतिनाह
Delphi	डेल्फ़ी
Muqaddas	मुक़द्‍दस
Khayyat	खय्यात
Manobhu	मनोभु
Dallaway	डैलावे
Kanoun	कैनाउन
Pitambar	पिताम्बर
Bhunch	भुंच
Nishan-E-Jung	निशान-ए-जंग
Shahjahanpur	शाहजहाँपुर
Vanani	वनानी
Banamala	बनमाला
Lottery	लॉटरी
Durdanah	दर्दनाह
Agatha	अगाथा
Edith	एडिथ
Malikaa	मलिका
Uwayam	उवायाम
Chip	चिप
Tictoria	तिकतोरिया
Chhinda	छिंदा
Viyogee	वियोगी
Kinshuk	किंशुक
Umaymah	उमैमाह
Uranium	यूरेनियम
Ekadant	एकदंत
Tambora	तम्बोरा
Arwen	अर्वेन
Devinderpal	देविंदरपाल
Helium	हीलियम
Aashiqui	आशिकी
Utaybah	उतैबाह
Buraj	बुरज
Alicia	एलीसिया
Zunheboto	जुन्हेबोटो
Susheet	सुशीत
Angarika	अंगारिका
Richtersveld	रिचस्ट्रेसवेल्ड
Chaand	चान्द
Natraj	नटराज
Chhapi	छपी
Bokaro	बोकारो
Hajeeb	हजीब
Vanaja	वनजा
Nimat	निमत
Ketan	केतन
Uhban	उहबन
Chhabi	छबि
Horeshoes	हॉरशूज़
Lanzarote	लेंज़रोट
Jashn	जश्न
Kasungu	कासुंग्यु
Cerise	सेरीस
Jagdamba	जगदंबा
Matondkar	मातोंडकर
Yashogaan	यशोगान
Baalagopal	बालगोपाल
Panini	पाणिनी
Bhawani	भवानी
Tirap	तिरप
Chitali	चिताली
Ukkusiksalik	उक्कुसिक्सालिक
Lesley	लेस्ली
Enakshi	ईनाक्षी
Hashim	हाशिम
Rajmukut	राजमुकुट
Gaylord	गेलॉर्ड
Dharma	धर्मा
Farrah	फराह
Yojana	योजना
Keral	केरल
Carr	कार
Kushinagar	कुशीनगर
Cents	सेंट्स
Aatikah	आतिकाह
Chamraura	चमरौरा
Kesar	केसर
Frankfurt	फ़्रंकफ़र्ट
Getey	गेटे
Sabyasachi	सब्यसाची
Terentia	टेरेंटिया
Deedar	दीदार
Ajgain	अज्गेन
Bakhtiar	बख्तियार
Mellette	मेलेट
Mu'awwiz	मुआव्विज़
Merle	मेर्ले
Glenna	ग्लेंना
Lindormen	लिंडरमेन
Ayyar	अय्यर
Rasaraj	रसराज
Khalis	खलीस
Kahma	काह्मा
Massimo	मस्सिमो
Lenci	लेंसी
Maricopa	मेरीकोपा
Sissy	सिज़ी
Boron	बोरोन
Shokhiyan	शोखियाँ
Jacques	जैकस
Shyaamataa	श्यामता
Early	अर्ली
Warsaw	वारसो
Thetis	थेटिस
Dilber	दिलबर
Pingalia	पिंगलिया
Fiorenza	फियोरेंज़ा
Manibandh	मणिबंध
Tamhankar	ताम्हनकर
Begunah	बेगुनाह
Vetaal	वेताल
Usman	उस्मान
Wapusk	वापुस्क
Demetria	डेमिट्रिया
Amur	आमूर
Raajakumaaree	राजकुमारी
Subrata	सुब्रता
Usayd	उसैद
Grady	ग्रेडी
Ethanael	एथनील
Vishnugua	विष्णुगुप्त
Jayant	जयंत
Nationawide	नेशनवाइड
Hothi	होठी
Sourabh	सौरभ
Doraha	दोराहा
Snigdha	स्निग्धा
Valentino	वैलेंटिनो
Shurayh	शुरायह
Tonya	टोन्या
Premendra	प्रमेंद्र
Ihina	इहिना
Mastek	मैस्टेक
Betwa	बेतवा
Devinder	देविंदर
Saptakoteshwar	सप्तकोटिश्वर
Abjinipati	अब्जिनिपति
Kaithal	कैथल
Shabari	शबरी
Asavaree	असावरी
Sarasvat	सारस्वत
Adinaaraayan	आदिनारायण
Romanzof	रोमनज़ोफ़
Calantha	कैलेंथा
Masud	मसूद
Colossus	कॉलॉसस
Khadilkar	खाडिलकर
Faustine	फॉस्टीन
Dongargaon	डोंगरगांव
Fakhrun nisa	फखरुन्निसा
Giri	गिरि
Ankleshwar	अंकलेश्वर
Rudra	रुद्र
Baion	बायोन
Deutschland	डेटस्कलैंड
Ramayana	रामायण
Satyakam	सत्यकाम
Amarkaant	अमरकांत
Shea	शीया
Lowes	लॉव्ज़
Gulati	गुलाटी
Brooklyn	ब्रुकले
Farhat	फरहत
Kuntaa	कुंता
Ghauth	गौथ
Prapitameshwar	प्रपितामेश्वर
Badreenaath	बद्रीनाथ
Gulami	गुलामी
Muriel	म्युरिएल
Ashiana	आशियाना
Vihuela	विहुएला
Vaparaiso Church of Christ	व्हापरासिओ
Shuchismita	शुचिस्मिता
Stan	स्टैन
Sukanya	सुकन्या
Jordan	जॉर्डन
Yolanda	योलान्डा
Heriot	हेरोइट
Phosphorus	फॉस्फोरस
Vijender	विजेंदर
Zaida	ज़ैदा
Hamburg	हैमबर्ग
Saipratap	साईप्रताप
Dionne	डियोन
Sharmila	शर्मिला
Baaqir	बाकिर
Tavita	टेविटा
Baranof	बैरनऑफ
Aachaaryanandan	आचार्यनंदन
Dhandhuka	धंधुका
Shagufa	शगुफा
Chaz	चैज़
Jagarau	जगराउ
Davendra	देवेंद्र
Olesia	ओलेसिया
Kynthia	कायंथिया
Schoenfeld	स्कोहेनेफेल्ड
Shaheenah	शाहीनाह
Anatole	अनातोली
Tanganyika	टांगानाइका
Chhapra	छपरा
Parminder	परमिंदर
Sa'ood	सऊद
Sawwaf	सव्वाफ
Kaga	कागा
Umayyah	उमय्याह
Cargill	कारजिल
Sule	सुले
Induja	इन्दुजा
Odissi	ओडिसी
Kathajuri	काठजुरी
Binnaguri	बिनागुरी
Caressa	कैरेसा
Caresse	कैरेसी
Mayur	मयूर
Baruva	बरुवा
Akalmash	अकल्मश
Rekhi	रेखी
Roti	रोटी
Sohota	सोहोटा
Bahadurgarh	बहादुरगढ़
Nasrudin	नसरूद्दीन
Shinjini	शिंजिनी
Pretvam	प्रीतवम
Shashee	शशी
Roshanalaal	रोशनलाल
Ambikaa	अंबिका
Sapphire	सैफायर
Satyawan	सत्यवान
Prajaapat	प्रजापत
Anaparti	अनापर्ती
Theodora	थियोडोरा
Isma'il	इस्मा'ईल
Ismah	इस्माह
Nayyab	नय्यब
Ova	ओवा
Balharshah	बल्हारशाह
Aideen	ऐदीन
Tori	टोरी
Phil	फिल
Nestor	नेस्टर
Gandhik	गणधिक
Damini	दामिनी
Lakkad	लक्कड
Chhatre	छत्रे
Bhadbhoke	भाडभोके
Althea	एल्थिया
Gustavo	गुस्तावो
Dhamija	धामीजा
Gangabhrit	गंगाभृत
Tanpura	तानपुरा
Basar	बसर
Lankeshvar	लंकेश्वर
Shyamangi	श्यामांगी
Khafid	खाफिद
Chetan	चेतन
Narang	नारंग
Olivia	ओलिविया
Barad	बराड़
Weddell	वेडेल
Aragon	एरागन
Yagy	यज्ञ
Wendy	वेंडी
Taravindar	तरविंदर
Genica	जेनिका
Arsenic	आर्सेनिक
Russell	रसेल
Chandralekha	चंद्रलेखा
Colorado	कोलोरॅडो
Hailakandi	हलाकांडी
Istabraq	इस्तबराक
Shisham	शीशम
Godse	गोडसे
Centrica	सेन्ट्रिका
Chinchli	चिंचली
Diane	डाएन
Wadech	वदेच
Aseem	असीम
Aatiqah	आतिकाह
Bahar	बहार
Pyrenees	पायरेनीस
Akashi-Kaikyo	अक्शी-कायक्यो
Hersey	हार्से
Shaswati	शस्वती
Lincoln	लिंकोलन
Ghugi	घुगी
Tarakeshwar	तारकेश्वर
Khirash	खिराश
Rosamund	रोसमन्ड
Utsa	उत्सा
Zaynab	ज़ैनब
Merch	मर्क 
Aatirah	आतिराह
Prometheus	प्रोमिथेउस
Dachigam	दाचीगम
Achaleswara	अचलेश्वर
Wallace	वैलेस
Caia	केया
Sidhdhi	सिद्धि
Chiranjeev	चिरंजीव
Nirmal	निर्मल
Cala	कैला
Faizullapur	फैज़ुलापुर
Heeraalaal	हीरालाल
Chirantan	चिरंतन
Badree	बद्री
Jodi	जोडी
Ajanta	अजंता
Toshiba	तोशिबा
Krodhi	क्रोधी
Colong	कोलाँग
Tanseem	तंज़ीम
Griffiths	ग्रिफिथ्स
Shaadaab	शादाब
Carlisle	कार्लिसल
Sayyar	सय्यार
Nigeria	नीजर
Bahaudeen	बहाउद्दीन
Deepit	दीपित
Saudamini	सौदामिनी
Suhrewardi	सुहरेवर्दी
Wipro	विप्रो
Salikah	सलीकाह
Ambodala	अम्बोडाला
Darsh	दर्श
Microbiology	माइक्रोबायोलॉजी
Modak	मोडक
Chiraag	चिराग
Lilly	लिली
Durgapur	दुर्गापुर
Hussum	हस्सम
Salihah	सलीहाह
Dana	दाना
Bhaaratee	भारती
Mainaa	मैना
Pratidin	प्रत‍िद‍िन
Bhanapur	भानापुर
Sailesh	सैलेश
Swasti	स्वस्ति
Navneet	नवनीत
Gaya	गया
Daulat	दौलत
Princess	प्रिंसेस
Aaminah	आमिनाह
Rozalia	रोज़ालिया
Bijoor	बिजूर
Simran	सिमरन
Elkhart	एल्कहार्ट
Reghe	रेगे
Aishbagh	ऐशबाग
Bagbahra	बागबहरा
Prasannjit	प्रसन्नजित
Maanasee	मानसी
Alakaa	अलका
Pandher	पंढ़ेर
Dasha	डैश
Quilla	क्विला
Acharysuta	आचार्यसुता
Zelig	ज़ेलिग
Jahdari	जहदारी
Kelimutu	केलीमुटु
Zensar	ज़ेन्सार
Shobhita	शोभिता
Darwaza	दरवाज़ा
Sysco	सिस्को
Katy	कैटी
Vyakhya	व्याख्या
Mahum	महुम
Shikishima	शिकीशिमा
Kacy	केसी
Ajmer	अजमेर
Mahua	महुआ
Dhara	धरा
Jadugar	जादुगर
Dumbra	डम्बरा
Donal	डोनल
Smith	स्मिथ
Kudmai	कुड़मई
Dharampuri	धरमपुरी
Autonaiton	ऑटोनेशन
Analaa	अनला
Bhavnagar	भावनगर
Meriwether	मेरिवेदर
Vilas	विलास
Mustafeed	मुस्तफीद
Banan	बनन
Yukon	यूकॉन
Kejimkujik	केज़ीमकुज़ीक
Shweta	श्वेता
London	लंदन
Jaandaar	जानदार
Panihari	पनिहारी
Neodymium	नीयोडिमियम
Effingham	एफिंघम
Kasib	कासिब
Senapati	सेनापति
Banyan	बॅनयान
Doli	डोली
Bommidi	बॉम्मिदी
Rustam	रुस्तम
Guinevere	गुइनवेर
Khilona	खिलौना
Sharp	शार्प
Terrence	टेरेंस
McCann	मैककेन
Gogi	गोगी
Kamble	कांबले
Gobi	गोबी
Jayadeep	जयदीप
Bexar	बेक्सार
Faryadi	फरियादी
Tony	टोनी
Paum	पौम
Rossa	रोसा
Naarlekar	नार्लेकर
Amanaath	अमानाथ
Amay	अमय
Berhampore	बरहमपोर
Ashwin	अश्विन
Bhaanoo	भानू
Girna	गिर्ना
French	फ्रेंच
Khanjar	खंजर
Vaaknis	वाकनीस
Ghuri	घूरी
Kavishwar	कवीश्वर
Ramnath	रामनाथ
Guarani	गुरानी
Babarpur	बाबरपुर
Mahashweta	महाश्वेता
Newfoundland	न्यू फाउंडलैंड
Mauritania	मॉरितानिया
Mohak	मोहक
Taybah	तय्यबाह
Shivsagar	शिवसागर
Humsafar	हमसफर
Ununbium	यूननबियम
Shery	शेरी
Andra	एण्ड्रा
Darrius	डैरियस
Ledell	लेडेल
Aruna	अरुणा
Mrigendra	मृगेंद्र
Giridhari	गिरिधारी
Haweliana	हवेलियाना
Nawar	नवर
Platinum	प्लेटिनम
Zayb	ज़ैब
Asta	एस्टा
Dalton	डेल्टन
Emmy	एमी
Berne	बर्न
Asma	अस्मा
Akaltara	अकालतारा
Baqir	बाकिर
Ocarina	ऑकारिना
Chingari	चिंगारी
Ginny	जीनी
Ajaatshatru	अजातशत्रु
Ishwar	ईश्वर
Shareekah	शरीकाह
Victory	विक्ट्री
Dham	धाम
Pophalikar	पोफली
Piggott	पिगोट
Umashankar	उमाशंकर
Anandinee	आनंदिनी
Amy	एमी
Bhaarateey	भारतीय
Kinara	किनारा
Aru	अरु
Balavan	बलवान
Tehran	तेहरान
Baheer	बहीर
Tulsa	टुलसा
Awena	एवेना
Barharwa Junction	बरहरवा
Hinduism	हिंदूइज़्म
Lisbon	लिस्बन
Columbia	कोलम्बिया
Shalimar	शालीमार
Dindral	दिंदराल
Summer	समर
Sohal	सोहल
Vinchurkar	विंचुरकर
Sohan	सोहण
Thakur	ठाकुर
Monitor	मॉनीटर
Iyaad	इयाद
Apala	अपला
Katherine	कैथरीन
Anuraadhaa	अनुराधा
Sipahiya	सिपहिया
Osmanabad	उस्मानाबाद
Parameshthin	परमेष्ठिन
Raghupati	रघुपति
Esha	ईशा
Dohara	दोहारा
Atithee	अतिथी
Puranjay	पुरंजय
Pavanaputr	पवनपुत्र
Arqam	अरकाम
Jawahir	जवाहिर
Madhubala	मधुबाला
Idalia	इडेलिया
Belvandi	बेलवंदी
Sipaahi	सिपाही
Krystal	क्रिस्टल
Balaram	बलराम
Callie	कैलीन
Luanda	लुआंडा
Garibi	गरीबी
Rambha	रम्भा
Lucine	ल्यूसिन
Muhriz	मुहरिज़
Corinthia	कोरिंथिया
Chiragh	चिराग़
Ghabrahat	घबराहट
Saib	सैब
Anirvaan	अनिर्वाण
Duniya	दुनिया
Madaniyah	मदनियाह
Hasna	हास्ना
Dastak	दस्तक
Bakeer	बकीर
Solan	सोलन
Kalikambal	कालीकम्बाल
Nobelium	नॉबेलियम
Norwich	नॉरविच
Chyna	चायना
Yalqoot	यलकूत
Rajkot	राजकोट
Jayashekhar	जयशेखर
Babatpur	बाबतपुर
Kafan	कफन
Raju	राजू
Kiswar	किस्वर
Panji	पणजी
Lancelot	लांसलोट
Diyodar	दियोधर
Gwylan	ग्वायलेन
Humsaya	हमसाया
Cobalt	कोबाल्ट
Bridge	ब्रिज
El-awra	एल-अव्रा
Corliss	कोर्लिस
Banavaaree	बनवारी
Pukar	पुकार
Manoj	मनोज
Mustajab	मुस्तजाब
Manon	मेनन
Dodada	दोदड़ा
Bareeq	बरीक
Firdaus	फिरदौस
Josie	जोसि
Violet	वायलेट
Dugdol	दुगडोल
Sivni	सिवनी
Mukhadaa	मुखड़ा
Meghanaad	मेघनाद
Hafs	हफ्स
Vinati	विनती
Sian	सिआन
Lipika	लिपिका
Hans	हंस
Hermes	हर्मीस
Brahmavart	ब्रहमवर्त
Kharqa	ख़ार्का
Achalapati	अचलापति
Ferguson	फरग्यूसन
Kharga	खारगा
Auberta	औबेर्टा
Ankit	अंकित
Yaman	यमन
Moan	मोन
Kineta	किनेटा
Jaganmay	जगन्मय
Vishavanbhar	विशवंभर
Maniram	मणिराम
Sonal	सोनल
Akshar	अक्षर
Belagaam	बेलगाम
Major	मेजर
Guldhar	गुलधर
Southampton	साउथम्पटन
Ruby	रूबी
Rudy	रुडी
Animish	अनिमिश
Arundhati	अरुंधति
Apmaan	अपमान
Punam	पूनम
Nartana	नर्तना
Vajramani	वज्रमणि
Shurafa	शुरफा
Midhvaan	मिधवान
Angoothi	अंगूठी
Chaani	चानी
Bahadur	बहादुर
Tandilat	तंदीलत
Sikand	सिकंद
Aacharynandan	आचार्यनंदन
Raaj	राज
Evelia	इवेलिया
Symona	सिमोना
Annis	एनिस
Trishagni	त्रिशाग्नी
Arkan	अरकान
Vachel	वचेल
Pooran	पूरण
Waliyah	वलियाह
Naveed	नवीद
Marundeeswarar	मरुनदीस्वरार
Steffi	स्टेफी
Elena	एलेना
Dhulkot	धुलकोट
Noor-E-Elahi	नूर-ए-इलाही
Rishiyaketu	ऋषियकेतु
Lahore	लाहौर
Dhoon	धुन
Corkett	कॉर्केट
Pragati	प्रगति
Gopan	गोपन
Grinham	ग्रिनहैम
Abhijaat	आभिजात
Alarice	एलेराइस
Thurnwald	थुर्नवाल्ड
Abhilasahaa	अभिलाषा
Jalgaon	जलगांव
Lamb	लैंब
Subhedar	सुभेदार
Akash	आकाश
Parul	पारुल
Vanita	वनिता
Mikel	मिकेल
Darinda	दरिंदा
Prashansa	प्रशंसा
Damul	दामुल
Maleehah	मलीहाह
Stolt-Nielsen	स्टॉल्ट निलसन
Barrackpore	बैरकपुर
Madan	मदन
Yaachishnu	याचिष्णु
Lucius	ल्यूसियस
Bafin	बफ़िन
Anjanee	अंजनी
Chatpati	चटपटी
Noleta	नोलेटा
Kotla	कोटला
Azamnagar Road	आज़मनगर
Katni	कटनी
Chetar	चेतार
Sadhvi	साध्वी
Adelle	एडेल
Devadhip	देवाधिप
Humrahi	हमराही
Wilkinson	विल्किनसन
Rajpal	राजपाल
Manaakshu	मनश्चक्षु
Bishop	बिशप
Suvarna	सुवर्णा
Ananga	अनंग
Tatra	टाट्रा
Chekitan	चेकितान
July	जुलाई
Days	डेज
Raghunaath	रघुनाथ
Berchtesgaden	बेरशेत्ज़गैडेन
Saarangapaani	सारंगपाणि
Emilio	एमिलिओ
Halwara	हल्वारा
Donato	डोनेटो
Adityapur	आदित्यपुर
Sumita	सुमिता
Usariya	उसरिया
Connor	कोनर
Arivarasu	अरिवरसु
Vivekaanand	विवेकानंद
Dohrighat	दोहरीघाट
Susmita	सुस्मिता
Pugree	पगड़ी
Christa	क्रिस्टा
Aanand	आनंद
Bhongir	भोंगीर
Sadoof	सदूफ
Cerebus	सेरेबस
Lucy	ल्यूसी
Dustin	डस्टिन
Sharman	शर्मन
Kamyabi	कामयाबी
Adityanandan	आदित्यनंदन
Reginald	रेगीनाल्ड
Illustrious	इलस्ट्रीयस
Ardan	अर्दन
Corin	कोरिन
Willard	विलार्ड
Bhuranyu	भूरण्यु
Torrance	टॉरेंस
Jayeshvar	जयेश्वर
Endesa	एन्डेसा
Dabur	डाबर
Manjushri	मंजुश्री
Nadalo	नडालो
Berlin	बर्लिन
Bhatpur	भटपुर
Nairit	नैरित
Cruybeke	क्रूबेक
Gregg	ग्रेग
Banwet	बनवेट
Navrangpur	नवरंगपुर
Saad	साड
Dumbeg	डमबेग
Gurjas	गुरजस
Malay	मलय
Reno	रेनो
Vernalis	वेर्नलीस
Jamison	जैमिसन
Virat	विरत
Timin	तिमिन
Shishir	शिशिर
Aparaajit	अपराजित
Abrash	अबराश
Viraj	विराज
Rand	रेंड
Sunila	सुनिला
Vishvajayee	विश्वजयी
Birapatti	बीरापती
Dulal	दुलाल
Ladki	लड़की
Angamali	अंगमाली
Evangelia	इवेंजेलिया
Abanur	अबनूर
Gloria	ग्लोरिया
Mustaeen	मुस्तईन
Yogita	योगिता
Vishalakshi	विशालाक्षी
Satang	सातांग
Potemkin	पॉटेमकिन
Sileas	सिलीस
Manaj	मानज
Khanduja	खंडुजा
Sanborn	सैनबॉर्न
Jorjanna	जोर्जना
Chaneti	चनेटी
Lyris	लाइरिस
Gousli	गोस्ली
Amalatas	अमलतास
Aachaaryasutaa	आचार्यसुता
Somansh	सोमांश
Vangie	वेनजी
Bajrangbali	बजरंगबली
Daamin	दामिन
Bolivia	बोलिविया
Nripendra	नृपेंद्र
Minoo	मीनू
Ailis	ऐलिस
FreeSeas	फ़्रीसीज़
Yogeey	योगीय
Subarna	सुबर्ना
Mahal	महल
Mahak	महक
Brazzaville	ब्राज़विले
Duhai	दुहाई
Implacable	इमप्लेसेबल
Grahasthi	गृहस्थी
Achalganj	अचलगंज
Kandhari	कंधारी
Fionn	फियोन
Finn	फिन
Salem	सलेम
Aslesh	अश्लेष
Arij	आरीज
Chander	चन्दर
Cityspire	सिटीस्पार
Umberto	अम्बेर्टो
Conakry	कोनार्की
Rowing	रोइंग
Sumatra	सुमात्रा
E'temad	इत्तेमाद
Hulchal	हलचल
Dulon	दूलों
Akaasha	आकाश
Sachchit	सच्चित
Gorana	गोराना
Douglass	डगलस
Priyatma	प्रियतमा
Kasia	कैसिया
Rohan	रोहण
Dayanand	दयानन्द
Goraya	गोराया
Aachaaryasuta	आचार्यसुता
Pran	प्राण
Ramkumar	रामकुमार
Garrick	गैरिक
Phalnikar	फलणीकर
Cheng	चेंग
Carson	कार्सन
Diving	डाईविंग
Dalpatpur	दलपतपुर
Bholaanaath	भोलानाथ
Afeerah	अफीराह
Willem	विलेम
Abahim	अबहीम
Telyn	टेलिन
Jaegar	जैगर
Sristi	सृष्टि
Bhapa	भापा
Nisbat	निस्बात
Omeshvar	ओमेश्वर
Ayra	आयरा
Guadalupe	गुडालुपे
Prabhsimran	प्रभसिमरन
Gohana	गोहाना
Latikaa	लतिका
Vinnie	विनी
Haree	हरी
Sultanpuria	सुल्तानपुरिया
Ura	उरा
Dalgaon	डलगांव
Sanjhi	सांझी
Filler	फिलर
Kullu	कुल्लू
Shrey	श्रेय
Akira	अकीरा
Nero	नीरो
Guriya	गुरिया
Providence	प्रॉविडन्स
Darla	डेर्ला
Devona	डेवोना
Vatika	वाटिका
Preyasi	प्रेयसी
Ratowal	रतोवाल
Muntasir	मुंतसिर
Dominique	डोमिनिक
Raidah	रैदाह
Bhavesh	भावेश
Suhas	सुहास
Omele	ओमेली
Ksena	क्सेना
Veradis	वेरेडिस
Jagan	जगन
Kristine	क्रिस्टीन
Godfrey	गोडफ्रे
Gretchen	ग्रेचेन
Jiten_dr	जितेन्द्र
Ibrat	इबरत
Verdi	वर्डी
Redoutable	रेडॉटेबल
Mohammad	मोहम्मद
SunOpta	सनऑप्टा
Shaheerah	शहीराह
Padosan	पड़ोसन
Janhavi	जान्हवी
Clem	क्लेम
Flo	फ्लो
Dasuha	दसूहा
Satyamurti	सत्यमूर्ति
Cardigan	कार्डिगन
Adelaide	एडीलेड
Sanghera	संघेरा
Ali	अली
Dasuya	दसुया
Rani	रानी
Rahamaan	रहमान
Keshav	केशव
Sultan	सुल्तान
Doiwala	दोइवाला
Rochan	रोचन
Amitaa	अमिता
Bijainagar	बिजयनगर
Devta	देवता
Gharoda	घरोड़ा
Saimah	सैमाह
Bongaigaon	बॉन्गाईगांव
Garmin	गार्मिन
Ronat	रोनट
Vishakha	विशाखा
Omana	ओमानन्द
Keoladeo	केवलादेव
Asbagh	अस्बाग
Anjushri	अंजुश्री
Fandango	फैनडैंगो
Jenibelle	जेनिबेल
Gangan	गंगन
Gavotte	गैवोट
Sheesha	शीशा
Nilagriv	नीलाग्रीव
Benin	बेनिन
Daad	दाद
Crocker	क्रोकर
Hancock	हैनकॉक
Nazneen	नाज़नीं
Uran	युरन
Fabiano	फैबियानो
Dayyan	दयान
Ninon	निनोन
Cassia	कैसिया
Lala	लाला
Fayd	फैयद
Nashtar	नश्तर
Tyanne	टायनी
Vikraant	विक्रांत
Badreeprasad	बद्रीप्रसाद
Aakarshan	आकर्षण
Quintana	क्विंटाना
Thuwaybah	थुवैबाह
Vanamaalee	वनमाली
Fahd	फहद
Sundarataa	सुंदरता
Bohrium	बोरियम
Atiya	अतिया
Muhtadi	मुहतादी
Mekong	मेकाँग
Medini	मेदिनी
Baalee	बाली
Ilesh	इलेश
Bangui	बैंगई
Balagopal	बालगोपाल
Yen	येन
Chandpur	चाँदपुर
Tahseen	तहसीन
Hazaribagh	हजारीबाग
Neil	नील
Champawat	चम्पावत
Mukut	मुकुट
Sandoval	सैंडोवल
Mukur	मुकुर
Philippines	फ़िलीपिन्स
Tarala	तरला
Trident	ट्रिडेंट
Idana	इडेना
Ramendra	रामेंद्र
Ara	आरा
Jocasta	जोकस्ता
Delta	डेल्टा
Vedi	वेदी
Baghauli	बघौली
Patagonian	पेटागोनियन
Sen	सेन
Lanza	लैंजा
Kristy	क्रिस्टी
Caitir	कैतिर
Aacharyanandanaa	आचार्यनंदना
Dalal	दलाल
Dhvani	ध्वनि
Amirindra	अमिरिंद्र
Nabigh	नबिघ
Saroja	सरोजा
Sherise	शेरीज
Vaaditaa	वादिता
Taruni	तरुणी
Tulasi	तुलसीदास
Liwonde	लिवोंदे
Vietnam	वियतनाम
Bell	बेल
Nathalie	नैथले
Danae	डेनी
Cavalier	कवालियर
Deshonnati	देशोन्नत‍ि
Arshad	अर्शद
Dvoyanka	दवोयंका
Subah	सुबह
Manchala	मनचला
Carlynda	कारलिंडा
Massena	मसीना
Vaartha	वार्ता
Baaghi	बागी
Iqtidar	इक़्तिदार
Constellation	कॉन्स्टेलेशन
Guitar-Charango	गिटार-करैंगो
Boinda	बोइंदा
Chandigadia	चंडीगड़िया
Gurneet	गुरनीत
Madra	मैड्रा
Kenadia	केनेडिया
Cutter	कटर
Gurpreet	गुरप्रीत
Kashifah	कशिफाह
Hujayrah	हुजयराह
Azaraq	अज़राक
Dakar	डाकर
Bhudhar	भूधर
Kusumaadhiraaj	कुसुमाधिराज
Prahlad	प्रहलाद
Salamat	सलामत
Rouen	रॉएन
Celestyn	सेलेस्टीन
Garrafon	गरफॉन
Bhagalpur	भागलपुर
Murray-Darling	मुर्रे डार्लिंग
Jhansiwale	झांसीवाले
Ravindr	रविंद्र
Edythe	एडिथ
Alfonso	अल्फांसो
Fell	फेल
Angelo	एंजेलो
Baalamani	बालमणि
Motilal	मोतीलाल
Haashim	हाशिम
Ghamandee	घमंडी
Delbert	डेलबर्ट
Sarakshi	सारक्षी
Pramada	प्रमदा
Royce	रॉयस
Dakhla	डाखला
Shivapriyaa	शिवप्रिया
Laiq	लईक
Prabir	प्रबीर
Samajh	समझ
Angraj	अंगराज
Negi	नेगी
Khuwaylah	खुवयलाह
Neci	नेकि
Bhanvaralaal	भंवरलाल
Lynna	लायना
Arihant	अरिहंत
Sugar	शुगर
Dianthe	डियांथ
Surgery	सर्जरी
Valentina	वैलेंटिना
Advait	अद्वैत
Siddhima	सिद्धिमा
Baankebihari	बांकेबिहारी
Awaargi	आवारगी
Dagan	दगन
Villette	विलेट
Pike	पाइक
Bhachau	भचउ
Boosters	बूस्टर्स
Baqi	बकी
Anthony	एंतनी
Pawan	पवन
Jhabua	झाबुआ
Dharmanand	धर्मानन्द
Lev	लेव
Leu	लेउ
Dabilpur	दाबिलपुर
Bhind	भिण्ड
Giselle	गिसेली
Nishad	निषाद
Umesh	उमेश
Hisar	हिसार
Repsol	रेप्सॉल
Cedi	कैडी
Saaz	साज़
Jeanette	जीनेट
Galop	गैलप
Beri	बेरी
Shikar	शिकार
Beti	बेटी
Paaro	पारो
Vegavaan	वेगवान
Arghya	अर्घ्य
Muralidhar	मुरलीधर
Narindrr	नरिंद्र
Aadinaraayan	आदिनारायण
Pratapgad	प्रतापगढ़
Sahil	साहिल
Sahas	सहस
Sahar	सहर
Neelanjan	नीलांजन
Bareli	बरेली
Qanoun	कनाउन
Dhiya	धिया
Mukhataar	मुखतार
Heckenberg	हेकनबर्ग
Nasamajh	नासमझ
Jeff	जेफ्फ
Braunschweig	ब्रॉन्स्वेग
Kenneth	केनेथ
Garot	गरोट
Ludlow	लडलो
Timbales	टिमबेल्स
Hanee	हनी
Chavalkhede	चवलखेड़े
Philander	फिलैंडर
Workstream	वर्कस्ट्रीम
Uditi	उदिति
Agasod	अगासोद
Bryant	ब्रायंट
Asafpur	आसफपुर
Senegal	सेनेगल
Reprisal	रीप्राइजल
Dyllis	डायलिस
Viplav	विप्लव
Adheera	अधीरा
Fort-chambly	फोर्ट-कैम्बली
Salam	सालम
Salif	सलीफ
Hocking	हॉकिंग
Daryapur	दरियापुर
Salah	सालेह
Salim	सलीम
Activity	एक्टीविटी
Girija	गिरिजा
Kuchipudi	कुचीपुड़ी
Caracas	काराकस
Bindiya	बिंदिया
Tyson	टायसन
Silsila	सिलसिला
Orbotech	ऑर्बोटेक
Anahid	अनहिद
Vaibhavee	वैभवी
Laalachand	लालचंद
Sukhdev	सुखदेव
Bracken	ब्रेकन
Agas	अगास
Darin	डैरिन
Gillespie	गिलेस्पी
Daria	डेरिया
Colusa	कॉलूसा
Agaathaa	अगाथा
Atmaram	आत्माराम
Suheera	सुहीरा
Dharampreet	धरमप्रीत
Rockbridge	रॉकब्रिज
Deo	डियो
Barsaat	बरसात
Hartford/Bradley	हॉर्टफोर्ड/ब्रॉड्ले
Dee	डी
Fermium	फेर्मियम
Bakare	बाकरे
Emerald	एमराल्ड
Vajra	वज्र
Bickle	बिकल
Lakshadweep	लक्षद्वीप
Kateb	कातिब
Surinder	सुरिन्दर
Beskidy	बेस्किडे
Xenos	ज़ेनोस
Chittoor	चित्तूर
Gholvad	घोलवद
Maharaja	महाराजा
Thanjavur	तंजावुर
Avataar	अवतार
Bouvet	बॉवेट
Aadinaaraayan	आदिनारायण
Pegasus	पेगासस
Thatte	थत्ते
Alboran	अल्बोरान
Kaltham	कल्थम
Gloriann	ग्लोरियन
Nighojkar	निघोजकर
Kumaar	कुमार
Lily	लिली
Anjaam	अंजाम
Etoile	इटोइल
Vevay	वेवे
Sanaa	साना
Purus	प्युरस
Quickstep	क्विकस्टेप
Tanmaya	तन्मया
Laud	लाउड
Mehmaan	मेहमान
Sanat	सनत
Bhitaura	भिटौरा
Kasauti	कसौटी
Zarqa	ज़र्का
Moxenos	मॉक्सेनोस
Duduk	डुदुक
Sambaran	समबरन
Courageous	करेजियस
Jeneva	जेनेवा
Spencer	स्पेन्सर
Ghazalan	ग़ज़लान
Teranika	टेरेनिका
Retalix	रेटालिक्स लि.
Vaachikaa	वाचिका
Khatoon	खातून
Stew	स्टीव
Xenophon	ज़ेनोफोन
Medhaavinee	मेधाविनी
Barsuan	बरसौन
Titus	टाइटस
Naaz	नाज़
Dameer	दमीर
Sadhna	साधना
Warner	वार्नर
Airell	ऐरेल
Gopal	गोपाल
Deenabandhu	दीनबंधु
Shoeb	शोएब
Bhudraj	भुदराज
Najibah	नाजिबा
Prajeet	प्रजीत
Abjayoni	अब्जयोनि
Gandhapalin	गंधपालिन
Christopher	क्रिस्टोफर
Sabar	सबर
Moniruzzaman	मोनीरुज़्ज़ामन
Stedman	स्टेडमैन
Vinayak	विनायक
Raamateke	रामटेके
Sterlite	स्टरलाइट
Solstice	सोलस्टिस
Preussen	प्रूसेन
Bijauli	बिजौली
Lowell	लोवेल
Prithviraj	पृथ्वीराज
Zwyndrecht	ज़ॉएन्ड्रेच
Bidupur	बिदुपुर
Najidah	नाजिदा
Baidehi	बैदेहि
Patanga	पतंगा
Bieszczady	बिज़क्ज़ाडे
Bilpur	बिलपुर
Zulfaqar	ज़ुल्फ़कार
Chikalthan	चिकलथन
Bard	बर्द
Sayar	सायार
Gearing	गियरिंग
April	एप्रिल
Gabon	गाबोन
Saleemah	सलीमाह
Ekatan	एकतन
Dhulajee	धुलजी
Pathik	पथिक
Krishnakali	कृष्णकली
Oldenberg	ऑडेनबर्ग
Tendulkar	तेंडुलकर
Wafiyah	वाफियाह
Maad	माड़
Nadaleen	नडालीन
Majd	मज्द
Ekambir	एकमबीर
Salwaan	सल्वान
Henkel	हेंकल
Onega	उनेगा
Chamundeswari	चमुनदेस्वरी
Sagan	सगन
Neeraja	नीरजा
Triyama	त्रियामा
Gorakhpur	गोरखपुर
Gymnastics	जिमनास्टिक्स
Bijnaur	बिजनौर
Aphrodite	एफ्रोडाइट
Sagar	सागर
Galan	गलन
Candie	कैंडी
Conrad	कौनराड
Falewal	फलेवाल
Dabeer	डबीर
Evanthe	इवांथ
Sugandh	सुगंध
Pramiti	प्रमिति
Ratul	रतुल
Sourabhi	सौरभि
Gaman	गमन
Mithil	मिथिल
Makati	मकाती
Faiz	फैज़
Bacheli	बचेली
Comcast	कॉमकास्ट
Lowndes	लॉनडेस
Selwyn	सेल्विन
Somendra	सोमेंद्र
Babrala	बाब्रला
Aanandamayee	आनंदमयी
Sompaal	सोमपाल
Melissan	मेलिसन
Calvert	कैल्वर्ट
Masoomah	मसूमाह
Kashmakash	कश्मकश
Gaali	गाली
Sipahsalar	सिपहसलार
Bretagne	ब्रेटाग्ने
Pamelia	पामेलिया
Garhwa	गढ़वा
Khubsurat	खूबसूरत
Vico	विको
Vaageesh	वागीश
Veethikaa	वीथिका
Gachhipura	गच्चीपुरा
Dabhaura	दभौरा
Kulthum	कुलथुम
Marakat	मरकत
Kylemore	किलमोर
Kabirah	कबीराह
Wilda	विल्डा
Aisling	ऐस्लिंग
Shikari	शिकारी
Dulcina	डल्सिना
Athawale	आठवले
Pence	पेन्स
Wolverine	वॉल्वरिन
Jaiwanti	जयवंती
Mathilda	मथिल्डा
Jalia	जैलिया
Hurmat	हुरमत
Smaram	स्मरम
Kulbhushan	कुलभूषण
Kashelikar	कशेलीकर
Laverne	लैवनन
Rachita	रचिता
Hatimtai	हातिमताई
Khalil	खलील
Vimogh	विमोघ
Coimbatore	कोयम्बटूर
Jazlynn	जैजलिन
Arcadis	आर्केडिस
Abha	आभा
Mrityunjai	मृत्युंजय
Arabela	एराबेला
Sudhanshu	सुधांशु
Pir	पीर
Excalibur	एक्सकैलिबर
Geeti	गीति
Aighar	ऐगर
Chitrarekha	चित्ररेखा
Amlakhurd	आम्लाखुर्द
Manning	मैनिंग
Mutayyib	मुताय्यिब
Wardha	वर्धा
Annette	एनेट
Budnaseeb	बद‍नसीब
Basrai	बसराई
Sudeepa	सुदीपा
Vaagmitaa	वाग्मिता
Carolena	कैरोलिना
Karale	कराले
Aabshar	आबशर
Swaroopaa	स्वरूपा
Jahajj	जाहज
Fuso	फूसो
Dandeli	डांडेली
Haskell	हैस्कल
Ebra	एब्रा
Saras	सरस
Bhinwaliya	भिनवालिया
Pedro	पेड्रो
Admiralty	एडमिरैल्टी
Piyali	पियाली
Aniteja	अनितेज
Gazalee	गज़ाली
Konig	कॉनिग
Cleave	क्लीवेंट
Caron	कैरोन
Nico	निको
Aurvashey	और्वशेय
Rahgeer	राहगीर
Kirra	किरा
AstraZeneca	एस्ट्राज़ेनेका
Capivara	कैपीवारा
Moude	मौडे
Annapurnaa	अन्नपूर्णा
Betaab	बेताब
Abeeraa	अबीरा
Majedaar	मजेदार
Ramashray	रामाश्रय
Smitaa	स्मिता
Haaroon	हारून
Kelvin	केल्विन
Jugnu	जुगनू
Mandal	मंडल
Kanwaljeet	कंवलजीत
Faseeh	फसीह
Dalmera	डलमेरा
Hathkadi	हथकड़ी
Interceptor	इंटरसेपटर
Muradabad	मुरादाबाद
Emmet	एमेट
Bansipur	बंसीपुर
Avinaash	अविनाश
Varthamanam	वर्तमानम
Jayprada	जयप्रदा
Goresuar	गोरेसुवर
Hockey	हॉकी
Raghuvansh	रघुवंश
Christine	क्रिस्टीन
Dewalgaon	देवालगांव
Laajavantee	लाजवंती
Makhdoom	मखदूम
Kiran	किरण
Dandolo	डैंडोलो
Margaret	माग्रेट
Midway	मिडवे
Lycoris	लाइकोरिस
Das	दास
Annapoorna	अन्नपूर्णा
Milo	मिलो
Chiyoda	चियोदा
Guajira	गुआजिरा
Rose	रोज़
Clifton	क्लिफ्टन
Selkirk	सेलक्रिक
Dorothea	डोरोथिया
Dino	डीनो
Shokaghn	शोकघ्न
Jill	जिल
Phadatare	फडतरे
Kripa	कृपाल
Yves	वेस
Devnath	देवनाथ
Vaidya	वैद्य
Hillier	हिलियर
Apurv	अपूर्व
Fujai	फुजाई
Arasur	अरासुर
Gino	जीनो
Rajam	राजम
Raeesah	रईसाह
Rajat	रजत
Urbana	अरबाना
Maasoom	मासूम
Aah	आह
Belapur	बेलापुर
Bedaag	बेदाग
Hindee	हिंदी
Sultanat	सल्तनत
Kamraj	कामराज
Fico	फीको
Baalgopaal	बालगोपाल
Portugal	पोर्तुगल
Hawshab	हौशाब
Simba	सिंबा
Maysun	मेसन
Pritha	पृथा
Jograj	जोगराज
Loretta	लोरेट्टा
Daler	दलेर
Ankush	अंकुश
Shashaank	शशांक
Darpad	दर्पद
Samarah	समराह
Shamamah	शममाह
Dudhani	दूधानी
Sahishnu	सहिष्णु
Mashoodah	मशूद
Rhea	रिया
Shergill	शेरगिल
Sapre	सप्रे
Rochefort	रॉचेफोर्ट
Shoorveer	शूरवीर
Palekar	पालेकर
Toktogul	टोक्टोगुल
Chinchore	चिंचोरे
Swagata	स्वागता
Tawseef	तौसीफ
Mohin	मोहिन
Akshan	अकशान
Sparsh	स्पर्श
Baragaon	बरागांव
Azzah	अज़्ज़ाह
Dante	दांते
Griselda	ग्रिसेल्डा
Qaisar	कैसर
Praveen	प्रवीण
Thea	थिया
Devaria	देवरिया
Jivan	जीवन
Kunti	कुंती
Paighaam	पैगाम
Kunte	कुंटे
Gananaayak	गणनायक
Rupashi	रूपशी
Kaduthuruthi	काडूथुरूट्टी
Balqees	बल्कीस
Pratap	प्रताप
Dhamkee	धमकी
Crete	क्रेट
Khalaf	खलाफ
Ihab	इहाब
Tatini	तातिनी
Gaddiwal	गड़्डीवाल
Wilbur	विल्बर
Khalisah	खलिसाह
Rexam	रेक्ज़ेम
Felicia	फेलिसिया
Shahraj	शहराज
Kendurkar	केंदुरकर
Tomai	टोमेई
Hathur	हठुर
Oalkar	ओलकर
Eustacia	यूस्टेसिया
Nachiket	नचिकेत
Aastha	आस्था
Afjal	अफजल
Anupama	अनुपमा
Mid-day	मिड-डे
Kundanika	कुन्दनिका
Rabat	रवात
Khatri	खत्री
Kingston	किंग्स्टन
Baalaaji	बालाजी
Snowboarding	स्नोबोर्डिंग
Daliganj	डलीगंज
Adam	आदम
Nabha	नाभा
Ozzy	ओज़्ज़ी
Mehrunissa	मेहरुन्निसा
Rudolph	रुडोल्फ
Gill	गिल
Argheshvara	अर्घेश्वर
Feruman	फेरूमन
Badwal	बड़वाल
Faruca	फ़रूका
Deeptiman	दीप्तिमान
Ellette	एलीट
Cholamandalam	कोलामंडलम
Chaela	चाएला
Fia	फिया
Gemini	जेमिनी
Tamanna	तमन्ना
Dhaleshwari	धलेश्वरी
Dhansindi	धानसिंडी
Wasimah	वसीमाह
Sehra	सेहरा
Ankushee	अंकुशी
Kartavya	कर्तव्य
Exelon	एक्ज़ेलॉन
Chitramala	चित्रमाला
Jhumroo	झुमरू
Deepankar	दीपंकर
Carissa	कैरीसा
Aachaaryanandana	आचार्यनंदना
Trenton	ट्रेंटन
Adriatic	एड्रीएटिक
Gaurinath	गौरीनाथ
Ud	उद
Centavos	सेन्टावोस
Sarwate	शोत्री
Shailasutaa	शैलसुता
Jahdami	जहदामी
Daiei	दैई
Cheema	चीमा
Faraz	फराज़
Yamashiro	यमाशिरो
Udaysah	उदैसाह
Tohana	टोहाणा
Stargazer	स्टारगेज़र
Bedekar	बेडेकर
Dore	डोर
Sukhanand	सुखानंद
Karouli	करौली
Burnpur	बर्नपुर
Mubarak	मुबारक
Nahanni	ना‍हान्नी
Dobbelaar	डोबेलार
Varada	वरदा
Manendra	मनेंद्र
Aafreen	आफरीन
Chaughule	चौघुले
Makayla	मकायला
Cecile	सेसिली
Jhitaruraam	झितरुराम
Sagheerah	सगीराह
Gore	गोर
Cleopatra	क्लियोपैट्रा
Gole	गोले
Singh	सिंघ
Vaahid	वाहिद
Bowling	बॉलिंग
Duguid	ड्यूगुड
Raasavihaaree	रासविहारी
Kinshasa	किन्शासा
Maysa	मेसा
Amritap	अमृतप
Ursala	उर्सला
Lillian	लिलियन
Shreepati	श्रीपति
Morinda	मोरिंडा
Vedika	वेदिका
Sulayman	सुलेमान
Coolie	कुली
Nandan	नन्दन
Gondal	गोंडल
Su'ad	सुआह
Shawm	शॉम
Shawn	शॉन
Devasree	देवश्री
Aurav	औरव
Lokprakash	लोकप्रकाश
Dhanbad	धनबाद
Sangha	संघा
Pooja	पूजा
Lorne	लोर्न
Ghatam	घातम
Jasmund	जैसमंड
Delora	डेलोरा
Shrimayi	श्रीमयी
Bundi	बूंदी
Telugu	तेलुगू
Tassos	टैसस
Antonie	एंटोनी
Amreek	अमरीक
Bhilainagar	भिलाईनगर
Panchayat	पंचायत
Vardha	वर्धा
Aliwal	अलीवाल
Truckin	ट्रकिन
Trethewey	ट्रेथवे
Dorie	डोरी
Goodwin	गुडविन
Doria	डोरिया
Madanapaal	मदनपाल
Daate	दाते
Mangalam	मंगलम
Kiora	किओरा
Wasifah	वज़ीफाह
Dorothy	डोरोथी
Darnarik	दर्नरिक
Queensboro	क्वीन्सबोरो
Sarasi	सरसि
Gainjahwa	गैनजहवा
Vijul	विजुल
Reibel	रीबल
Trafalgar	ट्रफल्गर
Meghnad	मेघनाद
Aayushmaan	आयुष्मान
Marissa	मैरिसा
Cardea	कार्डिया
Pavase	पावसे
Chanchal	चंचल
Daudpur	दाऊदपुर
Madhopur	माधोपुर
Achaleshwar	अचलेश्वर
Mufakkir	मुफ़क्किर
Amrita	अमृता
Evania	इवानिया
Paravej	परवेज
Barkaat	बरकात
Angada	अंगदा
Tejaswi	तेजस्वी
Avanti	अवंति
Rakhshan	रखशान
Shilling	शिलिंग
Palnitkar	पलणीटकर
Roll	रॉल
Kamboj	कंबोज
Najma	नजमा
Garrison	गैरीसन
Chaitanya	चैतन्य
Jayashree	जयश्री
Gagroli	गगरोली
Shiksha	शिक्षा
Agroia	अगरोइया
Yeardley	यार्डले
Panhala	पन्हाला
Panchvati	पंचवटी
Rufus	रफस
Raamacharan	रामचरण
Malaysia	मलेशिया
Pudhari	पुढ़ारी
Buldhana	बुलढाणा
Josephine	जोसफिन
Dhanakwada	धनकवाड़ा
Maryada	मर्यादा
Macumbo	मैकूंबा
Gajapaal	गजपाल
Tiffany	टिफेनी
Jalendra	जलेंद्र
Dhumr	धूम्र
Mirchandani	मीरचंदानी
Amr	अम्र
Hoor-E-Arab	हूर-ए-अरब
Lokre	लोकरे
Dindayal	दीनदयाल
Guwahati	गुवाहाटी
Nazirah	नज़ीरा
Oman	ओमान
Toran	तोरन
Dorjan	डॉर्जन
Matwala	मतवाला
Sarjana	सर्जना
Subhaash	सुभाष
Matwale	मतवाले
Evette	इवेट
Budaun	बुदौन
Janet	जेनेट
Kush	कुश
Goalball	गोलबॉल
Mignon	मिग्नोन
Wavre-sainte-catherine	वैवर-सेंट-कैथरीन
Earth	अर्थ
Innisfallen	इनिसफॉलन
Sambhav	सम्भव
Luxembourg	लक्ज़ेम्बर्ग
Anisaa	अनीसा
Pune	पुणे
Anisha	अनिशा
Allegheny	अल्लेगहेन्ये
Elwyn	एल्विन
Mambo	मैंबो
Makaila	मकैला
Habsburg	हैब्सबर्ग
Kamesh	कामेश
Yasmeenah	यस्मीनाह
Elaine	एलेना
Edison	एडीसन
Mardi	मार्डी
Puraskaar	पुरस्कार
Madhavi	माधवी
Yawatmal	यवतमाल
Onkar	ओंकार
Inas	इनस
Lucinda	ल्यूसिंडा
Tarunima	तरुणिमा
Banbhatta	बाणभट्ट
Okaar	ओंकार
Huria	हुरिया
Jhalak	झलक
Baliakheri	बलियाखेरी
Ahad	आहड
Gogorron	गॉगोरॉन
Singhasan	सिंहासन
Scot	स्कॉट
Bayan	बेयान
Paulette	पोलित
Slowman	स्लोमेन
Trishna	तृष्णा
Baheej	बहीज
Westbrook	वेस्टब्रूक
Palk	पाल्क
Manipur	मणिपुर
Manibhushan	मणिभूषण
Padosi	पड़ोसी
Suwaydah	सुवेदाह
Baglama	बगलामा
Ramani	रमानी
Chiranjeevi	चिरंजीवी
Manjistha	मंजिष्ठा
Azaraaq	अज़राक
Garth	गार्थ
Daltonganj	डैल्टनगंज
Independence	इंडीपेंडेंस
Holikaa	होलिका
Bhartiya	भारतीय
Agreement	एग्रीमेंट
Kalika	कालिका
Yuktika	युक्तिका
Aadinath	आदिनाथ
Vaad	वाड
Ivvavik	इवाविक
Phanse	फणसे
Weymark	वेमार्क
Vallari	वल्लरी
Leavitt	लेविट
Faiq	फै़क
Kenda	केंडा
Faeq	फाएक
Callum	कैलम
Dapodi	दपोदी
Venkateshvar	वेंकटेश्वर
Divan	दिवान
Saluja	सलूजा
Kajima	कजीमा
Andolan	आंदोलन
Suvarnaprabha	सुवर्णप्रभा
Nehra	नेहरा
Amin	अमीन
Haupango	हॉपैंगो
Kanyadan	कन्यादान
Anjaane	अंजाने
Mahaaraaj	महाराज
Raverkar	रावेरकर
Pralay	प्रलय
Chhipadohar	छिपादोहर
Guatemala	ग्वाटेमाला
Ambika	अंबिका
Bahrain	बहरीन
Talon	टेलॉन
Bhadravati	भद्रावती
Maitree	मैत्री
Jaiwant	जयवंत
To'ere	टोएरे
Lohgad	लोहगढ़
Dvijavahan	द्विजवाहन
Atchafalaya	अटचाफल्या
Akmaal	अकमाल
Baluran	बालुरान
Uzma	उज़्मा
Foch	फॉक
Alhad	आल्हाद
Kameng	कामेंग
Bansee	बंसी
Johar-E-Shamsheer	जौहर-ए-शमशीर
Bilva	बिल्व
Geranium	जेरेनियम
Tijuca	तिजुका
Vinny	विन्नी
Dhinoj	धिनोज
Kuhaylah	कुहयलाह
Pandey	पांडे
Kanika	कनिका
Ferdinand	फर्डीनांड
Scrots	स्क्रॉट्स
Prisca	प्रिस्का
Avalon	एवलॉन
Brown	ब्राउन
Meerut	मेरठ
Aashaa	आशा
Luce	ल्यूस
Rajeshwar	राजेश्वर
Nakodar	नकोदर
Ibthaj	इब्थज
Whitcomb	व्हाइटकॉम्ब
Baheri	बहेरी
Devayush	देवयश
Chengalpattu	चेंगलपट्‍टु
Bilwai	बिल्वाई
Haddad	हद्दाद
Vineeta	विनीता
Magroor	मगरूर
Ibhaanan	इभानन
Jumaynah	जुमयनाह
Fionnuala	फियोन्यूएला
Rajhans	राजहंस
Megara	मेगरा
Izhaar	इज़हार
Raadhikaa	राधिका
Sekere	सेकरे
Mahavat	महावत
Dushmani	दुश्मनी
Richelle	रिशेल
Jihad	जिहाद
Dhawan	धवन
Almas	अल्मस
Farandole	फैरेनडोल
Pratishtha	प्रतिष्ठा
Sach	सच
Yauvani	यौवनी
Golconda	गोलकोंडा
Labib	लबीब
CISCO	सिस्को
Reynolds	रेनॉल्ड्स
Sohani	सोहनी
Muqtasid	मुक़्तसिद
Ramanuj	रामानुज
Ajradaah	अजरदाह
Rukhsat	रुख़सत
Madhumaan	मधुमान
Na'il	नाइल
Valentine	वैलेंटाइन
Azahar	अज़हर
Sherman	शेर्मन
Multani	मुल्तानी
Amolak	अमोलक
Tohda	टोहड़ा
Qutb	क़ुत्ब
Livingstone	लिविंगस्टोन
Maalik	मालिक
Ladwa	लाडवा
Shilpita	शिल्पिता
Pratighat	प्रतिघात
Dausa	दौसा
Wuankara	वुआनकारा
Tasman	टास्मान
Gunah	गुनाह
Jerrica	जेरिका
Kalchakra	कालचक्र
Virdi	विरदी
Malda	मालदा
Didier	डिडिएर
Tarun	तरुण
Silvain	सिल्वैन
Hamidieh	हैमीडीह
Aalap	आलाप
Bheema	भीमा
Tudor	ट्यूडर
Shams	शम्स
Mandy	मैंडी
Gurudas	गुरुदास
Bhatkar	भाटकर
Paige	पैगे
Rapti	राप्ती
Mandu	मांडू
Aoulakh	औलख
Louise	लुइस
Kalahari	कलहारी
Bundesverdienstkreuz	बूंदेस्वेरदींस्तक्रुज़
Jathhar	जठार
Timor	तिमोर
Shrikumar	श्रीकुमार
Mekhala	मेखला
Abbaas	अब्बास
Pencilina	पेंसिलिना
Shireen	शिरीन
Hubba	हब्बा
Bakarah	बकराह
Arche	आर्क
Aldan	एल्डन
Chobe	कोबे
Molybdenum	मॉलिब्डेनम
Hayfa	हैफा
Gerry	गेरी
Saoirse	सेओइर्स
Mark	मार्क
Vipin	विपिन
GlaxoSmithKline	ग्लैक्सोस्मिथक्लाइन
Bhaaskar	भास्कर
Ahankaar	अहंकार
Takle	टकले
Sweety	स्वीटी
Valsad	बलसाड
Anirudha	अनिरुद्ध
Pendse	पेंडसे
Raadhaa	राधा
Knud	कनुद
Prabhrup	प्रभ्रुप
NELCO	नेल्को
Majdi	मज्दी
OpenTV	ओपन टीवी
Amirah	अमिराह
Mainpuri	मैनपुरी
Primo	प्रिमो
Arlo	अर्लो
Naeema	नईमा
Dongare	डोंगरे
Sugandhi	सुगंधि
Tungabhadra	तुंगभद्रा
Aurum	ऑरम
Katadare	काटदरे
Keshat	केशत
Vanhi	वान्ही
Bhattu	भट्‍टु
Leela	लीला
Rolta	रोल्टा
Nandikar	नन्दीकर
Falgun	फाल्गुन
Cecilia	सेसिलिया
Rangnathar	रंगनाथार
Gratia	ग्रेटिया
Najeeb	नजीब
Eeshvar	ईश्वर
Prabal	प्रबल
Achalaapati	अचलापति
Bheelwada	भीलवाडा
Shafiqah	शफीकाह
Kawthar	कवठार
Dillan	डिलैन
Dasharathi	दशरथी
Dillon	डिलन
Waelhem	वेलहेम
Gizela	गिज़ेला
Aabhaa	आभा
Dobro	डॉबरो
Bahiyudeen	बहियुद्दीन
Alethea	एलेथिया
Dibang Valley	दिबंगवैली
Arianna	एरियाना
Ayyaash	अय्याश
Patsy	पैट्सी
Lilika	लिलिका
Commando	कमांडो
Sybil	सिबिल
Srisailam	श्री शैलम
Narsimha	नरसिम्हा
Amory	एमोरी
Erno	एर्नो
Achindr	अचिंद्र
Lochan	लोचन
Udhampur	ऊधमपुर
Coyle	कॉयल
Geoffrey	ज्यॉफ्री
Krisalyn	क्रिसलिन
Kaethe	केथी
Hamra	हामरा
Hajrah	हजराह
Tawqir	तौकीर
Martand	मार्तंड
Deandra	डिएण्ड्रा
Pranati	प्रणति
Chaad	चाड
Daisy	डेजी
Parindra	परिंद्र
Hencoate	हेनकोट
Sharan	शरण
Johnson	जॉनसन
Boxer	बॉक्सर
Aetna	एट्ना
Thornton	थोरंटन
Bapatla	बापत्ला
Jasoos	जासूस
Adityavardhan	आदित्यवर्धन
Bagevadi	बागेवदी
Cosette	कोसेट
Astrazeneca	एस्ट्राज़ेनेका
Meenaa	मीना
Maneeshaa	मनीषा
Swapna	स्वप्ना
Barh	बार्ह
El-zarka	अल-ज़र्का
Maiyaa	मैया
Zia	ज़िया
Tokantins	टोकनटिंस
Swaroopa	स्वरूपा
Wickers	विकर्स
Mokokchung	मोकोकचुंग
Ilse	इल्सी
Bankura	बांकुरा
Darrell	डैरेल
Maharnav	महार्नव
Sidney	सिडनी
Sumter	सम्टर
Goudy	गॉडी
Batuque	बैट्यूक
Mahabal	महाबल
Deepamala	दीपमाला
Khallad	खल्लाद
Tirupparamkunram	तिरुप्पराम्कुंरम
Subrat	सुब्रत
Kodgu	कोडगू
Dhavlikar	ढवलीकर
Morela	मोरेला
Arub	अरुब
Renu	रेणु
Arib	अरीब
Guilford	गल्फोर्ड
Manmayi	मन्मयी
Pradyot	प्रद्योत
Arab	अरब
Paddi	पद्दी
Kaaleecharan	कालीचरण
Labangalata	लबंगलता
Angaraj	अंगराज
Otto	ओटो
Tamas	टामस
Aderyn	एडरिन
Laalamani	लालमणि
Shannon	शेन्नॉन
Augustus	ऑगस्टस
Bisla	बिस्ला
Valtina	वेल्टीना
Bisle	बिस्ले
Ectel	एक्टेल
Rohit	रोहित
Anant	अनंत
Wardah	वर्दाह
Shaqeeqah	श़की़काह
Sultani	सुल्तानी
Ghanauli	घनौली
Prema	प्रेमा
Rodney	रॉडनी
Dudhwakhara	दुधवाखरा
Anasah	अनसाह
Gosavi	गोसावी
Iodine	आयोडीन
Terribile	टेरिबल
Deshalpar	देशलपर
Melia	मेलिया
Nashit	नाशित
Kupwada	कुपवाड़ा
Venu	वेणु
Gyaanaprakaash	ज्ञानप्रकाश
Kiefer	कीफर
Laramie	लारामी
Pitt	पिट
Rahat	राहत
Khuddar	खुद्दार
Roger	रॉजर
Rik	रिक
Agostino	एगोस्तिनो
Mradul	मृदुल
Queens	क्वीन्स
Indonesia	इंडोनेशिया
Supriya	सुप्रिया
Zeya	ज़ेया
Amaatullah	अमातुल्लाह
Esam	इसाम
Satya	सत्या
Fawzan	फावज़ान
Vermont	वर्मोंट
Saluin	सालुइन
Saidah	सैदह
Shivaa	शिवा
Prakat	प्रकट
Tin	टिन
Chandok	चंडोक
Tim	टिम
Gadagad	गदगद
Shivaraam	शिवराम
Gordy	गॉर्डी
Dilruba	दिलरुबा
Khuraymah	खुरायमाह
Saahas	साहस
Kanpur	कानपुर
Mainak	मैनक
Refugee	रेफ्युजी
Chandawal	चंदावल
Aalim	आलिम
Yashila	यशीला
Citigroup	सिटीग्रुप
Akarshan	आकर्षण
Vin	विन
Vij	विज
Maadrey	माद्रेय
Ringhe	रिंगे
Rujul	रुजुल
Charis	चैरिस
Goverdhan	गोवर्धन
Milwaukee	मिलवॉकी
Sulakshana	सुलक्षणा
Charas	चरस
Arne	एर्ने
Carborundum	कॅरबॉरंडम
Fiorello	फियोरेलो
Nagarkar	नगरकर
Obayashi	ओबयाशी
Norma	नोर्मा
Marvin	मर्विन
Jasper	जैस्पर
Azaadeh	अज़ादेह
Paraas	परास
Bijli	बिजली
Ronia	रोनिया
Panesar	पनेसर
Jeevankala	जीवनकला
Diplana	दिपलाना
Oriana	ओरिआना
Achand	अचंद
Anthea	एंथिया
Him	हिम
Edalene	ईडेलेन
Bellsouth	बेलसाउथ
Bluenose	ब्लूनोज
Vilmaris	विल्मेरिस
Shabri	शबरी
Mukaam	मुकाम
Lancaster	लैनकेस्टर
Rajdhani	राजधानी
Anuhya	अनुह्या
Pakkhoke	पक्खोके
Abjit	अब्जित
Monish	मोनिश
Vaageeshvar	वागीश्वर
Erie	एरी
Agartala	अगरतला
Larnaca	लारनेका
Ellamanchili	इलामनचिली
Shahanshaah	शहंशाह
Otis	ओटिस
Sarojani	सरोजनी
Geodesic	जियोडेसिक
Liv	लिव
Shamoodah	शमूदाह
Balaraam	बलराम
Liz	लिज़
Chipanecas	चीपैनकास
Banga	बंगा
Everly	एवरली
Badhada	बाधड़ा
Sowani	सोवानी
Haidar	हैदर
Ikram	इकराम
Valora	वेलोरा
Score	स्कोर
Jovianne	जोविएन
Heer	हीर
Manoram	मनोरम
Gothaj	गोथज
Luthando	लुथेन्डो
Sawsan	सौसन
Tripuri	त्रिपुरी
Dildar	दिलदार
Keiran	कैरन
Vega	वेगा
Ranthambor	रणथंबोर
Larsen	लारसेन
Abhilaasha	अभिलाषा
Aahwanit	आह्वानित
Lenore	लेनोर
Arpitaa	अर्पिता
Drummond	ड्रमॉन्ड
Guntur	गुन्टूर
Demu	डेमु
Ameena	अमीना
Miles	मिलेस
Navathye	नवाथ्ये
Ujaalaa	उजाला
STAR	स्टार
Lokeshvar	लोकेश्वर
Hera	हीरा
Dharnaoda	धरनौदा
Promethium	प्रोमीथियम
Nell	नेल
Kalra	कालरा
Anpadh	अनपढ़
Mutatkar	मुटाटकर
Raisen	रायसेन
Tolstoy	टॉलस्टॉय
Sekhon	सेखोन
Ramya	रम्या
Dohollah	दोहोल्लाह
Lear	लीयर
Shirina	शिरिना
Weylin	वेलिन
Carolos	करोलोस
Malikah	मलिकाह
Indra	इंद्रा
Kutch	कच्छ
Ashivan	अशिवन
Devvrat	देवव्रत
Gryta	ग्रीटा
Bitragunta	बित्रागुंटा
Kyushu	क्यूशू
WORLDWIDE	वर्ल्डवाइड
Koryak	कोर्याक
Tapan	तपन
Darcie	डेर्सी
Dhulghat	धुलघाट
Omar	ओमार
Amurt	अमूर्त
Giraj	गिरज
Shameem	शमीम
Fluorine	फ्लोरीन
Muhajir	मुहाजिर
Swati	स्वाति
Sudeshna	सुदेषणा
Lesa	लेसा
Milt	मिल्ट
Shekhpura	शेखपुरा
Seemantini	सीमांतिनी
Taran	तारन
Purnanad	पूर्णनाद
Murari	मुरारी
Dwijaraj	द्विजराज
Muazah	मुआज़ा
Nirupama	निरूपमा
Chabbra	छाबड़ा
Talhah	तलहाह
Kawala	कावला
Vaishampayan	वैशम्पायन
Laalakamal	लालकमल
Sundar	सुन्दर
Voltas	वोल्टास
Deol	देओल
Juliette	जूलिएट
Colista	कोलिस्टा
Patang	पतंग
Gundardehi	गुणदरदेही
Bhajan	भजन
Kularanjan	कुलरंजन
Cliff	क्लिफ
Noori	नूरी
Manohar	मनोहर
Pratapgarh	प्रतापगढ़
Dhanakya	धनक्या
Fiat	फ़िएट
Deliz	डेलिज़
Deepashikha	दीपशिखा
Hemaraaj	हेमराज
Jarood	जरूद
Fedora	फेडोरा
Mercury	मर्क्यूरी
Ujjain	उज्जैन
Shikarpuri	शिकारपुरी
Endeavour	एण्डीवर
Jacada	जकाडा
Patralekha	पत्रलेखा
Vajraachaary	वज्राचार्य
Gayda	गयदा
Gunja	गुंजा
Denis	डेनिस
Chloris	क्लोरिस
Nakhat	नखत
Taqat	ताकत
Cresud	क्रेसुद
Materia	मटेरिआ
Darnell	डार्नेल
Azaraqi	अज़राकी
Waverly	वेवरलूी
Burdes	बर्डेस
Haridwar	हरिद्वार
Manmani	मनमानी
Ajooba	अजूबा
Electrolux	इलेक्ट्रोलक्स
Avyakt	अव्यक्त
Janeeva	जनीवा
Giriraaj	गिरिराज
Nasif	नसीफ
Teesta	तीस्ता
Clemens	क्लेमेंस
Riyasat	रियासत
Waldron	वाल्ड्रन
Mena	मेना
Barqi	बर्कि
Atri	अत्रि
Kaushalya	कौशल्या
Nasir	नासिर
Deva	देवा
Anupam	अनुपम
Adyan	अद्यान
Thermosphere	थर्मोस्फीयर
Pepin	पेपिन
Kaushal	कौशल
Kintan	किंतन
Bankim	बंकिम
Vanamala	वनमाला
Voltaire	वॉल्टेअर
Azaraqee	अज़राकी
Genevieve	जेनेवीव
Ajnabi	अजनबी
Klyuchevskaya	क्लुचेबस्क्या
In'am	इनआम
Abhr	अभ्र
Mastani	मस्तानी
Raajavraksh	राजवृक्ष
Karnik	कार्णिक
Duilio	डुईलियो
Balagovind	बालगोविंद
Rue	रू
Gatita	गतिता
Azra	अज़्रा
Awaragardi	आवारागर्दी
Balipara	बलीपारा
Trieste	ट्रिस्टे
Dakor	दाकोर
Football	फुटबॉल
Algawan	अल्गावन
Takiuddeen	तकिउद्दीन
Jignesh	जिग्नेश
Yogee	योगी
Sneha	स्नेहा
Nityanand	नित्यानन्द
Chattarpur	छतरपुर
Bratsk	ब्रत्स्क
Tasnim	तस्नीम
Advaki	अद्‍वाकी
Raakhee	राखी
Gydan	ग्यडान
Jupiter	ज्यूपिटर
Edwin	एडविन
Ghulam	ग़ुलाम
Alniya	अलनिया
Tariqah	तारि़काह
Milton	मिल्टन
Diwankhavati	दिवानखवाती
Ajay	अजय
Madras	मद्रास
Achhut	अछूत
Chukchi	चुकाची
Kaaran	कारण
Gadwal	गड़वाल
Ulfah	उल्फाह
Nadia	नादिया
Anchoret	एन्कोरेट
Maharashtra	महाराष्ट्र
Singha	सिंघा
Ratnesh	रत्नेश
Maalaakaar	मालाकार
Bundalbaaz	बंडलबाज़
Sidonia	सिडोनिया
Karamdata	करमदाता
Kosi	कोसी
Alphonse	अल्फोंसे
Avak	एवाक
Singaar	सिंगार
Gurbachan	गुरबचन
Stevens	स्टीवन्स
Rekhaa	रेखा
Alaina	एलैना
Aniarapriset	अनायराप्राइसेट
Passport	पासपोर्ट
Suparn	सुपर्ण
Surdas	सूरदास
Suffren	सफ्रेन
Azraqi	अज़राकी
Roomal	रुमाल
Bhadaura	भदौरा
Neurochem	न्यूरोकेम
Indraprastha	इंद्रप्रस्थ
Jogi	जोगी
Aidh	ऐध
Wawona	ववोना
Albina	अल्बिना
Umang	उमंग
Clementine	क्लेमेंटाइन
Chirayinkil	चिरायिंकिल
Escondido	एस्कोनडिडो
Lander	लैंडर
Latika	लतिका
Raagini	रागिनी
Therese	थेरेस
Liers	लियर्स
Angarikaa	अंगारिका
Aurelia	ऑरेलिया
Ujagar	उजागर
Kuberchand	कुबेरचंद
Caradoc	कारडोक
Peace	पीस
Bichpuri	बिचपुरी
Fenella	फेनेला
Kamana	कामना
Kirtinasha	कीर्तिनाशा
Avanindar	अवनिंदर
Qiagen	क्विएज़न
Ziazan	ज़िआज़न
Algiers	अल्जीयर्स
Vincent	विनसेंट
Makkad	मक्कड़
Janmabhoomi	जन्मभूमी
Nafis	नफीस
Pramit	प्रमित
Saibah	सैबाह
Andhera	अंधेरा
Bolangir	बोलनगीर
George	जॉर्ज
Altamaha	अल्तमाहा
Alaric	अलैरिक
Davidson	डेविडसन
Lipi	लिपि
Amaradhip	अमराधिप
Krona	क्रोना
Ayushmati	आयुष्मति
Batra	बत्रा
Dhadial	ढडियाल
Bhindra	भिंडरा
Awatif	अवातिफ
Tawqeer	तौकीर
Vijayaa	विजया
Chahal	चहल
Deviprasad	देवीप्रसाद
Bandugar	बंडूगर
Samar	समर
Kanti	कांति
Chhugani	छुगनी
Pakhewal	पखेवाल
Hibernia	हिबर्निया
Kanta	कांता
Chanderiya	चंदेरिया
Didwana	डिडवाना
Adway	अद्वय
Gisela	गिसेला
Oud	औद
Sajan	सजन
Nalin	नलिन
Deanna	डिएना
Bhadohi	भदोही
Hempstead	हेम्पस्टेड
Zanna	ज़ैना
Bhoke	भोक
Abhaynandaa	अभयनन्दा
Tawfeeq	तौफीक
Siskiyou	सिस्कियो
Akeef	अकीफ
Lilac	लिलेक
Makhani	मखानी
Karunakar	करुणाकर
Lawrencia	लॉरेंसिया
Valli	वल्ली
Fleta	फ्लेता
Sorcha	सोर्चा
Dakshari	दक्षारी
Bhanesh	भानेश
Darban	दरबान
Gunda	गुंडा
Mills	मिल्स
Annabelle	अन्नाबेली
Sealey	सीले
Ammarah	अम्मराह
Umeed	उम्मीद
Forbesganj	फोर्ब्सगंज
Achalendra	अचलेंद्र
Rochelle	रोशेल
Haleef	हलीफ
Langston	लैंगस्टन
Moti	मोती
Manish	मनीष
Vitankar	विटणकर
Baske	बस्के
Balasor	बालासोर
Guddi	गुड्डी
Thatcher	थैचर
Lakhanpal	लखनपाल
Munna	मुन्ना
Shaunna	शॉना
Dori	डोरी
Tikamgarh	टीकमगढ़
Congregation	कॉन्ग्रेगशन
Fitness	फिटनेस
Sodium	सोडियम
Bandera	बैंडेरा
Kuldeep	कुलदीप
Seymour	सेमूर
Radhika	राधिका
Jarana	जराना
Mahish	महिश
Rhodium	रॉडियम
Dhriti	धृति
Drijhoek	ड्रिजहोएक
Sibson	सिब्सन
Kynton	किंटन
Jaureguiberry	जॉर्ग्यूबैरी
Sannata	सन्नाटा
Uday	उदय
Marigold	मैरीगोल्ड
Supervalu	सुपरवैल्यू
Samyak	सम्यक
Lauderdale	लॉडर्डेल
Amritsar	अमृतसर
Zurna	ज़ुर्ना
Dua	दुआ
Sadhan	साधन
Krishnendu	कृष्णेंदु
Prabhmeet	प्रभमीत
Dabtara	दबतारा
Mekhalin	मेखलिन
Swimming	स्विमिंग
Saarang	सारंग
Adwaaki	अद्‍वाकी
Sitaanshuk	सितांशुक
Chas	चैस
Waqar	व़कार
Anantpur	अनन्तपुर
Dinesh	दिनेश
Bhaarat	भारत
Saharanpur	सहारनपुर
Ehren	एहरेन
Nizambad	निजामबाद
Shaili	शैली
Beguine	बेजूइन
Moles	मॉल्स
Bhimana	भिमाना
Bhairavi	भैरवी
Abhilashaa	अभिलाषा
Kalanidhi	कलानिधि
Wyeth	विथ
STATS ChipPAC	स्टेट्सचिपपैक
Premanaaraayan	प्रेमनारायण
Marukar	मरुकर
Dhamangaon	धमनगांव
Aalaap	आलाप
Raleigh	रेलिघ
Masumah	मासूम
Guruvayur	गुरुवयूर
Sonakshi	सोनाक्षी
Bekhbar	बेखबर
Jainarayan	जयनारायण
Viplaav	विप्लाव
Mineshvar	मिनेश्वर
Jethani	जेठानी
Khera	खेरा
Julie	जूली
Anoush	एनोश
Julia	जूलिया
Drafts	ड्राफ्ट्‍स
Cincinnati	सिनसिनाटी
Commander	कमांडर
Waseemah	वज़ीमाह
Clarence	क्लारेंस
Somkanta	सोमकांता
Bhrashtachar	भ्रष्टाचार
Imms	इम्स
Mutha	मुठा
Apoorv	अपूर्व
Jennica	जेनिका
Ashaa	आशा
Theola	थियोला
Pratosh	प्रतोश
Mangalsutra	मंगलसूत्र
Shradhanjali	श्रद्धांजलि
Manasvee	मनस्वी
Kevalkishore	केवलकिशोर
Dhanera	धनेरा
Rasika	रसिका
Norman	नॉर्मन
Dhekne	ढेकणे
Majahab	मजहब
Bhimal	भीमल
Avtaar	अवतार
Dehrabad	देहराबाद
Ceram	सेरम
Yaachit	याचित
Triveni	त्रिवेणी
In_drajeet	इन्द्रजीत
Linaeve	लिनाएव
Jivin	जिविन
Jalaput	जालापुत
Khatavkar	खटावकर
Leighna	लैग़ना
Foudre	फॉडर
Avaneendra	अवनींद्र
Bedreddin	बेद्रेद्दीन
Talakkad	तलक्कड
Ankola	अंकोला
Aadarsh	आदर्श
Amitiyoti	अमितियोति
Manchali	मनचली
Cesar	केसर
Vedavyaas	वेदव्यास
Glatton	ग्लैटन
Renata	रेनाटा
Balachandra	बालचंद्र
Margaux	मारगौक्स
Boisar	बोइसर
Shere-E-Watan	शेर-ए-वतन
Samastipur	समस्तीपुर
Yuvaraaj	युवराज
Waltz	वाल्ट्ज
Krodh	क्रोध
Bulerias	ब्यूलेरियास
Falakata	फलाकता
Kenya	केन्या
Tiruvanantpuram	तिरुवनन्तपुरम
Vijayshree	विजयश्री
Jalabala	जलबाला
Lalitchandra	ललितचंद्र
Leelaaraam	लीलाराम
Vadan	वदन
Periyar	पेरियार
Shilpa	शिल्पा
Sulalita	सुललिता
Donnelly	डोनली
Shrilekha	श्रीलेखा
Eenadu	इनाडू
Dibrugarh	डिब्रुगढ़
Lalita	ललिता
Fort-de-france	फोर्ट-डे-फ्रांस
Sanjana	संजना
Mahadevi	महादेवी
Pankaj	पंकज
Philadelphia	फिलाडेल्फ़िया
Tazwell	टैज़वेल
Greta	ग्रेटा
Navroz	नवरोज़
Cherry	चेरी
Akhlaaq	अखलाक
Baitarani	वैतरणी
Dollar	डॉलर
Babupeth	बाबूपेठ
Grace	ग्रेसन
Rituparan	ऋतुपर्ण
Shripad	श्रीपद
Katrina	कैटरीना
Bandhan	बंधन
Bakht	बख्त
Maurizio	मौरिज़िओ
Faidah	फैदाह
Minna	मिन्ना
Gondhalekar	गोंधलेकर
Sarabdev	सरबदेव
Aanandmayi	आनंदमयी
Waite	वैट
Eddy	एडी
Marva	मर्वा
Ashby	एश्बी
Cemal	केमल
Ekma	इक्मा
Marvi	मारवी
Naach	नाच
Alpanaa	अल्पना
Centex	सेंटेक्स
Hoor	हूर
Mediterranean	मेडिटेरेनियन
Sameera	समीरा
Bhaanumukhee	भानुमुखी
Tirath	तीरथ
Dhritvan	धृतिवान
Achyutray	अच्युतराय
Deabia	डेबिया
Garret	गैरेट
Ajeebaah	अजीबाह
Seemaant	सीमांत
Emas	इमस
Raghad	रगाद
Thadeus	थड्डेअस
Nizzar	निज़्ज़ार
Raajakumaar	राजकुमार
Nancy	नैन्सी
Qabool	क़बूल
Connemara	कोन्नेमारा
Ariane	एरियन
Adriano	एड्रियानो
Louisiana	लूसियाना
Harishchandra	हरीशचंद्र
Suhayb	सुहैब
Andaaz	अंदाज़
Labrador	लेब्राडोर
Optibase	ऑप्टीबेस
Almoda	अल्मोडा
Woodward	वुडवर्ड
Vibhutaa	विभुता
Eldorado	एल्डोरेडो
Yvonne	वॉन्नी
Sahalpur	सहलपुर
Meriel	मेरिएल
Kaneez	कनीज़
Abhinandaa	अभिनन्दा
Arhant	अर्हंत
Germany	जर्मनी
Wilona	विलोना
Jabalpur	जबलपुर
Indumati	इन्दुमति
Doyen	डोएन
Doyel	दोयल
Chesapeake	चेस्पेक
Bhaanuchand	भानुचंद
Shatadru	शतद्रु
Ranganath	रंगनाथ
Kumari	कुमारी
Gibson	गिब्सन
Noor	नूर
Ajitaabh	अजिताभ
Ajwad	अजवाद
Penelope	पेनेलोप
Geoff	ज्यॉफ
Muammar	मुअम्मर
Swapnali	स्वप्नाली
Nandalaal	नंदलाल
Sudhaa	सुधा
Yablonoi	याब्लोनोई
Khosha	खोसा
Sawad	सवाद
Sanchita	संचिता
Surendranagar	सुरेन्द्रनगर
Vinamr	विनम्र
Lavinia	लविनिया
Vilnius	बिल्नियस
Carolyn	कैरोलिन
Sargam	सरगम
Ammasandra	अम्मासंद्रा
Bahaudin	बहाउद्दीन
Julfikar	जुल्फिकार
Adie	एडी
Brady	ब्रैडी
Baahi	बाहि
Bataan	बटान
Tunisia	टुनिशिया
Ulupi	उलुपी
Orava	ओरावा
Terry	टेरी
Kalhan	कल्हण
Tikkekar	टिकेकर
IncrediMail	इंक्रेडिमेल
Aadamkhor	आदमखोर
Bansari	बंसरी
Chitradurg	चित्रदुर्ग
Lanthanum	लैंथनम
Alisa	अलिसा
Shakeel	शकील
Dhaman	धमन
Kamini	कामिनी
Prasoon	प्रसून
Thaqaf	थ़काफ
Aldona	एल्डोना
Fakhirah	फखीराह
Bagha	बाघा
Safwan	सफवान
Ramgadia	रामगड़िया
Sadeed	सदीद
Ahmadnagar	अहमदनगर
Accident	ऐक्सीडेंट
Zareh	ज़ारेह
Khadikar	खडीकर
Kaishori	कैशोरी
Junglee	जंगली
Edie	एडी
Agnija	अग्निजा
Wahban	वाहबान
Aleta	एलेटा
Gitanjali	गीतांजलि
Adalat	अदालत
Veronique	वेरोनिक
Indomptable	इंडोम्टेबल
Coborne	कॉबॉर्न
Raajamani	राजमणि
Aayushmati	आयुष्मति
Raiqah	रैकाह
Rutland	रूटलैंड
Madhumita	मधुमिता
Arafura	अराफुरा
Tansin	तनसिन
Rashad	रशाद
Yogaanand	योगानंद
Dubaha	दुबाहा
Koen	कोएन
Barclays	बरक्लैज़
Sumanolata	सुमनोलता
Mardangi	मर्दांगी
Xanthe	ज़ांथे
Neepa	नीपा
Zoltan	ज़ोल्टन
Gangaaraam	गंगाराम
Zhukov	ज़ूकोव
Thane	ठाणे
Thana	थाना
Apatkaal	आपातकाल
Philips	फ़िलिप्स
Pratik	प्रतीक
Aamirah	आमिराह
Skipper	स्किपर
Pali	पाली
Ormsby	ऑर्मस्बाय
Devnarayan	देवनारायण
Yuyutsu	युयुत्सु
Marcus	मार्कस
Ignatius	इग्नेशियस
Rolando	रोलेन्डो
Ajaad	आजाद
Kiana	कियाना
Farrukh	फारुख
Navare	नवरे
Rippington	रिपिंगटन
Saqi	साकी
Chanpatia	चनपटिया
Sumana	सुमन
Ludhianwi	लुधियानवी
Sharanyu	शरण्यु
Hotton	हॉटॉन
Radi	रादी
Shrilata	श्रीलता
Requinto	रेक्विंटो
Harun	हारून
Hamnah	हम्नाह
Barkat	बरकत
Aloudpuri	अलौदपुरी
Bajarangabalee	बजरंगबली
Romania	रोमानिया
Sujala	सुजला
Pingale	पिंगले
Sabine	सैबिन
Sujaya	सुजया
Naseen	नसीन
Chichagof	चिचागॉफ़
Salish	सालिश
Agaatha	अगाथा
Amol	अमोल
Arissa	एरिसा
Garvey	गार्वी
Garhwal	गढ़वाल
Sheesh	शीश
Itihaas	इतिहास
Vrajabala	व्रजबाला
Haddock	हैडॉक
Dunkerque	डंकर्क्यू
Swadesh	स्वदेश
Rajanee	रजनी
Kopran	कोप्रन
Xongo	ज़ोंगो
Yaasameen	यासमीन
Wafi	वाफी
Vesta	वेस्टा
Dharmanagar	धर्मनगर
Demeter	डिमीटर
Katha	कथा
Sumanah	सुमनाह
Mandelina	मैंडेलिना
Tellurium	टेल्यूरियम
Nanwan	ननवन
Varaj	वरज
Vari	वारी
Gadarwara	गाडरवाड़ा
Klamath	क्लामथ
Makhowal	माखोवाल
Hurdles	हर्डल्स
Taklamakan	तक्लामाकन
Sanatan	सनातन
Gwyneth	ग्वेनथ
Sami	सामी
Yogavati	योगवति
Dyan	डायएन
Khingan	खिंगन
Kailaash	कैलाश
Barkur	बरकर
Imaandar	ईमानदार
Akshitaa	अक्षिता
Quena	क्वेना
Jnyandeep	ज्ञानदीप
Aayush	आयुष
Walihah	वलीहाह
Osric	ओसरिक
Sandhar	संधर
Achaleswar	अचलेश्वर
Softball	सॉफ्टबॉल
Polly	पोली
Jati	जति
Gijare	गिजरे
Gent	गेंट
Indium	इंडियम
Behan	बहन
Bebus	बेबस
Izzatdar	इज्ज़तदार
Quran	कुरान
Shriranjan	श्रीरंजन
Sananda	सानन्द
Qusay	क़ुसय
Gascogne	गैस्कोग्ने
Sanduri	संदूरी
Khare	खरे
Mahotsaah	महोत्साह
Niraj	नीरज
Benbow	बेनबॉ
Believers	बिलिवर्स
Inaam	इनाम
Adrina	एड्रिना
Hochharz	होचार्ज़
Felice	फेलिस
Raan	रान
Bamnia	बमनिया
Rupinder	रूपिन्दर
Murugan	मुरूगन
Bhagwanti	भागवंती
Sadiqah	सदीकाह
Talwarkar	तलवारकर
Fedella	फेडेला
Achyuta	अच्युत
Naseem	नसीम
Spectramind	स्पेक्ट्रामाइंड
Pujita	पूजिता
Dominion	डोमिनियन
Gwendolyn	ग्वेंडोलिन
Gautier	गॉतियर
Cantabrian	केंटांब्रिअन
Jeeva	जीवा
Bhulon	भुलों
Frasier	फ्रेजियर
Taan	तान
Vaageeshvaree	वागीश्वरी
Torie	टोरी
Indal	इंडल
Kimber	किंबर
Biswan	बिसवान
Indrasena	इंद्रसेना
Bakkar	बाकर
Viadhar	विद्याधर
Florida	फ्लोरिडा
Provence	प्रोवेंस
Manoratha	मनोरथा
Karunamayi	करुणामयी
Alakanandaa	अलकनंदा
Snehalata	स्नेहलता
Cook	कुक
Taruna	तरुणा
Fishing	फिशिंग
Astro	एस्ट्रो
Chess	चेस
Kanjan	कंजन
Arivoli	अरिवोलि
Balawant	बलवंत
Prachetas	प्रचेतस
Shriprakash	श्रीप्रकाश
Kallol	कल्लोल
Payasvinee	पयस्विनी
Guraia	गुरइया
Cadi	कैडी
Raajamuni	राजमुनि
Dulrasar	दलरासर
Kanakpriya	कनकप्रिया
Tacy	टेसी
Banjaran	बंजारन
Giddarbaha	गिद्दरबहा
Shu'aa	शुआ
Exmouth	एक्समाउथ
Kismatwali	किस्मतवाली
Kamajit	कामजित
Thiruvazhunthoor	तिरुवाज़ुन्थूर
Kanwal	कंवल
Farz	फर्ज़
Konkar	कोनकर
Mednipur	मेदनीपुर
Eastland	ईस्टलैंड
Balvan	बलवान
Mani	मणि
Triguni	त्रिगुणी
Neelabja	नीलाब्जा
Lambert	लैबर्ट
Jaan	जान
Dani	दानी
Aral	अरल
Palki	पालकी
Dorcas	डॉर्कस
Utsaah	उत्साह
Qanit	क़ानित
Amoha	अमोह
Ashant	अशांत
Eavan	इवान
Gilda	गिल्डा
Oadira	ओआदिरा
Manoranjan	मनोरंजन
Yuktaa	युक्ता
Sienna	सिएना
Rupaiya	रुपैया
Fadeelah	फदीलाह
Chiraagh	चिराग़
Taryn	टैरिन
Iliamna	लियाम्ना
Bachwara	बचवारा
Apraa	अपरा
Bhau	भाउ
Mitti	मिट्टी
Banajit	बनजित
Saeedah	सईदाह
Gumman	गुमन
Dhodhar	ढ़ोधर
Santoor	संतूर
Pimpalkhare	पिंपलखरे
Silver	सिल्वर
Darve	दर्वे
Alvin	एल्विन
Jimuta	जिमुता
Selenium	सेलेनियम
Theresa	थेरेसा
Dolly	डॉली
Lakshmi	लक्ष्मी
Aanchal	आँचल
Indubhav	इन्दुभव
Dikshapal	दिक्षपाल
Suvaas	सुवास
Mangesh	मंगेश
Shrinivas	श्रीनिवास
Mahant	महंत
Nilay	निलय
Malamaal	मालामाल
Simpson	सिंपसन
Sirmaur	सिरमौर
Chelsa	चेल्सा
Ambareesh	अंबरीश
Chirawa	चिड़ावा
Elham	इलहाम
Jashpur	जशपुर
Rakhdian	रखड़ियाँ
Trixie	ट्रिक्सी
New Zealand	न्यूज़ीलैंड
Elias	इलियास
Prasad	प्रसाद
Hoche	हॉक
Dhansukh	धनसुख
Yaounde	याउंडे
Anjhi	अंझी
Lacy	लेसी
Gangaa	गंगा
Metro	मेट्रो
Divorce	डाइवोर्स
Gomer	गोमर
Tumucumaque	तुमुकुमाक
Tango	टैंगो
Satish	सतीश
Jagdeep	जगदीप
I^dukaant	इंदुकांत
Bareta	बरेटा
Meghamala	मेघमाला
Dhanwan	धनवान
Yashodhan	यशोधन
Zoe	ज़ोए
Padmal	पद्मल
Mubassir	मुबस्सिर
Katkar	काटकर
Chikmangloor	चिकमंगलूर
Eagle	ईगल
Mandan	मंडन
Bridger	ब्रिजर
Gumnaam	गुमनाम
Fidel	फिडेल
Shaqeeq	शकीक
Mann	मान
Anubhav	अनुभव
Cosmo	कोस्मो
Lavada	लवेडा
Arati	आरती
Mirashi	मिराशी
Dhumravarn	धुम्रवर्ण
Sunoco	सनोको
Farihah	फरीहाह
Kaliyan	कलियाँ
Walter Scott	वॉल्टरस्कॉट
Guiliaine	गुइलिएन
Sandesha	संदेशा
Ambedkarnagar	अम्बेडकरनगर
Qameer	कमीर
Valeureuse	वैलेरेउस
Kara-Kum	काराकुम
Shadi	शैदी
Devadutt	देवदत्त
Twensang	त्वेनसांग
Siddheshwar	सिद्धेश्वर
Fawn	फॉन
Ghaith	गैथ
LondonHeathrow	लंदन हीथ्रो
Dextra	डेक्स्ट्रा
Bendre	बेंद्रे
Amjad	अमजद
Malcolm	माल्कम
Copernicus	कॉपरनिकस
Lucie	ल्यूसी
Lucia	ल्यूसी
Conley	कोनली
Kalimba	कालिम्बा
Veneer	वेणीर
Lokranjan	लोकरंजन
Jitamitra	जितमित्रा
Majboori	मजबूरी
Binata	बिनता
Ekchari	इकचरी
Manimala	मणिमाला
Abbasi	अब्बासी
Chawla	चावला
Manjira	मंजिरा
Tess	टेस
Faridah	फरीदाह
Babbar	बब्बर
Rowena	रोवेना
Saaransh	सारांश
Maitraavaruni	मैत्रावरुणि
Nazraana	नज़राना
Cloris	क्लोरिस
Whitby	व्हिटबी
Gajanand	गजानन्द
Sister	सिस्टर
Alain	अलैन
Armina	आर्मीना
Som	सोम
Nairana	नैराना
Archimedes	आर्किमिडीज़
Indravishnu	इंद्रविष्णु
Mahmi	माहमी
Halim	हलीम
Rama Lingeshwara	रामालिंगेश्वर
Ruchira	रुचिरा
Kaalanjay	कालंजय
Qatar	कतर
Xanti	ज़ेंटी
Shrigeeta	श्रीगीता
Meghdutt	मेघदत्त
Rod	रॉड
Roy	रॉय
Kartik	कार्तिक
Fiddah	फिदाह
Neelkamal	नीलकमल
Halimah	हलीमाह
Maadhuree	माधुरी
Mansur	मंसूर
Khalifah	खलिफाह
Hadiyah	हदियाह
Danka	डंका
Giulio	गिउलिओ
Qutaylah	कुतयलाह
Maida	मैडा
Letitia	लेटीशिया
Samudragupta	समुद्रगुप्त
Tom	टौम
Baddhan	बद्धण
Antimony	एंटीमनी
Addison	एडिसन
Allstate	ऑलस्टेट
Walter	वाल्टर
Coligny	कोलिग्नी
Gracie	ग्रेसी
Bilqis	बिल्किस
Lucrece	ल्यूक्रेस
Nakshatra	नक्षत्र
Painleve	पेनलीव
Won	वॉन
Sankalpa	संकल्पा
Jetta	जेट्टा
Terrian	टेरियन
Dhaka	ढाका
Irai	इराय
Mustaneer	मुस्तनीर
Bheede	भीड़े
Iha	इहा
Sitamgar	सितमगर
Ebony	ईबोनी
Yadvinder	यदविंदर
Subhagya	सुभाग्या
Mehsaana	मेहसाना
Nelson	नेल्सन
Hajjaj	हज्जाज
Khattda	खट्टड़ा
Gajakarna	गजकर्ण
Shat-al-Arab	शत-अल-अरब
Gianna	गियाना
Gopinath	गोपीनाथ
Chitkala	चितकला
Ghumar	घूमर
Induleksh	इन्दुलेक्ष
Bombo	बॉम्बो
Pixelplus	पिक्सेलप्लस
Race	रेस
Harad	हरड़
Dharmendu	धर्मेंदु
Balkhash	बलखश
Cobra	कोबरा
Gaetano	गैटेनो
Gaetana	गायतेना
Jayshree	जयश्री
Gaetane	गाएतेन
Ekavali	एकावली
Oregon	ओरेगन
Rohanlal	रोहनलाल
Bhise	भिसे
Cape Town	केपटाउन
Bal Krishna	बालकृष्णा
Jagadishvan	जगदीशवान
Jivitesh	जिवितेश
Sunanda	सुनन्दा
Kalirai	कालीराई
Qatil	कातिल
Baaligh	बालिग
Makhtooma	मख्तूमा
Peetaa	पीता
Howrah	हावड़ा
Pimparikar	पिंपरीकर
Khulaybah	खुलयबाह
Fajr-E-Islam	फज्र-ए-इस्लाम
Paris	पेरिस
Tare	तारे
Joy	जॉय
Kothe	कोठे
Wade	वेड
Bhawabhooti	भवभूति
Muktaa	मुक्ता
Eskalis	ऐसकाइलस
Mahaan	महान
Atuly	अतुल्य
Arunpriya	अरुणप्रिया
Glen	ग्लेन
Khiladi	खिलाड़ी
Hamajoli	हमजोली
Piratenpriset	पाइरैटनप्राइसेट
Randilyn	रैंडिलिन
Attariwala	अट्टारीवाला
Jibran	जिब्रान
Venkateshwar	वेंकटेश्वर
Pranjivan	प्राणजीवन
Lou	लाऊ
Sudha	सुधा
Nishan	निशान
Nicki	निक्की
Anakapalle	अनाकापल्ले
Gothenburg landvetter	गॉथेनबर्ग-लेंडवेटर
Tonback	टोनबैक
Saakshi	साक्षी
Ashtkarna	अष्टकर्ण
Canyon	केन्यॉन
Nidhi	निधि
Arvi	अर्वी
Beas	ब्यास
Abyad	अब्याद
Asnoti	अस्नोती
Kouchibouguac	कोउचीबोगुआक
Keefer	कीफर
Suren_dar	सुरेन्दर
Malkauns	मालकौंस
Chill	चिल
Toofan	तूफान
Manzana	मंज़ाना
Mohita	मोहिता
Purba	पूर्बा
Enya	एन्या
Ethiopian	इथियोपियन
Pinakin	पिनाकिन
Spence	स्पेंस
Suchi	सुचि
Lalitamohana	ललितमोहन
Megan	मेगन
Commerzbank	कॉमर्ज़बैंक
Nicosia	निकोसिया
Romeo	रोमियो
Jhajjar	झज्जर
Dakha	दाखा
Chitrawad	चित्रवाड़
Baikunthpur	बैकुंठपुर
Bharatpur	भरतपुर
Roden	रोडन
Rodeo	रोडियो
Bengali	बंगाली
Balasore	बालासोर
Cox	कॉक्स
Virgo	वर्गो
Mobile	मोबाइल
Rajgarh	राजगढ़
Safoorah	सफूराह
Jaidayal	जयदयाल
Beaverhead	बेवर्हेड
Loncin	लिन्सिन
Agent	एजेंट
Lalana	ललना
Serengeti	सेरेंगेती
Jovan	जोवन
Radico	रैडिको
Inkaar	इंकार
Janasah	जनसह
Radhesh	राधेश
Preet	प्रीत
Neelanjana	नीलांजना
Pam	पाम
Daaku	डाकू
Jacqueline	जैकलिन
Jorn	जोर्न
Parthivi	पर्थिवी
Dot	डॉट
Conlan	कोनलैन
Alaknandaa	अलकनंदा
Don	दॉन
Hayah	हयाह
Protherics	प्रोथेरिक्स
Vidyashankar	विद्याशंकर
Irish	आयरिश
Sal	सल
Murshidabad	मुर्शिदाबाद
Amandeep	अमनदीप
Rianna	रियान्ना
Bhagyawati	भाग्यवती
Kushal	कुशल
Saz	साज़
Bhupalsagar	भूपलसागर
Geetanjali	गीतांजलि
Fanish	फणीश
Meghalaya	मेघालय
Belampalli	बेलमपाली
Menai	मेनाई
Raj	राज
Kohli	कोहली
Rewadikar	रेवाड़ीकर
Fox	फॉक्स
Sardinia	सार्दिना
Wellman	वेलमेन
Qabeel	क़बील
Batool	बतूल
Molucca	मोलुक्का
Knoxville	नॉक्ज़विले
Wickerson	विकर्सन
Cate	कैटलिन
Delfina	डेल्फिना
Rahabar	रहबर
Clayland	क्लेलैंड
Pinta	पिंटा
Malloren	मैलोरेन
Arul	अरुल
Gay	गाय
Bhanudas	भानुदास
Dacait	डकैत
Tad	टैड
Lakkhewali	लक्खेवाली
Vanakan_yaa	वनकन्या
Dispur	दिसपुर
Tripti	तृप्ति
Chhaya	छाया
Alaska	अलास्का
Aryaman	आर्यमान
Kapoor	कपूर
Enel	एनल
Avril	एव्रिल
Parameshwari	परमेश्वरी
Ikhlas	इखलास
Doust	डॉस्ट
Vandanaa	वंदना
Egypt	इजिप्त
Nafasat	नफसत
Bhagwati	भगवती
Anastacia	एनेस्टेसिया
Crenshaw	क्रेन्शॉ
Wind River	विंडरिवर
Laith	लइथ
Munimji	मुनीमजी
Duaba	दुआबा
Kermit	केर्मिट
Gale	गैल
Ateli	अटेली
Alakananda	अलकनंदा
Saugandh	सौगंध
Laadla	लाडला
Jundub	जुन्दुब
Gulabhganj	गुलाबगंज
Police	पुलिस
Murshid	मुर्शीद
Tambre	टेम्ब्रे
Frug	फ्रग
Banarhat	बनारहट
Julian	जूलियन
Curtis	कर्टिस
Cynara	सायनारा
Bahir	बहिर
Vanshavardhan	वंशवर्धन
Oamra	ओआमरा
Celeste	सेलेस्टी
Kaz	काज़
Gopikrushna	गोपीकृष्ण
Ma'mun	मैमून
Tulasidas	तुलसीदास
Rhoda	रोडा
Samleshwar	स्यामलेश्वर
Leonard	लियोनार्ड
Neemuch	नीमच
Palashranjan	पलाशरंजन
Maddock	मैडॉक
Shakirah	शकीराह
Tarannum	तरन्नुम
Manamohak	मनमोहक
Paolo	पाओलो
Suvarnarekha	सुवर्णरेखा
Avani	अवनि
Alibagh	अलीबाग
Bahjat	बहजात
Queenie	क्वीनी
Lunglei	लुंगलेई
Durgapura	दुर्गापुरा
Gurtej	गुरतेज
Eleanor	एलिएनर
Sila	सिला
Christiana	क्रिस्टीएना
Leonora	लियोनोरा
Veeresh	वीरेश
Agnikaal	अग्निकाल
Siya	सिया
Bulandshahr	बुलंदशहर
Foolendu	फूलेंदु
Sita	सीता
Monrovia	मोनरोविया
Physiology	फिजियोलॉजी
Johar	जौहर
Viduthalai	व‍िदुथलई
Aakar	आकार
Kalakaar	कलाकार
Svaroopabaaee	स्वरूपबाई
Divyesh	दिव्येश
Garfield	गारफील्ड
Mendhe	मेंढे
Noakes	नोक्स
Tyagarajar	त्यागराजार
Vidyut	विद्युत
Nai	नाइ
Babugarh	बाबूगढ़
Tawang	तवांग
Sukhinder	सुखिन्दर
Fattanwala	फत्तणवाला
Qarasafahl	करासफाहल
Samsung	सैमसंग
Kesari	केसरी
Goliath	गोलिअथ
Fundtech	फंडटेक
Kantimoy	कंतिमोय
Gallium	गैलियम
Gudakesha	गुडाकेश
Sonoran	सोनोरॅन
Rahamat	रहमत
Jowai	जोवई
Clovis	क्लोविस
Karkhanis	कारखानीस
Devpreet	देवप्रीत
Sophia	सोफिया
Krashn	कृष्ण
Amooly	अमूल्य
Gugral	गुगराल
Jessop	जेसॉप
Brahmachari	ब्रह्मचारी
Bhuchchu	भुच्चु
Abhijeet	अभिजीत
Mahipal	महिपाल
Devak	देवक
Deval	देवल
Rocco	रोको
Gurdev	गुरदेव
Brahmaputra	ब्रह्मपुत्र
Izzat	इज़्ज़त
Clara	क्लारा
Greece	ग्रीस
Judamnah	जुदम्नाह
Rajmachikar	राजमाचीकर
Sabhy	सभ्य
Ekampreet	एकमप्रीत
Alleppey	एलीपे
Bal	बल
Hira	हीरा
Kuhad	कुहड़
Chidambarnaar	जिदंबरनार
Nagpur	नागपुर
Rollo	रोलो
Ahijit	अहिजित
Vijaynagar	विजयनगर
May	मई
Parshuram	परशुराम
Abbad	अब्बाद
Kira	किरा
Kellan	केलन
Cortland	कोर्टलैंड
Pensioner	पेंशनर
Junagarh	जूनागढ़
Donnica	डोनिका
Zahra	ज़ाहरा
Desai	देसाई
Balchandra	बालचंद्र
Lakeeren	लकीरें
Suchita	सुचिता
Chidambar	चिदम्बर
Tulayhah	तुलैहाह
Atifa	अतीफा
Vaishali	वैशाली
Hamas	हमास
Montagu	मॉन्टैगो
Bedetti	बदेत्ती
Ekatma	एकात्मा
Chaphekar	चाफेकर
Czechoslovakia	चेकोस्लोवाकीया
Atarra	अटारा
Layyah	लय्याह
Gaj	गज
Mendelevium	मेंडलीवियम
Muktaaprasu	मुक्ताप्रसु
Iredell	आयरडेल
Nileen	निलीन
Adalia	ऐडालिया
Clifford	क्लिफोर्ड
Mitesh	मितेश
Twyla	ट्वायला
Nirlep	निर्लेप
Keemat	कीमत
Shyamlata	श्यामलता
Clint	क्लिंट
Hotspur	हॉटस्पर
Marmit	मर्मित
Anastasia	एनेस्टेसिया
Daaka	डाका
Aas	आस
Chandika	चन्दिका
Lima	लीमा
Aaj	आज
Lekha	लेखा
Aan	आन
Khartoum	खारटूम
Anjana	अंजना
Madivan	मादिवन
Bhaalachandr	भालचंद्र
Anadya	अनाद्य
Raktotpal	रक्तोत्पल
Pascal	पास्कल
Hanif	हनीफ
Naiduniya	नईदुन‍िया
Depalsar	देपलसर
Lecea	लेसिया
Banseelaal	बंसीलाल
Parinda	परिंदा
Canberra	कैनबरा
Humlog	हमलोग
Ghutai	घुटाई
Drupad	द्रुपद
Chalala	छलाला
Abodh	अबोध
Priyam	प्रियम
Cassiar	क्लासिअर
Ratnavali	रत्नावली
Sansar	संसार
Shabnam	शबनम
Ghosunda	घोसुंदा
Jocelin	जोसेलिन
Dehaj	देहज
Angaarika	अंगारिका
Afafura	अफाफुरा
Tawbah	तौबाह
Weldon	वेल्डन
Avinashi	अविनाशी
Corydon	कॉरीडॉन
Kakadu	काकाडू
Farasat	फरासत
Charumati	चारुमति
Zahrah	ज़ाहराह
Hamim	हमीम
Mita	मीता
Malvina	माल्विना
Forrester	फॉरेस्टर
Snowdonia	स्नोडोनिया
Petra	पेत्रा
Nyckelharpa	निकलहार्पा
Mubashir	मुबाशिर
Bahia	बहिया
Sevillanas	सेविलेनास
Pink	पिंक
Wilson	विल्सन
Ross	रॉस
Manfoosah	मनफूसाह
Summayyah	सुमेय्याह
Disa	दिसा
Dipa	दीपा
Colman	कोलमैन
Raigarh	रायगढ़
Helsinki	हेलसिंकी
Ahzab	अहज़ाब
Etna	इटना
Gina	जीना
Shirlyn	शिर्लिन
Avent	एवेंट
Kahlo	काहलो
Messinia	मेसिनिआ
Didrika	डिड्रिका
Kabuliwala	काबुलीवाला
Tulayb	तुलैब
Sucheta	सुचेता
Fida	फिदा
Shripal	श्रीपाल
Seemaa	सीमा
Timothy	टिमोथी
Vimohinee	विमोहिनी
Bazaar	बाज़ार
Atharvan	अथर्वन
Jagadbandu	जगदबंधु
Viveca	विवेका
Devastator	डिवास्टेटर
Laurens	लॉरेंस
Bholi	भोली
Fauve	फॉव
Deepak	दीपक
Nandana	नन्दना
Balil	बलिल
Aida	आइडा
Dhandhera	धंधेरा
Kardawiyah	कर्दवियाह
Organ	ऑर्गन
Vrandaavaneshvaree	वृंदावनेश्वरी
Taline	टेलिन
Vayasyaa	वयस्या
Chaksu	चाकसू
Rubicon	रुबिकन
Shriram	श्रीराम
Duesseldorf	डसेलडॉर्फ़
Andrew	एण्ड्रयू
Rubidium	रूबीडियम
Atari	अटारी
Aacharyasuta	आचार्यसुता
Saadat	सादात
Angara	अंगारा
Zairah	ज़ैराह
Ranks	रैंक्स
Kenisha	केनिशा
Sangli	सांगली
Eudora	यूडोरा
Teledata	टेलीडेटा
Shams-ul-haq	शम्स-उल-ह़क
Khidrah	खिदराह
Abhivir	अभिवीर
Gadolinium	गैडोलीनियम
Narragansett	नॅरागनसेट
Zahidah	ज़हीदाह
Champa	चम्पा
Shor	शोर
Badrudin	बद्रुदिन
Devarsi	देवर्षि
Emir	एमिर
Tierney	टिएर्नी
Purvaja	पूर्वजा
Naveena	नवीना
Mahasamund	महासमुंद
Harasharan	हरशरण
Poushali	पूशाली
Charusheela	चारुशीला
Giraftaar	गिरफ्तार
Horizon	होरिज़न
Amogh	अमोघ
Karishma	करिश्मा
Makowal	माकोवाल
Kaumudi	कौमुदी
Mimi	मिमी
Petrobrás	पेट्रोब्रस
Param	परम
Bhale	भाले
Zulfa	ज़ुल्फा
Diti	दिति
Azeem	अज़ीम
Bhagat	भगत
Samasya	समस्या
Raaka	राका
Niobium	नियोबियम
Gypsy	जिप्सी
Amagi	अमागी
Kirtikumar	कीर्तिकुमार
Baazi	बाज़ी
Bashirah	बशीराह
Tameem	तमीम
Kayaking	कायाकिंग
Pfizer	फ़िज़र
Paramjeet	परमजीत
Philippine	फ़िलिपीनी
Lakshmigopal	लक्ष्मीगोपाल
Keita	कीटा
Nawada	नवादा
Rumba	रुंबा
Phatak	फाटक
Rakhi	राखी
Taqatwala	ताकतवाला
Rajmahal	राजमहल
Larissa	लैरीसा
Raakh	राख़
Padmanabhan	पद्मनाभन
Pushkar	पुष्कर
Lakshmidhar	लक्ष्मीधर
Vuntut	वनटूट
Husnara	हुस्नआरा
Kilakilaa	किलकिला
Leighton	लीगटन
Dhot	ढोट
Surjot	सुरजोत
Atindarjeet.	अतिंदरजीत
Morna	मोर्ना
Gandak	गंडक
Dakshata	दक्षता
Ihtiram	इहतिराम
Jaraah	जराह
Nick	निक
Ghoradongri	घोराडोंगरी
Kasargod	कासरगोड
Oracle	ओरेकल
Hessen	हेसेन
Baasim	बासिम
Jetashri	जेतश्री
Bhadkamkar	भडकमकर
Saggai	सगाई
Kellyn	केलिन
Onella	ओनेला
Basabi	बसाबी
Hafizah	हफीज़ाह
Kanvalasinh	कंवलसिंह
Shrimat	श्रीमत
Shrivats	श्रीवत्स
Jaikrishna	जयकृष्ण
Khudrah	खुदराह
Ravinandan	रविनन्दन
Bains	बैंस
Rupee	रुपी
Gaurika	गौरिका
Adhokshaj	अधोक्षज
Barbados	बार्बडोस
Zabrina	जैबरीना
Medera	मेडेरा
Gyalshing	ग्यालशिंग
Kaman	कमान
