Paris Charles de Gaulle 	पेरिस रॉसे चार्ल्स डे ग्यूले 
South Arlington Church of Christ 	साउथ अर्लिंग्टन 
Sea of the Hebrides 	सी ऑफ हरब्रिड्‍स 
Kelvingrove Art Gallery and Museum 	केल्व‍िनग्रोव आर्ट एण्ड म्युज़ियम 
Netaji Subhash Chandra Bose 	नेताजी सुभाषचंद्र बोस 
Rediff.com India Limited 	रेडिफ़ डॉट कॉम इंडिया लिमिटेड 
War of the Holy League 	वार ऑफ होली लीग 
Catherine zeta - Jones 	कैथरीन ज़ेटा-जोन्स 
Lagardère Groupe 	लैगार्डेयर ग्रुप  
Order of Vasa 	ऑडर ऑफ़ द वासा 
ColourPlus Fashions 	कलर प्लस फ़ैशन्स 
Parkway Apostolic 	पार्क वे अपोस्टोलिक 
Rockbrook United 	रॉकब्रुक यूनाइटेड मेथोडिस्ट 
Australian National University 	ऑस्ट्रेलियननेशनल यूनिवर्सिटी 
Chaitanya English medium High School,Tirupathi 	चैतन्य इंग्ल‍िश म‍ीड‍ियम हाई स्कलू, त‍िरुपती 
King Edward VII 	किंग एडवर्ड 
Mass Mutual Life 	मास म्युच्युअल लाइफ़ इंश्योरेंस 
Tenerife South Reina Sofia 	तेनेरीफ साउथ-रेइना सोफिया 
Apna Kaun ? 	अपना कौन? 
Navabharat Ferro Alloys 	नव भारत फ़ैरो अलॉय 
Saint John the Baptist High School,Thane 	सेंट जॉन द बैप्टिस्ट हाई स्कूल, ठाणे 
Omkarnath Thakur 	ओंकार नाथ ठाकुर 
