Spingarn Medal 	स्पिनगार्न मेडल 
Hari bhoomi 	हरी भूमि 
Graham Stevenson 	ग्रैहम स्टीवंसन 
Ackland Art Museum 	अकलैंड आर्ट म्युज़ियम 
Effie Awards 	एफी अवार्ड्‍स 
Warren Wisneski 	वॉरेन विसनेस्की 
Shree Ram Bharat Milap 	श्री राम भरत मिलाप 
Bornhem fort 	बॉर्नहेम फोर्ट 
Bedard Zamana Kya Jane 	बेदर्द ज़माना क्या जाने 
Abbott India 	एबॉट इंडिया 
Irfan Bhatti 	इरफान भट्टी 
Gurudwara Betma Sahib 	गुरूद्वारा बेटमा साहिब 
Adas Road 	आदस रोड 
Virginia reel 	वर्जीनिया रील 
Inteqam Ki Aag 	इंतिक़ाम की आग 
Aravalli Road 	अरावली रोड 
Water Polo 	वाटर पोलो 
Aakhri Adalat 	आखिरी अदालत 
University of Colorado 	यूनिवर्सिटी ऑफ कोलोरैडो 
Dainik bhaskar 	दैन‍िक भास्कर 
Pyar Ki Baazi 	प्यार की बाज़ी 
Mohammad Abul Kalam Azad 	मौलाना अब्दुल कलाम आज़ाद 
Naughty Boy 	नॉटी बॉय 
Khaled Mashud 	खालिद मशूद 
Perin over 	पेरीन ओवर 
Order of Sikatuna 	ऑडर ऑफ सिकाटुना 
Kala Dhandha Gorey Log 	काला धंधा गोरे लोग 
Rock Lake Baptist 	रॉक लेक बैपटिस्ट 
Mahadev Verma 	महादेवी वर्मा 
Brevard Worship Center 	ब्रेवार्ड वर्शिप सेंटर 
Captain Barry 	कैप्टन बैरी 
Shikhar par 	शिखर पर 
Bocher Memorial Prize 	बॉचर मेमोरियल प्राइज़ 
Walt Disney 	वॉल्ट डिज़्नी 
Calvary Baptist 	क्लेवरी बैपटिस्ट 
Intl Business Machines 	इंटल बिज़नेस मशीन्स 
Charles Coventry 	चार्ल्स कॉवेंट्री 
Khuda Kasam 	खुदा कसम 
Herschelle Gibbs 	हरशेले गिब्स 
Fort douaumont 	फोर्ट डॉमोंट 
Andy Pycroft 	एण्डी पाइक्रोफ्ट 
University College London 	यूनिवर्सिटी कॉलेज लंडन 
Chhindwara Junction 	छिंदवाड़ा जंक्शन 
Bagri Sajjanpur 	बागरी सज्जनपुर 
Hum Tum Aur Who 	हम तुम और वो 
Karsan Ghavri 	कर्सन घावरी 
Opto Circuits 	ऑप्टो सर्किट्स 
Noma Prize for Literature 	नोमा प्राइज़ फॉर लिट्रेचर 
Waqt Ki Deewar 	वक्त की दीवार 
Ahmed Kamal 	अहमद कमाल 
Jawaharlal Nehru 	जवाहरलाल नेहरू 
Vishvesvaraya Dam 	विश्वेसवराया डैम 
Preet Na Jane Reet 	प्रीत न जाने रीत 
Supreme Petro 	सुप्रीम पेट्रो 
Fort pearsall 	फोर्ट पेअरसैल 
Venugopal Rao 	विणुगोपाल राव 
Aap Ki Maarzi 	आप की मर्ज़ी 
Nippon Mining Holdings 	निप्पॉन माइनिंग होल्डिंग्स 
Prix Medicis 	प्रिक्स मेडिसिस 
Fort tejon 	फोर्ट टेजॉन 
Kyoto Prize 	क्योटो प्राइज़ 
Jane Anjane 	जाने अनजाने 
Muhammad Madani Miya Ashrafi al-Jilani 	मोहम्मद मदानी मियाँ अशरफी अल-जिलानी 
Ashapurna Devi 	आशापूर्णा देवी 
Hughes Medal 	ह्युजेस मेडल 
Hare Kanch Ki Churiyan 	हरे काँच की चुड़ियाँ 
Shiv Ratri 	शिव रात्रि 
Deep Dasgupta 	दीप दासगुप्ता 
Gurudwara Tibbi Sahib 	गुरूद्वारा टिब्बी साहिब 
Maut Ka Toofan 	मौत का तूफान 
Joseph Stalin 	जोसफ स्टेलिन 
Banqiao Dam 	बैंकियाओ डैम 
LeoNardo Di Caprio 	लियोनार्डो डी कैप्रियो 
Garnett Kruger 	गर्नेट क्रुगर 
Sant Gyaneshwar 	संत ज्ञानेश्वर 
Babu Meman 	बाबू मेमन 
Express Scripts 	एक्सप्रेस स्क्रिप्ट्स 
Raj Tilak 	राज तिलक 
International Paper 	इंटरनेशनल पेपर 
Jet Airways 	जेट एयरवेज़ 
Actress Kyon Bani 	एक्ट्रेस क्यों बनी 
Hasina Maan Jayegi 	हसीना मान जाएगी 
Roj Kennedy 	रोज कैनेडी 
Arsikere Junction 	अरसिकेरी जंक्शन 
Michael Landon 	मिशेल लंदन 
Dublin Writers Museum 	डब्ल‍िन राइटर्स म्युज़ियम 
Do Ankhen 	दो आँखें 
Havells India 	हॉवेल्स इंडिया 
Fort townsend 	फोर्ट टाउनसेंड 
Gurudwara Bauli Sahib 	गुरूद्वारा बाउली साहिब 
Brooke Walker 	ब्रूक वॉकर 
Delta Air Lines 	डेल्टा एयर लाइन्स 
Jack Nicholson 	जेक निकोलसन 
Mohsin Khan 	मोहसिन खान 
Grant Bradburn 	ग्रांट ब्रैडबर्न 
Abdul raheem 	अब्दुल रहीम 
Thomas Paine 	थॉमस पेन 
Royal Academy of Arts 	रॉयल एकेडमी ऑफ आर्ट्स 
Anaikuttam Reservoir 	अनइकुट्‍टम रिज़रवायर 
David Lloyd 	डेविड लॉएड 
Andhon Ki Duniya 	अंधों की दुनिया 
Aftab Ahmed 	आफताब अहमद 
Radha Aur Sita 	राधा और सीता 
Great Sandy 	ग्रेट सैंडी 
Richard Burton 	रिचर्ड बरटॉन 
Newbery Honor 	न्यूबेरी हॉनर 
Milan Malpensa 	मिलान मालपेन्सा 
Marlon Black 	मार्लोन ब्लैक 
Scotia Sea 	स्कॉटिया सी 
Sheikh Shebeli 	शेख़ शबेली 
University of Portsmouth 	यूनिवर्सिटी ऑफ पोर्ट्समाउथ 
Helle Joel Osment 	हेले जोएल ऑसमेंट 
Do Dushman 	दो दुश्मन 
Baghdad Ki Raten 	बगदाद की रातें 
Aduz zahir 	अदुज़ ज़हीर 
Jab Pyar Kise Se Hota Hai 	जब प्यार किसी से होता है 
The morning quick 	द मॉर्निंग क्व‍िक 
Jimmy Cook 	जिम्मी कुक 
Bill Lawry 	बिल लॉरी 
Kevin Duers 	केविन डुअर्स 
Kahani Phoolvati Ki 	कहानी फूलवती की 
Bhim Garjana 	भीम गर्जना 
Hafizur Rahman 	हफिज़ुर रहमान 
Ross Perot 	रॉस पीरॉट 
Raat Ke Rahi 	रात के राही 
Shahid Anwar 	शाहिद अनवर 
Emirates tower One 	एमीरेट्स टॉवर वन 
Bawa Muhaiyaddeen 	बाबा मुहइयाद्दीन 
High angle battery 	हाई एंगल बैटरी 
David White 	डेविड व्हाइट 
San Pablo Bay 	सैन पाब्लो बे 
Gola Barood 	गोला बारूद 
Ian Macewen 	इयान मैकवेन 
Umashankar Joshi 	उमाशंकर जोशी 
Stuart Williams 	स्टुअर्ट विलियम्स 
Ravi Ratnayeke 	रवि रत्नायके 
Groupe Caisse Dépargme 	ग्रुप कैस डेपॉर्मे 
Fort san felipe del morro 	फोर्ट सैन फेलिप डेल मॉरो 
Evergreen Community 	एवरग्रीन कम्युनिटी 
Orchards Community 	ऑर्चर्ड्स कम्युनिटी 
Harvey Awards 	हार्वे अवार्ड्‍स 
Saeed Azad 	सईद आज़ाद 
Steve Wonder 	स्टीव वॉन्डर 
Nazar Ka Shikar 	नज़र का शिकार 
Shriram TransFi 	श्रीराम ट्रांसफ़ी 
Four Continents Figure skating Champions 	फोर कॉनटिनेंट्‍स फिगर स्केटिंग चैंपियन्स 
Jacob Oram 	जेकब ऑरम 
Internet Initiative Japan 	इंटरनेट इनीशिएटिव जापान 
Fighter Sheila 	फाइटर शीला 
Allah Rakha 	अल्लाह रखा 
Colorado Kettle River 	कोलोरैडो केटल रिवर 
Bruce Medal 	ब्रूस मेडल 
Porttipahta reservoir 	पोर्टीपहटा रिज़रवायर 
Football World Cup 	फुटबॉल वर्ल्ड कप 
Insaaf Main Karoonga 	इंसाफ मैं करूँगा 
Fort cornwallis 	फोर्ट कार्नवॉलिस 
Major League Lacrosse Community Service Award 	मेजर लीग लैक्रोस कम्युनिटी सर्विस अवार्ड 
Crimean campaigns 	क्रिमेन कैम्पेन्स 
Aap Ka Pyar 	आप का प्यार 
Sanjh Ki Bela 	सांझ की बेला 
Pyar Ka Karz 	प्यार का कर्ज़ 
Guru Suleman Chela Pahelwan 	गुरु सुलेमान चेला पहलवान 
La raspa 	ला रैस्पा 
Morne van Wyk 	मॉर्न वेन वीक 
South Carolina 	साउथ कैरोलिना 
Nevanlinna Prize 	नेवानलिना प्राइज़ 
Gurudwara Pariwar Wichhoda 	गुरूद्वारा परिवार विछोड़ा 
Francesco Morosini 	फ्रांसेस्को मोरोसिनी 
Somnath Jyotirlinga 	सोमनाथ ज्योतिर्लिंग 
Tommy Hilfiger 	टॉमी हिल्फ़िज़र 
Jon Kent 	जॉन केंट 
Hyundai Motor 	हुंडई मोटर 
Delhi Public School Indirapuram 	डेल्ही पब्ल‍िक स्कूल इंदिरापुरम 
West Spitsbergen 	वेस्ट स्पीट्‍सबर्गन 
Finlandia Prize for Literature 	फिनलैंडिया प्राइज़ फॉर लिट्रेचर 
Mohammad Ashraful 	मोहम्मद अशराफल 
Wohi Bhayanak Raat 	वही भयानक रात 
Ashok Leyland 	अशोक लीलैंड 
Sajiv Murti 	सजीव मूर्ति 
Abdul rabb 	अब्दुल रब्ब 
Colin Stuart 	कॉलिन स्टुअर्ट 
Caldecott Medal 	काल्डेकॉट मेडल 
Fort ord 	फोर्ट ऑर्ड 
Peter Toohey 	पीटर टूहे 
Jack Benny 	जैक बेनी 
Silver Standard Resources 	सिल्वर स्टैंडर्ड रिसोर्सेज़ 
Cameron White 	कैमरॉन व्हाइट 
Order of Leopold 	ऑडर ऑफ लियोपोल्ड 
Order of Merit for the Fatherland 	ऑडर ऑफ मेरिट फॉर द फादरलैंड 
Bukit Tiga Puluh 	बुकिट टिगा पुलुह 
Khan Bahadur 	खान बहादुर 
Chris Kuggeleijn 	क्रिस कगलेजिन 
Sachin Tendulkar 	सचिन तेंडुलकर 
Albert Pinto Ko Gussa Kyon Ata Hai 	अल्बर्ट पिंटो को गुस्सा क्यों आता है 
Century sangbad 	सेंच्युरी संगबद 
Brad Young 	ब्रैड यंग 
Deep Sea Diving 	डीप सी डाइविंग 
Main Hoon Alladin 	मैं हूँ अलादीन 
Shree Krishna Leela 	श्री क़ृष्ण लीला 
University of canberra 	यूनिवर्सिटी ऑफ कैनबेरा 
Ameer Admi Garib Admi 	अमीर आदमी गरीब आदमी 
Hansraj Morarji Public School 	हंसराज मोरारजी पब्ल‍िक स्कूल 
Tom Riz 	टॉम रिज़ 
Dainik agradoot 	दैन‍िक अग्रदूत 
Mera Qasoor Kya Hai 	मेरा कसूर क्या है 
Gurudwara Nagina Ghat 	गुरूद्वारा नगीना घाट 
War of the Grand Alliance 	वार ऑफ द ग्रैंड अलाएंस 
Mohammad Rafique 	मोहम्मद रफीक 
Vinothen John 	विनोथन जॉन 
Two Prudential Plaza 	टू प्रुडेन्शियल प्लाज़ा 
Abdus sami 	अब्दुस सामी 
Raju Kulkarni 	राजू कुलकर्णी 
Descartes Systems Group 	डेसकार्टेस सिस्टम्स ग्रुप 
Gaon Hamara Shehar Tumhara 	गाँव हमारा शहर तुम्हारा 
Portsdown hill 	पोर्ट्‍सडाउन हिल 
Transamerica Pyramid 	ट्रांसमेरीका पिरामिड 
Donald Trump 	डोनाल्ड ट्रंप 
Gudur Junction 	गुदुर जंक्शन 
Apne Paraye 	अपने पराए 
Hum Shakal 	हम शक्ल 
Ratna Lutari 	रत्न लुटारी 
Takhat Shri Kesgarh Sahib, Anandpur Sahib (Punjab) 	तखत श्री केसगढ़ साहिब, आनंदपुर साहिब (पंजाब) 
Hamzah Fansuri 	हमज़ाह फंसूरी 
Piya Milan Ki Aas 	पिया मिलन की आस 
Saint George's Channel 	सेंट जॉर्ज्स चैनल 
Hamari Shaan 	हमारी शान 
Lucky Number 	लकी नंबर 
Dabur India 	डाबर इंडिया 
Neel Mani 	नील मणी 
Dirk Wellham 	डर्क वेल्हैम 
Khush bakht 	खुश बख्त 
Ballard Power Systems 	बेलर्ड पॉवर सिस्टम्स 
Fransworth Art Museum 	फ्रैंसवर्थ आर्ट म्युज़ियम 
Milford haven 	मिल्फोर्ड हैवन 
Paul Collingwood 	पॉल कोलिंगवुड 
Guntur Junction 	गुंटूर जंक्शन 
Hamari Mazil 	हमारी मंज़िल 
My Love 	माय लव 
University of the Sunshine Coast 	यूनिवर्सिटी ऑफ द सनशाइन कोस्ट 
Lorence Oliver 	लॉरेंस ऑलीवर 
Alma Assembly of God's 	अल्मा असेंब्ली ऑफ गॉड्स 
Sadak Chhap 	सड़क छाप 
Bhakt Pralhad 	भक्त प्रहलाद 
Badr al din 	बद्र अल दीन 
National Australia Bank 	नेशनल ऑस्ट्रेलिया बैंक 
Eent Ka Jawab Patthar 	ईंट का जवाब पत्थर 
Apna Bana Lo 	अपना बना लो 
Mike Denness 	माइक डेनेस 
Koyna Dam 	कोयना डैम 
Kmart Holding 	मार्ट होल्डिंग 
Aruna Asif Ali 	अरूणा आसफ अली 
Ahmadpur Junction 	अहमदपुर जंक्शन 
University of Lancaster 	यूनिवर्सिटी ऑफ लैंकेस्टर 
John Maguire 	जॉन मेग्यूर 
Apradhi Kaun 	अपराधी कौन 
Peabody Award 	पीबॉडी अवार्ड 
Hum Ek Hain 	हम एक हैं 
Colorado river 	कोलोरॅडो रिवर 
Dominican merengue 	डॉमनिकन मेरेंग्यू 
Love And Murder 	लव एण्ड मर्डर 
Order of the Falcon 	ऑडर ऑफ द फैल्कन 
Harry S. Truman 	हैरी एस. ट्रूमेन 
Anand Bhavan 	आनंद भवन 
Dainik jugasankha 	दैन‍िक जुगसंखा 
Wal Mart Stores 	वॉल मार्ट स्टोर्स 
Fort meigs 	फोर्ट मेग्स 
Jaago Hua Savera 	जागो हुआ सवेरा 
Paul Walker 	पॉल वॉल्कर 
Aban LoydChiles 	अबान लॉयडचिलीज़ 
Naag Mani 	नाग मणि 
Pritish Nandy Communications 	प्रितिश नंदी कम्युनिकेशन 
Sachche Ka Bolbala 	सच्चे का बोलबाला 
Registan Ki Rani 	रेगिस्तान की रानी 
Goncière Euris 	गॉन्सियर यूरिस 
University of Brighton 	यूनिवर्सिटी ऑफ ब्राइटन 
Aakash Deep 	आकाश दीप 
Bruce Peninsula 	ब्रुस पेनिनसुला 
Hats' Russian War 	हैट्स रशियन वार 
United Technologies 	यूनाइटेड टेक्नोलॉजीज़ 
Chandrashekhar Azad 	चंद्रशेखर आज़ाद 
University of Glamorgan 	यूनिवर्सिटी ऑफ ग्लेमॉर्गन 
Ghar Akhir Ghar Hai 	घर आखिर घर है 
North Dakota 	नॉर्थ डकोटा 
Fort monckton 	फोर्ट मॉन्कटन 
University of North Carolina 	यूनिवर्सिटी ऑफ नार्थ कैरोलीना 
Heer Ranjha 	हीर रांझा 
Sabz Baag 	सब्ज़ बाग 
Most Valuable Player Award 	मोस्ट वैल्युएबल प्लेयर अवार्ड 
Athar Ali Khan 	आथर अली खान 
Fauladi Mukka 	फौलादी मुक्का 
Aung San su ki 	आंग सांग सू की 
Trinity Lutheran 	ट्रीनिटी लुथरेन 
Sainik School Goalpara 	सैनिक स्कूल गोलपारा 
Veinticinco de Mayo 	वेंटिसिन्को डी मेयो 
Naag Mohini 	नाग मोहिनी 
Bagutta Prize 	बगुटा प्राइज़ 
Taqdeer Ka Badshah 	तक़दीर के बादशाह 
Guj Alkali 	गुजरात अल्कली 
Mahabali Hanuman 	महाबली हनुमान 
Graeme Watson 	ग्रीम वॉटसन 
Dhandari Kalan 	धनदरी कलां 
Quintana Maritime Limited 	क्वींटाना मैरीटाइम लिमिटेड 
Mohammad Hafeez 	मोहम्मद हफीज़ 
Mel Brooks 	मॅल ब्रुक्स 
Railway Museum of the Municipality of Kalamata 	रेल्वे म्युज़ियम ऑफ द म्यून‍िस‍िपाल्टी ऑफ कलमाटा 
South Korea 	साउथ कोरिया 
Trillium Award 	ट्रिलियम अवार्ड 
Francisco Carneiro 	फ्रान्सिस्को कॉर्निइरो 
Padma Vibhushan 	पद्‍म विभूषण 
Akila daily 	अकीला डेल्ही 
Naeem Ahmed 	नईम अहमद 
Polish revolt against King Augustus II 	पॉलिश रिवॉल्ट अगेंस्ट किंग अगस्टस ॥ 
Emily Post 	एमिली पोस्ट 
Hashan Tillakaratne 	हशन तिलकरत्ने 
Sundaram Fasteners 	सुंदरम फ़ास्टनर्स 
Essar Steel 	एस्सार स्टील 
Khaled Mahmud 	खालिद महमूद 
ClickSoftware Technologies 	क्लिकसॉफ़्टवेयर टेक्नोलॉजीज़ 
Tum Mere Ho 	तुम मेरे हो 
Haathi Mere Saathi 	हाथी मेरे साथी 
University of Teeside 	यूनिवर्सिटी ऑफ टीसाइड 
Glenmark Pharmaceuticals 	ग्लैनमार्क फ़ार्मास्युटिकल्स 
Steiner Leisure Limited 	स्टेनर लेज़र लिमिटेड 
Jeff Dujon 	जेफ डुजोन 
Trevor Laughlin 	ट्रेवर लाफ्लिन 
Sima Pumacocha 	सिमा प्युमाकोका 
Manulife Financial 	मैन्युलाइफ़ फ़ाइनेंशियल 
Purani Haveli 	पुरानी हवेली 
Scottish Church College, Calcutta 	स्कॉट‍िश चर्च कॉलेज, कैलकटा 
Tareq Aziz 	तारीक अज़ीज़ 
Order of William 	ऑडर ऑफ़ विलियम 
Jonathan Agnew 	जोनाथन एग्न्यू 
Corey Collymore 	कॉरे कॉलीमर 
Cross Country 	क्रॉस कंट्री 
Roger Telemachus 	रॉजर टेलीमैचुस 
Daku Mangal Singh 	डाकू मंगल सिंह 
Dinesh Mongia 	दिनेश मोंगिया 
Tere Bina Kya Jeena 	तेरे बिना क्या जीना 
Cobra Girl 	कोबरा गर्ल 
Order of Beneficence 	ऑडर ऑफ बेनेफिसेंस 
Colour Chem 	कलर कैम 
Nilantha Ratnayake 	निलंथा रत्नायके 
Dinesh Karthik 	दिनेश कार्तिक 
Basit Ali 	बसित अली 
Murdoch University 	मर्डोक यूनिवर्सिटी 
Andrea Doria 	एन्ड्रीया डोरिया 
Chhote Nawab 	छोटे नवाब 
Mushfiqur Rahim 	मुश्फिकर रहीम 
Constellation Energy 	कॉन्सटेलेशन एनर्जी 
Global Sources 	ग्लोबल सोर्सेज़ 
Barberton Friends 	बार्बेरटॉन फ्रेंडस 
Phir Aya Toofan 	फिर आया तूफान 
Fort amherst 	फोर्ट एमहर्स्ट 
James Whitaker 	जेम्स व्हिटेकर 
Ab To Jeene Do 	अब तो जीने दो 
War of Devolution 	वार ऑफ डिवॉल्यूशन 
Neil Semon 	‍नील सिमॉन 
Bunny hop 	बनी हॉप 
Time Warner 	टाइम वॉर्नर 
Lakshmipathy Balaji 	लक्ष्मीपति बालाजी 
Savu Sea 	सावू सी 
State University of New York 	स्टेट यूनिवर्सिटी ऑफ न्यू यॉर्क 
Chit Baragaon 	चित बड़ागांव 
Bombay Ka Chor 	बॉम्बे का चोर 
Munsif daily 	मुंसिफ डेल्ही 
Newberg Christian 	न्यूबर्ग क्रिश्चियन 
Barbara Boxer 	बारबरा बॉक्सर 
George Bernard Shaw 	जॉर्ज बर्नार्ड शॉ 
Roti Kapada Aur Makan 	रोटी कपड़ा और मकान 
Fort mchenry 	फोर्ट मैकहेनरी 
Everest Ind 	एवरेस्ट इंडस्ट्रीज़ 
Peter Kirsten 	पीटर किर्स्टन 
King Faisal Foundation Prize 	किंग फैज़ल फाउंडेशन प्राइज़ 
University of Birmingham 	यूनिवर्सिटी ऑफ बर्मिंघम 
Apna Desh Paraye Log 	अपना देश पराए लोग 
Banke Sipahi 	बाँके सिपाही 
Bal Yogi 	बाल योगी 
Nanjing Museum 	नंज‍िंग म्युज़ियम 
Abdul ganee 	अब्दुल गनी 
Meru Betiri 	मेरु बेतिरी 
Aakhri Cheekh 	आखिरी चीख 
West coast swing 	वेस्ट कोस्ट स्विंग 
First Southern Baptist 	फर्स्ट साउदर्न बैपटिस्ट 
University of Kent 	यूनिवर्सिटी ऑफ केंट 
Devon Malcolm 	डेवॉन मैल्कम 
Aankhon Dekhi 	आँखों देखी 
Alger Hiss 	अल्गर हिस 
China Mobile Communications 	चाइना मोबाइल कम्यूनिकेशंस 
Cosmo Films 	कॉस्मो फ़िल्म्स 
Anglo American 	एंग्लो अमेरिकन 
Pattharon Ka Saudagar 	पत्थरों का सौदागर 
Premio Bancarella 	प्रेमियो बैनकैरेला 
Navios Maritime Holdings 	नैवियोज़ मैरीटाइम होल्डिंग्स 
James Anderson 	जेम्स एण्डरसन 
Modern Matriculation School, Cholvaram Nagar 	मॉडर्न मैट्रिक्युलेशन स्कूल, चोल्वाराम नगर 
Lou Vincent 	लोउ विंसेंट 
Lumps fort 	लम्प्स फोर्ट 
South China 	साउथ चायना 
Watan Ke Rakhwale 	वतन के रखवाले 
Royal Gorge 	रॉयल गॉर्ज 
Aaj Ka Daur 	आज का दौर 
Abdul muta'alee 	अब्दुल मुताअली 
Viv Richards 	विव रिचर्ड्‍स 
The assam tribune 	द असम ट्रिब्यून 
National Medal of Science 	नेशनल मेडल ऑफ साइंस 
Cape Breton 	केप ब्रेटन 
Colvin Taluqadar's College, Lucknow 	कॉल्व‍िन तालुकदार्स कॉलेज, लखनऊ 
Imaan Dharam 	ईमान धरम 
The Carper Award 	द कार्पर अवार्ड 
Faith Missionary Baptist 	फ़ेथ मिशनरी बैपटिस्ट 
Warren Community 	वारेन कम्युनिटी 
Mount Revelstoke 	माउंट रिवेलस्टोक 
Fort nelson 	फोर्ट नेल्सन 
Rajasthan patrika 	राजस्थान पत्रिका 
Sun Trust Plaza 	सन ट्रस्ट प्लाज़ा 
Fort macon 	फोर्ट मैकन 
Sanjh savera 	सांझ सवेरा 
Adolf Hitler 	अडॉल्फ़ हिटलर 
University of Dundee 	यूनिवर्सिटी ऑफ डंडी 
Dil Ne Phir Yaad Kiya 	दिल ने फिर याद किया 
Fatehabad Junction 	फतेहाबाद जंक्शन 
Andros Museum of Modern Art 	एण्ड्रॉस म्युज़ियम ऑफ मॉडर्न आर्ट 
Mere Garib Nawaz 	मेरे गरीब नवाज़ 
Sharif Daku 	शरीफ डाकू 
Sona Koyo Stee 	सोना कोयो स्टी 
Chamara Kapugedera 	चामरा कपुगेदेरा 
Azimganj Junction 	अज़ीमगंज जंक्शन 
Charlton Heston 	चार्लटन हेस्टन 
Parth Kumar 	पार्थ कुमार 
Reddys Labs 	रेड्डी लैब्स 
Fort bokar 	फोर्ट बोकर 
Pyar Ki Maar 	प्यार की मार 
Aamer Nazir 	आमेर नाज़िर 
Irvine Shillingford 	इरविन शिलिंगफोर्ड 
Meet One Greet One 	मीट वन ग्रीट वन 
Fort bovisand 	फोर्ट बॉविसैंड 
Great Victoria 	ग्रेट विक्टोरिया 
Bank of India 	बैंक ऑफ इंडिया 
Giuseppe Miraglia 	ग्यूसेप मिराग्लिया 
Christy Hefner 	क्रिस्टी हैन्फ़र 
Khufia Mahal 	खुफिया महल 
Olympic medalists 	ओलिंपिक मेडलिस्ट 
Do Hawaldar 	दो हवलदार 
Chubu Electric Power 	शुब इलेक्ट्रिक पॉवर 
Solomon Island 	सोलोमन द्वीप 
Chyulu Hills 	च्यूलु हिल्स 
Peter Willey 	पीटर विले 
Mithra Wettimuny 	मिथ्रा वेट्टीमुनी 
Hum Diwane 	हम दीवाने 
Fort edmonton 	फोर्ट एडमॉन्टन 
Mississippi River 	मिसिसिपी रिवर 
Steve Wozniak 	स्टीव वॉज़निक 
Hungarian Revolt 	हंगेरियन रिवॉल्ट 
Mera Ghar Mere Bachche 	मेरा घर मेरे बच्चे 
Coimbatore North Junction 	कोइम्बटूर नॉर्थ जंक्शन 
Summit Awards 	सुमित अवार्ड्‍स 
San Francisco Oakland Bay 	सैन फ्रान्सिस्को ऑकलैंड बे 
Laxmi Pooja 	लक्ष्मी पूजा 
Hydrogenics Corporation 	हाइड्रोजेनिक्स कॉर्पोरेशन 
Charles Darwin 	चार्ल्स डार्विन 
Gokul Ka Raja 	गोकुल का राजा 
Upul Chandana 	उपुल चन्दाना 
Gujarat Ambuja Cement 	गुजरात अंबुजा सीमेंट 
Ganga Ki Saugandh 	गंगा की सौगंध 
Ronald Reagan 	रोनाल्ड रीगन 
Raj Laxmi 	राज लक्ष्मी 
Bentuang Karimun 	बेंटुआंग कारीमुन 
Don Anurasiri 	डॉन अनुरसीरी 
John Wayne 	जॉन वेन 
Varadraja Perumal 	वरदराजा पेरूमाल 
Raste Aur Manzil 	रास्ते और मंज़िल 
Amadou Bamba 	अमादोउ बांबा 
Blue Dart 	ब्लू डार्ट 
Badnam Farishte 	बदनाम फरिश्ते 
Naam O Nishaan 	नाम ओ निशान 
Ravindra Pushpakumara 	रविंद्र पुष्पकुमारा 
Bhai Bahen 	भाई बहन 
Shambhu Maharaj 	शंभू महाराज 
Sadhu Ya Shaitan 	साधू या शैतान 
Australian Catholic University 	ऑस्ट्रेलियन कैथलिक यूनिवर्सिटी 
Museum of the city of New York 	म्युज़ियम ऑफ द स‍िट‍ी ऑफ न्यू यॉर्क 
Jaali Note 	जाली नोट 
Taner Ansari 	तनीर अंसारी 
Mere Lal 	मेरे लाल 
Gurudwara Manikaran 	गुरूद्वारा मनीकरण 
John Rennie 	जॉन रेनी 
Turkish-Transylvanian War 	टर्किश-ट्रांसिल्वेनियन वार 
Pyasi Nadi 	प्यासी नदी 
Naomi Awards 	नाओमी अवार्ड्‍स 
Pyar Kiye Ja 	प्यार किए जा 
Dharmavaram Junction 	धर्मवरम जंक्शन 
Jeevan Naiya 	जीवन नैया 
Tiptree award 	टिपट्री अवार्ड 
The Royal Norwegian Order of Saint Olav 	द रॉयल नॉरवेगन ऑडर ऑफ सेंट ओलव 
Sean Williams 	सीन विलियम्स 
Lanka Dahan 	लंका दहन 
Order of Liberty 	ऑडर ऑफ लिबर्टी 
Florence Nightingale 	फ़्लोरेंस नाइटेंगल 
Dave Callaghan 	डेव कैलाघन 
Robin Singh 	रॉबिन सिंह 
Fort pickens 	फोर्ट पिकन्स 
Grande Sertao Veredas 	ग्रैंड सेरटाओ वेरीडास 
Phoolon Ki Sej 	फूलों की सेज 
Dhampur Sugar 	धामपुर शुगर 
Ajay Jadeja 	अजय जडेजा 
Road To Sikkim 	रोड टू सिक्किम 
Abdus salam 	अब्दुस सलाम 
Kapil Dev 	कपिल देव 
Capilano Suspension 	कॅपीलानो सस्पेंशन 
Bruce Edgar 	ब्रूस एगर 
John Milton 	जॉन मिल्टन 
Aayi Yaad Teri 	आई याद तेरी 
Abdus samad 	अब्दुस समद 
Meri Lalkaar 	मेरा ललकार 
Alan Wells 	ऐलन वेल्स 
Cofre de Perote 	कॉफरे डी पेरोट 
Colin Croft 	कॉलिन क्रोफ्ट 
John Penn 	जॉन पेन 
Gua Cipicung 	गुआ सिपीकुंग 
Christopher Reeve 	क्रिस्टोफर रीव 
Fort vermilion 	फोर्ट वर्मिलियन 
NASA Medal for Exceptional Scientific Achievement 	नासा मेडल फॉर एक्सेप्शनल साइंटीफिक अचीवमेंट 
Abdul tawwaab 	अब्दुल तव्वाब 
Palm Springs 	पाम स्प्रिंग 
Henry Williams 	हेनरी विलियम्स 
Bowden fort 	बोडन फोर्ट 
San Paolo Imi 	सन पेओलो मी 
Track and Field 	ट्रैक एण्ड फील्ड 
Andrew Flintoff 	एण्ड्रयू फ्लिंटॉफ 
Vanburn Holder 	वैनबर्न होल्डर 
China National Petroleum 	चाइना नेशनल पेट्रोलियम 
Ndere Island 	नदेरे आयलैंड 
Seven Miles 	सेवन माइल्स 
Zurich Financial Services 	ज़्यूरिक फ़ाइनेंशियल सर्विसेज़ 
Guy Whittall 	गाए व्हिट्टल 
Julia Child 	जुलिया चाइल्ड 
Corporation Bank 	कॉर्पोरेशन बैंक 
River Phoenix 	रिवर फ़ोनिक्स 
Syed Kirmani 	सय्यद किरमानी 
Souten Ki Beti 	सौतन की बेटी 
Steve Rixon 	स्टीव रिक्सन 
Mera Saya 	मेरा साया 
Bandula Warnapura 	बन्दुला वर्नापुरा 
Order of Maritime Merit 	ऑडर ऑफ मैरीटाइम मेरिट 
Aankhon Annkhon Mein 	आँखों आँखों में 
Santa Maria 	सांता मारिया 
Dakaniya Talav 	डाकनिया तलाव 
Luxembourg City 	लक्ज़ेम्बर्ग सिटी 
Aamer Malik 	आमेर मलिक 
Deogan Road 	देवगन रोड 
Mujahid Jamshed 	मुजाहिद जमशेद 
Suzuki Motor 	सुज़ुकी मोटर 
Shake Hands 	शेक हैंड्‍स 
Agar Tum Na Hote 	अगर तुम न होते 
Roshan Jurangpathy 	रोशन जुरंगपथी 
Jecy James 	जेसी जेम्स 
Age Badho 	आगे बढ़ो 
Asif Mahmood 	आसिफ महमूद 
Beris Dam 	बेरिस डैम 
Saful islam 	सैफुल इस्लाम 
Film Hi Film 	फिल्म ही फिल्म 
Abdul baseer 	अब्दुल बसीर 
Abdus salaam 	अब्दुस सलाम 
Dharam Veer 	धरम वीर 
Paul Vrellis Greek History Museum 	पॉल व्रेलिस ग्रीक ह‍िस्ट्री म्युज़ियम 
Fort worth 	फोर्ट वर्थ 
University of Surrey 	यूनिवर्सिटी ऑफ सरेय 
Lack Walesa 	लॅक वॉलेंसा 
Fort tregantle 	फोर्ट ट्रेगैन्टल 
Shoaib Malik 	शोएब मलिक 
Baba Bulleh Shah 	बाबा बुले शाह 
Sheikh Chilli 	शेख चिल्ली 
Divine Nagar 	डिवाइन नगर 
Anokha Rishta 	अनोखा रिश्ता 
Sainte marie 	सेंट मेरी 
Naseer Malik 	नसीर मलिक 
Pyar Ka Rishta 	प्यार का रिश्ता 
Nafrat Ki Andhi 	नफरत की आँधी 
Doug Walters 	डॉग वाल्टर्स 
Steve Smith 	स्टीव स्मिथ 
Franco-Russian War 	फ्रेंको-रशियन वार 
Chittar Reservoir-2 	चित्तर रिज़रवायर-2 
Indian Bank 	इंडियन बैंक 
Omar Khaiyyam 	ओमर खैय्यम 
Pharmaxis Limited 	फ़ार्माएक्सिस लिमिटेड 
Atrauli Road 	अत्रौली रोड 
Murray Goodwin 	मुर्रे गुडविन 
Dark Street 	डार्क स्ट्रीट 
Deryck Murray 	डेरिक मुर्रे 
Marsabit and Reserve 	मारसाबिट एण्ड रिज़र्व 
Mahindra Ugine 	महिंद्रा युजिन 
Mangalore Chem 	मैंगलोर केमिकल्स 
Cape Cod 	केप कॉड 
Neend Hamari Khwab Tumhare 	नींद हमारी ख्वाब तुम्हारे 
Chandia Road 	चंदिया रोड 
Guiness World of Record Museum 	ग‍िनीज वर्ल्ड ऑफ रेकॉर्ड्स म्युज़ियम 
Vidya Vardhaka Sangha High School, Bangalore 	विद्या वर्धक संघ हाई स्कूल, बैंगलोर 
Rishta Kagaz Ka 	रिश्ता कागज़ का 
Army Public School, New Delhi 	आर्मी पब्‍लिक स्‍कूल, न्यू डेल्ही 
Garhi Manikpur 	गर्ही मानिकपुर 
Adam Dale 	एडम डेल 
Kavli Prize 	कावली प्राइज़ 
Benito Mussolini 	बेनिटो मुसोलिनी 
Federal Express 	फ़ेडेरल एक्सप्रेस 
Templo De Alabanza A Bilingual 	टेम्पलो डे अलबन्ज़ा ए बिलींगुअल 
Dream Girl 	ड्रीम गर्ल 
Miyan Biwi Razi 	मियाँ बीवी राज़ी 
Doctor Shaitan 	डॉक्टर शैतान 
Aakhri Muqabla 	आखिरी मुकाबला 
Jewel Thief 	ज्वेल थीफ 
London Metropolitan University 	लंडन मैट्रोपॉलिटन यूनिवर्सिटी 
Doosri Dulhan 	दूसरी दुल्हन 
Maan Gaye Ustaad 	मान गए उस्ताद 
Aswan Dams 	अस्वान डैम 
Abdul haleem 	अब्दुल हलीम 
Newbery Medal 	न्यूबेरी मेडल 
Neelam Pari 	नीलम परी 
Barya Ram 	बर्या राम 
Centurion Bank 	सेंच्यूरियन बैंक 
Guru Dakshina 	गुरु दक्षिणा 
Order of Saint George 	ऑडर ऑफ सेंट जॉर्ज 
Rangeen Zamana 	रंगीन ज़माना 
Ek Shola 	एक शोला 
Finolex Industries 	फ़िनोलेक्स इंडस्ट्रीज़ 
Northampton University College 	नार्थएंपटन यूनिवर्सिटी कॉलेज 
Bada Aadmi 	बड़ा आदमी 
Apna Khoon Apna Dushman 	अपना खून अपना दुश्मन 
Mervyn Dillon 	मर्विन डिलों 
Moin Khan 	मोइन खान 
Syed Fazl Kareem Quadri 	सय्यद फज़्ल करीम क़ादरी 
Antalya Havalimani 	अंताल्या हावालीमानी 
Hugo Award 	ह्यूगो अवार्ड 
Kasam Paida Karne Wale Ki 	कसम पैदा करने वाले की 
Delhaize Group 	डलहैज़ी ग्रुप 
Barry Hadlee 	बैरी हैडली 
Mehandi Lagi Mere Haath 	मेहँदी लगी मेरे हाथ 
Carl Rogers 	कार्ल रॉगर्स 
Salil Ankola 	सलिल अंकोला 
Somerset Mom 	सोमरसेट मॉम 
John Bradshaw 	जॉन ब्रेडशॉ 
College Girl 	कॉलेज गर्ल 
Al Hilal 	अल हिलाल 
Church of the Open Door 	चर्च ऑफ द ओपन डोर 
Chau Mahla 	चाउ माहला 
Reliance Natura 	रिलायंस नैच्युरा 
Union pipe 	यूनियन पाइप 
Cosmo Oil 	कॉस्मो ऑईल 
Dayton art Institute 	डेटन आर्ट इंस्टीट्‍यूट 
Ek Baar Chale Aao 	एक बार चले आओ 
Rudra Pratap Singh 	रुद्र प्रताप सिंह 
Bonso Electronics International 	बोनसो इलेक्ट्रॉनिक्स इंटरनेशनल 
American Express 	अमेरिकन एक्सप्रेस 
Guj State Petro 	गुजरात स्टेट पेट्रो 
Malcolm Jarvis 	मैल्कम जर्विस 
Meri Asha 	मेरी आशा 
Abdul hadee 	अब्दुल हदी 
Prem Samadhi 	प्रेम समाधि 
Mera Suhag 	मेरा सुहाग 
Kephart United Methodist 	केफार्ट यूनाइटेड मेथोडिस्ट 
Hindustan Petroleum 	हिंदुस्तान पेट्रोलियम 
Goldie Haun 	गोल्डी हॉन 
Palar Porandalar Reservoir 	पालर पोरन्दलर रिज़रवायर 
Chaminda Mendis 	चमिंडा मेंडिस 
Lucil Ball 	ल्युसिल बॉल 
Jin Mao Building 	जिन माओ बिल्डिंग 
Gora Ghuma 	गोरा घुमा 
Arab Ka Saudagar 	अरब का सौदागर 
James Cook University 	जेम्स कुक यूनिवर्सिटी 
Gerald Peckover 	गेराल्ड पेकोवर 
Kiev fortress 	कीव फोर्ट्रेस 
Marathon Oil 	मेराथन ऑइल 
Emily Harris 	एमिली हॅरिस 
Kanoon Apna Apna 	कानून अपना अपना 
Sunil Joshi 	सुनील जोशी 
Mera Salaam 	मेरा सलाम 
Manimuthar Reservoir 	मणिमुथर रिज़रवायर 
Hannan Sarkar 	हन्नान सरकार 
Khoon Pasina 	खून पसीना 
Roop Rupaiya 	रूप रुपैया 
Fort cumberland 	फोर्ट कंबरलैंड 
Ek Kunwari Ek Kunwara 	एक कुँवारी एक कुँवारा 
Mosaddek Hossain 	मोसाद्देक हुसैन 
Lukayan Caverns 	ल्युकायन केवरन्स 
Anmol Moti 	अनमोल मोती 
Texas Health Science Center 	टेक्सास हैल्थ साइंस सेंटर 
Salaam Memsaab 	सलाम मेमसाब 
Do Gulab 	दो गुलाब 
Bank of Plaza 	बैंक ऑफ प्लाज़ा 
Trintech Group 	ट्रिनटेक ग्रुप 
Jhoota Kahin Ka 	झूठा कहीं का 
Bhagwat Chandrashekhar 	भागवत चन्द्रशेखर 
Uttar Kannada 	उत्तर कन्नड़ 
Keith Dabengwa 	कैथ डबेंग्वा 
Quad Rugby 	क्वाड रग्बी 
Shankar Hussain 	शंकर हुसैन 
United States Military Academy 	यूनाइटेड स्टेट्‍स मिलिट्री अकेडमी 
Jataa shankaree 	जटा शंकरी 
Research in Motion Limited 	रिसर्च इन मोशन लिमिटेड 
Param Dharam 	परम धरम 
Janam Janam Ke Phere 	जनम जनम के फेरे 
Aflatoon Aurat 	अफलातून औरत 
Piya Ki Jogan 	पिया की जोगन 
George Van Biesbroeck Prize 	जॉर्ज वैन बिसब्रोएक प्राइज़ 
Ian Redpath 	इआन रेडपाथ 
Ek Phool Ek Bhool 	एक फूल एक भूल 
Gareth Hopkins 	गैरेथ हॉप्किंस 
Apne Apne 	अपने अपने 
Glenn Trimble 	ग्लेन ट्रिंबल 
Wayne Larkins 	वेन लार्किंस 
Lake Manyara 	लेक मन्यारा 
Prashant Vaidya 	प्रशांत वैद्य 
Chanda Aur Bijli 	चंदा और बिजली 
Aji assamese daily 	अज‍ि असमीज डेल्ही 
Ian Botham 	इआन बोथम 
Maan Apmaan 	मान अपमान 
Saleem Pervez 	सलीम परवेज़ 
Arthur conan doyle 	ऑर्थर कानन डोलाय 
Chaminda Vaas 	चमिंडा वास 
Shane Bond 	शेन बॉन्ड 
Mahatma Gandhi 	महात्मा गांधी 
Hunterian Museum and Gallery 	हुंटेरियन म्युज़ियम एण्ड गैलरी 
Aurat Ki Zindagi 	औरत की ज़िंदगी 
Miss Bombay 	मिस बॉम्बे 
Jai Chittod 	जय चित्तौड़ 
Hamari Bahu Alka 	हमारी बहू अल्का 
Gonda Junction 	गोंडा जंक्शन 
Credit Susse 	क्रेडिट सुसे 
Reshmi Rumal 	रेशमी रुमाल 
Major League Lacrosse Offensive player of the Year Award 	मेजर लीग लैक्रोस ओफेंसिव प्लेयर ऑफ द ईयर अवार्ड 
Monica Lewinsky 	मोनिका लुइंस्की 
Tushar Imran 	तुषार इमरान 
Aazadi Ki Ore 	आज़ादी की ओर 
Madura Garments 	मदुरा गारमेंट्स 
Dominion Resources 	डॉमिनियन रिसोर्सेज़ 
Morgan Stanley 	मॉर्गन स्टेनली 
Abdul muhayee 	अब्दुल मुहायी 
Dirt Racing 	डर्ट रेसिंग 
Peter Coman 	पीटर कॉमेन 
Hamari Kismat 	हमारी किस्मत 
Khan Dost 	खान दोस्त 
Lysa hora 	लाइसा होरा 
Compton Crook Award 	कॉम्पटन क्रूक अवार्ड 
Victor Hugo 	विक्टर ह्यूगो 
Bhiwandi Road 	भिवंडी रोड 
Cato Calin 	केटो केलिन 
Lipman Electronic Engineering 	लिपमैन इलेक्ट्रॉनिक इंजीनियरिंग 
Tokyo Electric Power 	टोक्यो इलेक्ट्रिक पॉवर 
Aya Toofan 	आया तूफान 
Ibrahim Niass 	इब्राहिम नियास 
Chauri Chaura 	चौरी चौरा 
Dobh Bahali 	दोभ बहाली 
University of Stirling 	यूनिवर्सिटी ऑफ स्टर्लिंग 
Michael Douglas 	मिशेल डॉगल्स 
Exxon Mobile 	एक्ज़ॉन मोबाइल 
John Emburey 	जॉन एंब्यूरे 
Elbit Systems 	एल्बिट सिस्टम्स 
Museum and Study Centre of the Greek Theatre 	म्युज़ियम एण्ड स्टडी सेंटर ऑफ द ग्रीक थ‍िएटर 
Bryan Young 	ब्रायन यंग 
Ruth Bader Ginsburg 	रूथ बॅडर जिंसबर्ग 
New Kent 	न्यू केंट 
Arkansas traveler 	अर्कन्सास ट्रैवलर 
Artistic Gymnastics 	आर्टिस्टिक जिमनास्टिक्स 
Bir Sreshtho 	बीर श्रेष्ठो 
Euler Medal 	युलर मेडल 
Aaj Ka Hindustan 	आज का हिंदुस्तान 
China Finance Online 	चाइना फ़ाइनेंस ऑनलाइन 
Fort san filipet 	फोर्ट सैन फिलीपेट 
Stephen Peall 	स्टीफन पील 
Duniya Meri Jeb Mein 	दुनिया मेरी जेब में 
Sir John Soane's Museum 	सर जॉन सॉन्स म्युज़ियम 
Daniyawan Bazar 	दनियावान बाज़ार 
Punjab Lancers 	पंजाब लैंसर्स 
Shaun Graf 	शॉन ग्रेफ 
David Bernard 	डेविड बरनार्ड 
Maharani Jhansi 	महारानी झाँसी 
Saheb Biwi Aur Gulam 	साहब बीवी और गुलाम 
Khoon Ki Takkar 	खून की टक्कर 
Beverly Sills 	बिवर्ले सिल्स 
Abdul haakim 	अब्दुल हाकिम 
Bandhan Kachchey Dhagon Ka 	बंधन कच्चे धागों का 
Bir Bikrom 	बीर बिक्रोम 
Wood Buffalo 	वूड बफेलो 
Abdul maalik 	अब्दुल मालिक 
Duncan Fletcher 	डंकन फ्लेचर 
Salam Bombay 	सलाम बॉम्बे 
Grammy Hall of Fame Award 	ग्रैमी हॉल ऑफ फेम अवार्ड 
Monde Zondeki 	मोंडे ज़ोंडेकी 
Saint Francis D'Assisi High School 	सेंट फ्रांसिस ड‍िअस‍ीसी हाई स्कूल 
Taka Bone Rate 	टाका बोने रेट 
Isi Ka Naam Duniya Hai 	इसी का नाम दुनिया है 
Fort ellice 	फोर्ट एलिस 
Aanchal Ke Phool 	आँचल के फूल 
Do Thug 	दो ठग 
Palma de Mallorca 	प्लामा डे मल्लोर्का 
Great Britain 	ग्रेट ब्रिटेन 
Tu Nagin Main Sapera 	तू नागिन मैं सपेरा 
Siddhamalli Reservoir 	सिद्धामली रिज़रवायर 
Vic Pollard 	विक पोलार्ड 
SAP India 	सैप इंडिया 
Naqli Nawab 	नकली नवाब 
Hum Intezaar Karenge 	हम इंतज़ार करेंगे 
Damien Martyn 	डेमिन मार्टिन 
Fort delaware 	फोर्ट डेलावेयर 
Kahani Ek Chor Ki 	कहानी एक चोर की 
Hashim Amla 	हाशिम अम्ला 
Linganamakki Dam 	लिंगनमक्की डैम 
Gurudwara Makka Madina 	गुरूद्वारा मक्का मदीना 
Nar Narayan 	नर नारायण 
Pyasi Nigahen 	प्यासी निगाहें 
Progressive Baptist 	प्रोगेसिव बैपटिस्ट 
Hum Sub Ustad Hain 	हम सब उस्ताद हैं 
Gurudwara Tahliana Sahib 	गुरूद्वारा टाहलीआणा साहिब 
Fort worden 	फोर्ट वॉर्डन 
Order of Christ 	ऑडर ऑफ क्राइस्ट 
Jacques Kallis 	जैक्वेस कैलिस 
Gurudwara Fatihgarh Sahib 	गुरूद्वारा फतिहगढ़ साहिब 
Major League Lacrosse Most Improved Player of the Year Award 	मेजर लीग लैक्रोस मोस्ट इम्प्रूव्ड प्लेयर ऑफ द ईयर अवार्ड 
Kal Kya Hoga 	कल क्या होगा 
Jawani Ki Bhool 	जवानी की भूल 
Fort cartwright 	फोर्ट कार्टराइट 
Amadeus Mozart 	एमॅड्यूस मोज़ार्ट 
Baap Beti 	बाप बेटी 
Anokhi Ada 	अनोखी अदा 
Mike Whitney 	माइक व्हिटने 
Debu Chaudury 	देबू चौधरी 
Fort nathan hale 	फोर्ट नैथन हेल 
Precision Valley Corvette Museum 	प्रिस‍िज़न वैली कॉरवेट म्युज़ियम 
War of the Second Coalition 	वार ऑफ द सेकंड कॉलिशन 
Abdul hakeem 	अब्दुल हकीम 
Sri Adhikari 	श्री अधिकारी 
Order of Industrial Merit 	ऑडर ऑफ इंडस्ट्रियल मेरिट 
Barry Unsworth 	बेरी अनसोर्थ 
Robert Wagner 	रॉबर्ट वॅगनर 
Kiski Jeet 	किसकी जीत 
Magna International 	मैग्ना इंटरनेशनल 
Mithi Nazar 	मीठी नज़र 
Teri Kasam 	तेरी कसम 
Indika de Saram 	इंडिका डे सारम 
Rhode Island 	रॉड आइलैंड 
Brad Hodge 	ब्रैड हॉज 
Vembakottai Reservoir 	वेम्बकोत्ताई रिज़रवायर 
Shah E Iran 	शाह ए ईरान 
Internet Gold Golden Lines 	इंटरनेट गोल्ड गोल्डन लाइन्स 
Andy Lloyd 	एण्डी लॉएड 
Lynn Canyon Suspension 	ल्येन कॅन्योन सस्पेंशन 
Gurudwara Nanakmata 	गुरूद्वारा नानकमता 
Paise Ki Gudiya 	पैसे की गुड़िया 
Man Industries 	महिंद्रा इंडस्ट्रीज़ 
Aaj Ki Duniya 	आज की दुनिया 
Madam Zapatta 	मैडम ज़पाट्टा 
Hilton Group 	हिल्टन ग्रुप 
Raja Gopichand 	राजा गोपीचंद 
Kahf Hoti 	काफ़ होटी 
Premio Camoes 	प्रेमियो कैमोस 
Abdul basir 	अब्दुल बसीर 
Abdul basit 	अब्दुल बासित 
Gurudwara Bhatta Sahib 	गुरूद्वारा भट्टा साहिब 
Pet Pyar Aur Paap 	पेट प्यार और पाप 
Tum Par Hum Quarban 	तुम पर हम क़ुर्बान 
Balrampur Chini 	बलरामपुर चीनी 
University of Keele 	यूनिवर्सिटी ऑफ कीले 
Khoon Khoon 	खून खून 
Naya Daur 	नया दौर 
Ernest Hemingway 	अर्नेस्ट हेमिंग्वे 
Satish Gujral 	स‍तीश गुजराल 
Nottingham East Midlands 	नॉटिंगहॅम ईस्ट मिडलैंड्‍स 
Maar Dhaad 	मार धाड़ 
Mohammad Zahid 	मोहम्मद ज़ाहिद 
Sanyo Electric 	सैन्यो इलेक्ट्रिक 
Apna Paraya 	अपना पराया 
Fort carroll 	फोर्ट कैरॉल 
Order of Nakhimov 	ऑडर ऑफ नखीमोव 
Golden Temple 	गोल्डन टेम्पल 
Duniya Gol Hai 	दुनिया गोल है 
Gomantak times 	गोमंतक टाइम्स 
Alstom Projects 	आल्सटॉम प्रोजेक्ट्स 
Groupe Auchan 	ग्रुप ऑचन 
Anokha Daan 	अनोखा दान 
Hindustan Motors 	हिंदुस्तान मोटर्स 
Sur gaayak 	सुर गायक 
Abdul wadood 	अब्दुल वदूद 
Insaaf Ki Awaz 	इंसाफ की आवाज़ 
Rashk E Laila 	रश्क ए लैला 
Ricardo Powell 	रिकार्डो पॉवेल 
Aag Aandhi Aur Toofan 	आग आँधी और तूफान 
Alvin Kallicharran 	एल्विन कालीचरन 
Grah Laxmi 	गृह लक्ष्मी 
General Electric 	जनरल इलेक्ट्रिक 
Dulip Samaraweera 	दुलीप सामरावीरा 
Jism Ka Rishtaa 	जिस्म का रिश्ता 
Nevado de Colima 	नेव्हाडो डी कोलीमा 
Mark Burgess 	मार्क बर्गेस 
Ashish Kapoor 	आशीष कपूर 
Bwindi Impenetrable 	बीविंडी इम्पेनिट्रेबल 
Ghar Parau 	घर परेयु 
Sorrento 1 	सॉरेन्टो 1 
Pambar Reservoir 	पम्बर रिज़रवायर 
Madan Lal 	मदन लाल 
Kumkum The Dancer 	कुमकुम द डांसर 
Sati Narmada 	सती नर्मदा 
Mana Pools 	माना पूल्स 
Cedar Mill Bible 	केडार मिल बायबल 
Bandhan Bahon Ka 	बंधन बाँहों का 
Manzil Manzil 	मंज़िल मंज़िल 
Indra Sabha 	इंद्र सभा 
Bade Bhaiya 	बड़े भइया 
Aage Ki Soch 	आगे की सोच 
Oswald Veblen Prize in Geometry 	ऑसवल्ड वेब्लेन प्राइज़ इन ज्योमेट्री 
Willie Brown 	विली ब्राउन 
Miss Manorama 	मिस मनोरमा 
San Saba 	सैन साबा 
Yohan Goonasekera 	योहन गूरसेकरा 
Prickett's fort 	प्रिकेट्‍स फोर्ट 
Kinare Kinare 	किनारे किनारे 
Anglo-French War 	एंग्लो-फ्रेंच वार 
Kanoon Ki Awaaz 	कानून की आवाज़ 
Arthur haley 	आर्थर हॅले 
Kris Srikkanth 	क्रिस श्रीकांत 
Ashish Nehra 	आशीष नेहरा 
United Kingdom 	यूनाइटेड किंगडम 
Gulf Islands 	गल्फ आयलैंड 
Batala Junction 	बटाला जंक्शन 
Tata Tea 	टाटा टी 
Jo Angel 	जॉ एंजेल 
Sati Nagkanaya 	सती नागकन्या 
Aadmi Sadak Ka 	आदमी सड़क का 
Agni Sakshi 	अग्नि साक्षी 
Nayan Mongia 	नयन मोंगिया 
Aaj Ki Taza Khabar 	आज की ताज़ा खबर 
Andheri Raat Mein Diya Tere Hath Mein 	अंधेरी रात में दिया तेरे हाथ में 
Vijay Bharadwaj 	विजय भारद्वाज 
Aakhri Kasam 	आखिरी कसम 
Pahadi Nagin 	पहाड़ी नागिन 
Thoppaiyar Reservoir 	थोपइयर रिज़रवायर 
Shankar Khan 	शंकर खान 
North East Land 	नॉर्थ इस्ट लैंड 
Wade Seccombe 	वेड सेकॉम्ब 
Jai Hanuman 	जय हनुमान 
Dartmouth fort 	डार्टमाउथ फोर्ट 
Ganga Ki Lehren 	गंगा की लहरें 
Demi Moore 	डेमी मूर 
Order of Courage 	ऑडर ऑफ करेज 
James Hopes 	जेम्स होप्स 
Anura Tennekoon 	अनुरा टेनेकून 
Andy Flower 	एण्डी फ्लार 
Fernado de Noronha Marine 	फर्नेंडो डी नॉरोन्हा मरीन 
Stele Forest Museum 	स्टेल फॉरेस्ट म्युज़ियम 
Gola Gokaranath 	गोला गोकरनाथ 
Order of the White Lion 	ऑडर ऑफ़ द व्हाइट लायन 
Malati Madhav 	मालती माधव 
Hanuman Chalisa 	हनुमान चालीसा 
Craig Cumming 	क्रेग क्युमिंग 
Orange Prize for Fiction 	ऑरेंज प्राइज़ फॉर फिक्शन 
Winston Benjamin 	विंस्टन बेंजामिन 
Gavin Briant 	गेविन ब्रायंट 
Chennai Petro 	चेन्नई पेट्रो 
Insaaf Ki Pukar 	इंसाफ की पुकार 
Matt Prior 	मैट प्रायर 
John Tash 	जॉन टॅश 
National Transport Museum of Ireland 	नेशनल ट्रांसपोर्ट म्युज़ियम ऑफ आयरलैंड 
Kunwara Baap 	कुँवारा बाप 
Phaansi Ke Baad 	फाँसी के बाद 
Faoud Bacchus 	फॉड बैचुस 
Hamen Khelne Do 	हमें खेलने दो 
Prem Sangeet 	प्रेम संगीत 
David Brain 	डेविड ब्रेन 
Strait of Hormuz 	स्ट्रेट ऑफ होरमज़ 
Suryanar Koil 	सूर्यानार कोयील 
Osaka World Trade Center 	ओसाका वर्ल्ड ट्रेड सेन्टर 
Hind Constr 	हिंद कंसट्रक्शन 
Tchernichovsky Prize 	चेर्निकोवस्की प्राइज़ 
Bhedi Lutera 	भेदी लुटेरा 
Kan Kan Men Bhagwan 	कण कण में भगवान 
Jai Mahalaxmi Maa 	जय महालक्ष्मी माँ 
Gary Kirsten 	गैरी किर्स्टन 
Abdul afuw 	अब्दुल अफुव 
Bade Sarkar 	बड़े सरकार 
Peechha Karoo 	पीछा करूँ 
Isle of wight 	आइसल ऑफ विट 
University of Sheffield 	यूनिवर्सिटी ऑफ शेफफील्ड 
Sajjad Akbar 	सज्जाद अकबर 
Pankaj Dharmani 	पंकज धरमानी 
Andy Bichel 	एण्डी बिचेल 
Gharwali Baharwali 	घरवाली बाहरवाली 
Waste Management 	वेस्ट मैनेजमेंट 
Mohammad Salim 	मोहम्मद सलीम 
Manu The Great 	मनु द ग्रेट 
Lal Bujhakkad 	लाल बुझक्कड़ 
Alan Dawson 	ऐलन डॉसन 
Shalimar Paints 	शालीमार पेंट्स 
Aaj Ke Angaarey 	आज के अँगारे 
Naag Nagin 	नाग नागिन 
Major League Lacrosse Defensive player of the Year Award 	मेजर लीग लैक्रोस डिफेंसिव प्लेयर ऑफ द ईयर अवार्ड 
Andros Maritime Museum 	एण्ड्रॉस मैर‍िटाइम म्युज़ियम 
Pick Pocket 	पिक पॉकेट 
Char Din 	चार दिन 
Willingdon Reservoir 	विलिंगडन रिज़रवायर 
Magic Johnson 	मैजिक जॉनसन 
Basketball Hall of Fame 	बास्केटबॉल हॉल ऑफ फेम 
Franz Haniel 	फ़्रांज़ हेनीयल 
World Championships in Biathlon 	वर्ल्ड चैंपियनशिप इन बैथलन 
Iron Cross 	आइरन क्रॉस 
Shah E Misar 	शाह ए मिसर 
Albela Mastana 	अलबेला मस्ताना 
Balika Badhu 	बालिका बधू 
Sadagoppan Ramesh 	सदागोप्पन रमेश 
Richard Webb 	रिचर्ड वेब 
Ian Bradshaw 	इआन ब्रेडशॉ 
Anthony Ireland 	एंथनी आयरलैंड 
Sigmund Freud 	सिगमंड फ़्रुड 
Bhogpur Sirwal 	भोगपुर सरवल 
Ashley de Silva 	ऐश्ले डे सिल्वा 
Barchi Road 	बारची रोड 
Mil Gai Manzil Mujhe 	मिल गई मंजिल मुझे 
Stuart Carlisle 	स्टुअर्ट कार्लिस्ले 
Peter Ueberroth 	पीटर युबेरोथ 
Jwaharlal nehru University india 	जवाहरलाल नेहरु यूनिवर्सिटी इंडिया 
Erzherzog Karl 	अर्ज़रज़ोग कार्ल 
Federal Bank 	फ़ेडेरल बैंक 
Robert Laughlin 	रॉबर्ट लाफलिन 
Fort de kock 	फोर्ट डे कॉक 
Block Island 	ब्लॉक आइलैंड 
English tango 	इंग्लिश टैंगो 
Himalay Ki God Mein 	हिमालय की गोद में 
Steele Prize 	स्टील प्राइज़ 
Gurudwara Kareer Sahib 	गुरूद्वारा करीर साहिब 
Yaar Kasam 	यार कसम 
Amritlal nagar 	अमृतलाल नागर 
Behram Khan 	बेहराम खान 
Kurfurst Friedrich Wilhelm 	कर्फस्ट फ्रेडरिक विल्हेम 
Derek Pringle 	डेरेक प्रिंगल 
British Book Awards 	ब्रिटिश बुक अवार्ड्‍स 
Francesco Caracciolo 	फ्रांसेस्को केरासिओलो 
Miss Frontier Mail 	मिस फ्रंटियर मेल 
Greg Thomas 	ग्रेग थॉमस 
Veer Bhimsen 	वीर भीमसेन 
Naya Kadam 	नया कदम 
State Tower 	स्टेट टॉवर 
Tipper Gore 	टिपर गोर 
Andrew Jones 	एण्ड्रयू जोंस 
Bob Woolmer 	बॉब वूल्मर 
Asli Naqli 	असली नकली 
The humber forts 	द हंबर फोर्ट्‍स 
Neera Aur Nanda 	नीरा और नंदा 
Adam Bacher 	ऐडम बैचर 
Tom Cruise 	टॉम क्रुज़ 
Sant Kabir 	संत कबीर 
Saat Samunder Paar 	सात समुंदर पार 
Abdul wasi 	अब्दुल वसी 
Nartaki Chitra 	नर्तकी चित्र 
Rallis India 	रैलिस इंडिया 
Sati Anjani 	सती अंजनी 
Bhuvaneswari Hindu 	भुवनेस्वरी हिन्दू 
Allahabad City 	अलाहाबाद सिटी 
John von Neumann Theory Prize 	जॉन वॉन न्युमेन थ्योरी प्राइज़ 
Order of the Golden Fleece 	ऑडर ऑफ द गोल्डन फ्लीस 
Saint Louis 	सेंट लुइस 
Bhai Jaan 	भाई जान 
Saint John's High School, Chandigarh 	सेंट जॉन्‍स हाई स्कूल, चंडीगढ़ 
University of East London 	यूनिवर्सिटी ऑफ ईस्ट लंडन 
John Carson 	जॉन कार्सन 
Burbara Bush 	बारबरा बुश 
Gurudwara Thanda Burj 	गुरूद्वारा ठंडा बुर्ज 
Los Marmoles 	लॉस मार्मोल्स 
Phansi Ka Phanda 	फाँसी का फंदा 
Jammu and Kashmir 	जम्मू एण्ड कश्मीर 
Chris Gayle 	क्रिस गेल 
High Island Reservoir 	हाई आइलैंड रिज़रवायर 
Lychnostatis Open-air Museum 	ल‍िक्नोस्टेट‍िस ओपन-एयर म्युज़ियम 
Daku Mansoor 	डाकू मंसूर 
Phir Janam Lenge Hum 	फिर जनम लेंगे हम 
Mark Ramprakash 	मार्क रामप्रकाश 
Tarzan And Cobra 	टार्ज़न एण्ड कोबरा 
Ron Headley 	रॉन हेडले 
Tewaaraton Trophy 	टेवारटन ट्रॉफी 
China TechFaith Wireless Communication Technology Limited 	चाइना टेकफ़ेथ वायरलेस कम्युनिकेशन टेक्नोलॉजी लिमिटेड 
Summerside United Methodist 	समरसाइड यूनाइटेड मेथोडिस्ट 
Satah Se Uthata Adami 	सतह से उठता आदमी 
Suresh Raina 	सुरेश रायना 
Darbhanga Junction 	दरभंगा जंक्शन 
Bryan Strang 	ब्रायन स्ट्रेंग 
Abdur rashid 	अब्दुर रशीद 
Ayatollah Khomeini 	अयातुल्लाह खोमेनी 
Delta Galil Industries 	डेल्टा गलिल इंडस्ट्रीज़ 
Fort ethan allen 	फोर्ट एथन ऐलन 
Prem Pujari 	प्रेम पुजारी 
Landguard fort 	लैंडगार्ड फोर्ट 
David Gower 	डेविड गॉवर 
Munich Re Group 	मुनिच री ग्रुप 
Margo Caribe 	मार्गो कैरिब 
Memorial Baptist 	मेमोरियल बैपटिस्ट 
The afternoon 	द आफ्टरनून 
Ganga Mang Rahi Balidan 	गंगा माँग रही बलिदान 
Redoute de tallaert 	रिडाउट डे टैलार्ट 
Ram Balram 	राम बलराम 
Bensonvale Covenant 	बेनसोन्व्हले कॉन्व्हेन्ट 
The British School, New Delhi 	द ब्रिटिश स्कूल, न्यू डेल्ही 
Anou Timedouine 	अनाउ टाइमडोयून 
Seth Mukand Lal Inter College, Ghaziabad 	सेठ मुकुंद लाल इंटर कॉलेज, गाज़ियाबाद 
Whitney Museum of American Art 	व्ह‍िटनी म्युज़ियम ऑफ अमेर‍िकन आर्ट 
Mangla Gauri 	मंगला गौरी 
George Harrison 	जॉर्ज हैरिसन 
Zahoor Elahi 	ज़हूर इलाही 
Abdul khaleeq 	अब्दुल खलीक 
Lower Nirar Reservoir 	लोवर निरार रिज़रवायर 
Zaporizhian sich 	ज़ैपोरीज़िआन सिच 
Crescent City 	क्रेसेंट सिटी 
Khamosh Sipahi 	खामोश सिपाही 
Echo Mountain 	ईको माउंटन 
The drawing center 	द ड्रॉइंग सेंटर 
Milton Small 	मिल्टन स्मॉल 
Aag Aur Shola 	आग और शोला 
Laheri Lala 	लहरी लाला 
Hayo del Aire 	हेयो डेल आइरी 
George Lucas 	जॉर्ज लुकास 
Indra Leela 	इंद्र लीला 
Carmel Convent School, Chandigarh 	कारमेल कॉन्‍वेंट स्कूल, चंडीगढ़ 
Fort le vieux 	फोर्ट ले व्युक्स 
Jane Fonda 	जेन फ़ोंडा 
Achcha Bura 	अच्छा बुरा 
Do Matwale 	दो मतवाले 
Ram Rajya 	राम राज्य 
Rayban Sun 	रेबन सन 
Chanda Fort 	चंदा फोर्ट 
Dale Benkenstein 	डेल बेन्कनस्टीन 
Carl Cachopa 	कार्ल केचोपा 
Mujhe Shakti Do 	मुझे शक्ति दो 
Himalay Ki Beti 	हिमालय की बेटी 
Topeka Bible 	टोपेका बायबल 
Cronos Group 	क्रॉनोस ग्रुप 
Ian Smith 	इआन स्मिथ 
Yeh Woh Manzil To Nahin 	ये वो मंज़िल तो नहीं 
Gurudwara Likhansar 	गुरूद्वारा लिखणसार 
Chandni Raat 	चाँदनी रात 
Sierra San Pedro Martir 	सिर्रा सैन पेड्रो मार्टिर 
University of Adelaide 	यूनिवर्सिटी ऑफ एडेलेड 
Al-Faisaliah Center 	अल-फैसलीअह सेन्टर 
Dak Babu 	डाक बाबू 
Bombay Masjid 	बॉम्बे मस्जिद 
Hamara Watan 	हमारा वतन 
Electricite De France 	इलेक्ट्रीसाइट डी फ़्रांस 
Draupadi Vastra Haran 	द्रौपदी वस्त्र हरण 
Aansoo Aur Muskan 	आँसू और मुस्कान 
Shafiuddin Ahmed 	शफीउद्दीन अहमद 
Rameez Raja 	रमीज़ राजा 
Sanjay Raul 	संजय राउल 
Kutte Ki Kahani 	कुत्ते की कहानी 
Abdul hadi 	अब्दुल हदी 
Nordea Bank 	नोर्डिया बैंक 
Naya Ghar 	नया घर 
Bhed Bhav 	भेद भाव 
Lalchand Rajput 	लालचंद राजपूत 
Abdul muid 	अब्दुल मुईद 
Desmond Haynes 	डेस्मंड हेन्स 
Asif Mohammad 	आसिफ मोहम्मद 
Pearson Medal of Peace 	पीयरसन मेडल ऑफ पीस 
Star of mysore 	स्टार ऑफ मैसूर 
Novamerican Steel 	नोवामेरिकन स्टील 
Romesh Bhandari 	रोमेश भंडारी 
Kelavarapalli Reservoir 	केलावरापल्ली रिज़रवायर 
Sai Baba of Shirdi 	सांई बाबा ऑफ शिर्डी 
Hua Savera 	हुआ सवेरा 
Subex Systems 	सुबेक्स सिस्टम्स 
Sant Tukaram 	संत तुकाराम 
Khoon Kharaba 	खून खराबा 
Anthony Stuart 	एंथनी स्टुआर्ट 
Kahani Hum Sab Ki 	कहानी हम सब की 
Ian Bishop 	इआन बिशप 
Brick Schoolhouse Museum 	ब्रिक स्कूलहाउस म्युज़ियम 
Schiller Prize 	शिलर प्राइज़ 
Shaw Prize 	शॉ प्राइज़ 
Lasker Award 	लास्कर अवार्ड 
Ann Landers 	एन लैंडर्स 
Dekha Jayega 	देखा जाएगा 
Mitsubishi Tokyo Financial Group 	मित्सुबिशी टोक्यो फ़ाइनेंशियल ग्रुप 
University of Gloucestershire 	यूनिवर्सिटी ऑफ ग्लॉसेस्टरशायर 
Wilf Slack 	विल्फ स्लैक 
Dil Ki Rahen 	दिल की राहें 
Satte Pe Satta 	सत्ते पे सत्ता 
Bartaman patrika 	बर्तमान पत्रिका 
Bhagam Bhag 	भागम भाग 
Abdul mani 	अब्दुल मनी 
Aamer Sohail 	आमेर सोहेल 
Order of the National Coat of Arms 	ऑडर ऑफ द नेशनल कोट ऑफ आर्म्‍स 
Patthar Ka Khwab 	पत्थर का ख्वाब 
Canaan Presbyterian 	कॉनान प्रेस्बिटेरिटन 
Fort independence 	फोर्ट इंडिपेंडेन्स 
Chand Ki Duniya 	चाँद की दुनिया 
Bir Protik 	बीर प्रोतीक 
Dudhia Khurd 	दूधिया खुर्द 
Albert Gore 	अल्बर्ट गोर 
Prabath Nissanka 	प्रभाथ निस्संका 
Whoopi Goldberg 	व्हूपी गोल्डबर्ग 
Fort clark 	फोर्ट क्लार्क 
Nai Zindagi 	नई ज़िंदगी 
Turner Prize 	टर्नर प्राइज़ 
Iqbal Sikander 	इकबाल सिकन्दर 
Patni Computer 	पटनी कम्प्यूटर्स 
Abdur rahman 	अब्दुर रहमान 
Alpine Skiing World Cup 	एल्पाइन स्कीइंग वर्ल्ड कप 
Steve Waugh 	स्टीव वॉ 
Bahadur Daku 	बहादुर डाकू 
Shanghai Baosteel Group 	शंघाई बाओस्टील ग्रुप 
Rajput Ramani 	राजपूत रमणी 
Prem Sandesh 	प्रेम संदेश 
Manjural Islam Rana 	मंजुरल इस्लाम राणा 
Country western two-step 	कंट्री वेस्टर्न टू-स्टेप 
Sesa Goa 	सेसा गोवा 
The Japan Prize 	द जापान प्राइज़ 
National Art Gallery and Alexandros Soutzos Museum 	नेशनल आर्ट गैलरी एण्ड एलेक्ज़ैंड्रस सुज़ॉस म्युज़ियम 
Elron Electronic Industries 	एलरॉन इलेक्ट्रॉनिक इंडस्ट्रीज़ 
Agent Vinod 	एजेंट विनोद 
Svenska Akademins nordiska pris 	स्वेंस्का एकाडेमिंस नॉरडिस्का प्रिस 
Peter Taylor 	पीटर टेलर 
New Springs Christian 	न्यू स्प्रिंग्स क्रिश्चियन 
Sim Sim Marjina 	सिम सिम मर्जीना 
Chhora Chhori 	छोरा छोरी 
The Broads 	द ब्रॉड्स 
Priestley Medal 	प्रीस्टले मेडल 
Global Trust Bank 	ग्लोबल ट्रस्ट बैंक 
John Dyson 	जॉन डायसन 
Door Gagan Ki Chhaon Mein 	दूर गगन की छाँव में 
Christ the King Lutheran 	क्रिस्ट दी किंग लुथेरान 
Kato Kaelin 	किट्टी कैली 
Aur Pyar Ho Gaya 	और प्यार हो गया 
Everton Mattis 	एवर्टन मैटिस 
Rokeby Museum 	रोकबाय म्युज़ियम 
British Airways 	ब्रिटिश एयरवेज़ 
Dougie Brown 	डग ब्राउन 
Canada Southern Petroleum 	कनाडा साउदर्न पेट्रोलियम 
Robert Downing Junior 	रॉबर्ट डाउनिंग ज्युनियर 
Dronachellam Junction 	द्रोनाकेलम जंक्शन 
NET Servicos de Comunicacao 	नेट सर्विकोज़ डी कम्युनिकाकेओ 
Wasim Jaffer 	वसीम जाफर 
Dominic Cork 	डॉमिनिक कॉर्क 
Gurudwara Omkareshwar 	गुरूद्वारा ओंकारेशवर 
Charno Ki Saughandh 	चरणों की सौगंध 
George Pack 	जॉर्ज पैक 
Meri Surat Teri Ankhen 	मेरी सूरत तेरी आँखें 
Farokh Engineer 	फारोख इंजीनियर 
Beesvi Sadi 	बीसवी सदी 
Yeshiva University Museum 	येश‍िवा युन‍िवर्स‍िटी म्युज़ियम 
Baaz Bahadur 	बाज़ बहादुर 
Guru granth sahib 	गुरू ग्रंथ साहिब 
Alfred Tennison 	अल्फ़्रेड टेनीसन 
Kevin Costner 	केविन कॉस्टनर 
Jeevan Prabhat 	जीवन प्रभात 
Sarovar Park 	सरोवर पार्क 
Harunur Rashid 	हरुनर रशीद 
Gop Jam 	गोप जाम 
Andha Intequam 	अंधा इंतेक़ाम 
Chorvad Road 	चोरवड़ रोड 
Shahriar Nafees 	शहरियार नफीस 
Dil Bhi Tera Hum Bhi Tere 	दिल भी तेरा हम भी तेरे 
Russell Krovi 	रसेल क्रोवी 
Geoff Howarth 	जिऑफ हॉवर्थ 
Fort point 	फोर्ट पॉइंट 
Vijaya High School, Jayanagar, Bangalore 	विद्या हाई स्कूल, जयनगर, बैंगलोर 
Ernesettle fort 	अर्नसेटल फोर्ट 
Randgold Resources Limited 	रैंडगोल्ड रिसोर्सेज़ लिमिटेड 
Salahuddin Ahmed 	सलाहुद्दीन अहमद 
Grey art Gallery 	ग्रे आर्ट गैलरी 
Naya Paisa 	नया पैसा 
Light House 	लाइट हाउस 
Saman Jayantha 	समन जयंथा 
Alan Connolly 	एलन कॉनोली 
University of Bournemouth 	यूनिवर्सिटी ऑफ बॉर्नमाउथ 
Geeta Ki Saugandh 	गीता की सौगंध 
Justin Kemp 	जस्टिन केंप 
Kaun Kitney Pani Mein 	कौन कितने पानी में 
Kar Bhala 	कर भला 
Nawab Sirazuddaula 	नवाब सिराज़ुद्‍दौला 
Mary Antoinette 	मेरी एंटॉइनेट 
Sasti Dulhan Mahenga Doolha 	सस्ती दुल्हन महँगा दुल्हा 
Ek Se Bhale Do 	एक से भले दो 
Bhusaval Junction 	भुसावल जंक्शन 
Birur Junction 	बिरुर जंक्शन 
Alexander Agassiz Medal 	अलेक्ज़ेंडर अगासीज़ मेडल 
Kyle Mills 	काइल मिल्स 
Municipal Gallery of Corfu 	म्युन‍िस‍िपल गैलरी ऑफ कोरफू 
Clive Rice 	क्लाइव राइस 
Chhori Gaon Ki 	छोरी गाँव की 
Captain Sheroo 	कैप्टन शेरू 
Coca-Cola India 	कोका-कोला इंडिया 
Nippon Oil 	निप्पॉन ऑइल 
Maa Kasam Badla Loonga 	माँ कसम बदला लूँगा 
European Figure skating Champions 	युरोपियन फिगर स्केटिंग चैंपियन्स 
Scout Camp 	स्काउट कैंप 
Rani Sahiba 	रानी साहिबा 
Lal Patthar 	लाल पत्थर 
La Bela 	ला बेला 
Shane Warne 	शेन वार्न 
Bruce Yardley 	ब्रूस यार्डले 
Baba Fakruddin 	बाबा फकरूद्दीन 
Bob Taylor 	बॉब टेलर 
Royal Ontario Museum 	रॉयल ऑन्टार‍ियो म्युज़ियम 
Aaj Ke Shahanshah 	आज के शहँशाह 
Varadamanadhi Reservoir 	वरदामनधी रिज़रवायर 
Ambala City 	अम्बाला सिटी 
George Carlin 	जॉर्ज कार्लिन 
Central Bank 	सेंट्रल बैंक 
Khooni Kaun 	खूनी कौन 
Spathareion Museum of the Shadow Theatre 	स्पाथेर‍ियन म्युज़ियम ऑफ द शैडो थ‍िएटर 
Glenn Turner 	ग्लेन टर्नर 
Christopher Marlowe 	क्रिस्टोफ़र मारलो 
Vijay Yadav 	विजय यादव 
Mahajana High School 	महाजन हाई स्कूल 
Hemantha Wickramaratne 	हेमंथा विक्रमारत्ने 
Kali Raat 	काली रात 
Keith Arthurton 	कैथ अर्थर्टन 
James Laughlin Award 	जेम्स लॉफलिन अवार्ड 
Aakhri Nishchay 	आखिरी निश्चय 
Abdul qadeer 	अब्दुल कदीर 
Chhota Gudha 	छोटा गुधा 
Zsa zsa 	ज़ा ज़ा 
Larry King 	लैरी किंग 
Baghi Sardar 	बागी सरदार 
Orckit Communications 	ऑर्किट कम्यूनिकेशन्स 
Iran Ki Ek Raat 	ईरान की एक रात 
Robert Atkins 	रॉबर्ट एटकिन्स 
National Museum of Denmark 	नेशनल म्युज़ियम ऑफ डेनमार्क 
Ajir asom 	अजीर असोम 
Kaurav Pandav 	कौरव पांडव 
National Public School 	नेशनल पब्लिक स्कूल 
Bundi fort 	बूँदी फोर्ट 
Chhote Babu 	छोटे बाबू 
Anou Achra Lemoun 	अनाउ एचरा लेमोन 
Shenzhen Special Zone Daily Tower 	शेन्ज़ेन स्पेशल ज़ोन डेली टॉवर 
Fifty Fifty 	फिफ्टी फिफ्टी 
Koningen Regentes 	कॉनिंगन रीजेंटेस 
Bert Vance 	बर्ट वैंस 
Howrah Express 	हावड़ा एक्सप्रेस 
Liam Plunkett 	लैम प्लंकेट 
Fortaleza do monte 	फोर्टालेज़ा डो मॉन्टे 
Grace Lutheran 	ग्रेस लुथरेन 
Bombay War 	बॉम्बे वार 
University of Tokyo 	यूनिवर्सिटी ऑफ टोक्यो 
Bushnell's Museum 	बुशनेल्स म्युज़ियम 
The Living Well United Methodist 	द लिविंग वेल यूनाइटेड मेथोडिस्ट 
Do Chor 	दो चोर 
Anmol Ghadi 	अनमोल घड़ी 
Babagon Dam 	बाबागोन डैम 
Greg Blewett 	ग्रेग ब्लेवेट 
Gauri Phanta 	गौरी फांटा 
Tsavo East 	त्सावो ईस्ट 
Black Mailer 	ब्लैक मेलर 
Rei Agro 	री एग्रो 
Usman Afzaal 	उस्मान अफज़ाल 
Aztec Software 	एज़्टेक सॉफ़टवेयर 
Ek Main Aur Ek Tu 	एक मैं और एक तू 
University of South Queensland 	यूनिवर्सिटी ऑफ साउथ क्वीन्सलैंड 
Sri Shakti 	श्री शक्ती 
Fort wood 	फोर्ट वुड 
Gurudwara Gowindwal Sahib 	गुरूद्वारा गोविंदवाल साहिब 
Abdus saami 	अब्दुस सामी 
Jonathan Winters 	जोनॅथन विंटर्स 
Johan Botha 	जोहन बोथा 
Kaun Jeeta Kaun Haara 	कौन जीता कौन हारा 
Abdul muhayameen 	अब्दुल मुहायमीन 
Hum Panch 	हम पाँच 
Sabiha Gokcen 	साबिहा गॉकेन 
Richard Pryor 	रिचर्ड प्रेयोर 
Dodda Ganesh 	डोडा गणेश 
Motor Cycle Racing 	मोटर सायकल रेसिंग 
Shane Thomson 	शेन थॉमसन 
Dev gaayak 	देव गायक 
Vinod Kambli 	विनोद कांबली 
Sonia Gandhi 	सोनिया गांधी 
Fats Domino 	फ़ेट्स डोमिनो 
Fort mcandrew 	फोर्ट मैकएण्ड्रयू 
Anglo-Dutch War 	एंग्लो-डच वार 
Sina Corporation 	सिना कॉर्पोरेशन 
Man Group 	मैन ग्रुप 
Nagasaki University 	नागासाकी यूनिवर्सिटी 
Serra dos orgaos 	सेरा डॉस ऑरगाओस 
Man Ki Ankhen 	मन की आँखें 
Gurudwara Nadala Sahib 	गुरूद्वारा नडाला साहिब 
Ram Bharose 	राम भरोसे 
Nathdwara Temple 	नाथद्वारा टेम्पल 
Dooj Ka Chand 	दूज का चाँद 
Abdul Paula 	अब्दुल पाउला 
Gurudwara Mata Kaulan ji 	गुरूद्वारा माता कौलां जी 
Mahashweta Devi 	महाश्वेता देवी 
Ladies Only 	लेडीज़ ओनली 
Jungle King 	जंगल किंग 
Pyari Behna 	प्यारी बहना 
Neecha Nagar 	नीचा नगर 
Amar Deep 	अमर दीप 
Arnala fort 	अरनाला फोर्ट 
Rocky Mount 	रॉकी माउंट 
Sweekar Kiya Maine 	स्वीकार किया मैंने 
Daman and Deev 	दमन एण्ड दीव 
Akash Pari 	आकाश परी 
Fateh Singhpura 	फतेह सिंहपुरा 
Biwi Ho To Aisi 	बीवी हो तो ऐसी 
Spitbank fort 	स्पिटबैंक फोर्ट 
Fortaleza da guia 	फोर्टालेज़ा दा गुइआ 
Dennis Amiss 	डेनिस एमिस 
Chattan Singh 	चट्‍टान सिंह 
Origins Award 	ऑरिजिन्स अवार्ड 
Bank of China 	बैंक ऑफ चायना 
Ashok Mankad 	अशोक मांकड़ 
Howard Hughes 	हॉवर्ड ह्युजे 
Raja Radhika Prasad 	राजा राधिका प्रसाद 
Top Image Systems 	टॉप इमेज सिस्टम्स 
Bel AIr United Methodist 	बेल अल्र यूनाइटेड मेथोडिस्ट 
Wheelchair Basketball 	व्हीलचेयर बास्केटबॉल 
Nawab Sahib 	नवाब साहिब 
Anglo-Maratha War 	एंग्लो-मराठा वार 
Egg buckland keep 	एग बकलैंड कीप 
Belthara Road 	बेलठारा रोड 
Old roman 	ओल्ड रोमन 
Citadelle fort 	सिटाडेल फोर्ट 
Ruchira Perera 	रुचीरा परेरा 
Main Azad Hoon 	मैं आज़ाद हूँ 
Jacobite Rising in Scotland 	जैकॉबाइट राइसिंग इन स्कॉटलैंड 
Allen Ginsberg 	एलन जिंसबर्ग 
Roop Kahani 	रूप कहानी 
Modern Girl 	मॉडर्न गर्ल 
Main Aur Mera Bhai 	मैं और मेरा भाई 
Amar ujala 	अमर उजाला 
Fort brockhurst 	फोर्ट ब्रॉकहर्स्ट 
Ek Gunah Aur Sahi 	एक गुनाह और सही 
Aamne Samne 	आमने सामने 
Lei yue mun fort 	ली यू मुन फोर्ट 
Bikhare Moti 	बिखरे मोती 
Queen Anne's War 	क्वीन एनीज वार 
Dahanu Road 	दहानु रोड 
Tung chung fort 	तुंग चुंग फोर्ट 
Main Bhi Ladki Hoon 	मैं भी लड़की हूँ 
Mark Taylor 	मार्क टेलर 
Jiyo Raja 	जियो राजा 
Profiles in Courage Award 	प्रोफाइल्स इन करेज अवार्ड 
Count Dracula 	काउंट ड्राक्युला 
Pritzker Prize 	प्रिज़कर प्राइज़ 
Pulitzer Prize 	पुलिटज़र प्राइज़ 
Nai Maa 	नई माँ 
Throgs Neck 	थ्रॉग्ज नेक 
Ek Phool Do Mali 	एक फूल दो माली 
Insaan Aur Shaitan 	इंसान और शैतान 
Balauda Takun 	बलौदा ताकुन 
Ram Avtar 	राम अवतार 
Sasta Khoon Mehanga Pyar 	सस्ता खून महँगा पानी 
Fort trumbull 	फोर्ट ट्रम्बुल 
Balimela Reservoir 	बालिमेला रिज़रवायर 
Chor Ke Ghar Chorni 	चोर के घर चोरनी 
Wahidul Gani 	वहीदुल गानी 
Mera Yaar Mera Dushman 	मेरा यार मेरा दुश्मन 
Kostas Frontzos Museum of Epirus' Folk Art 	कोस्टस फ्रंटज़ॉस म्युज़ियम ऑफ एप‍िरस फोक आर्ट 
Gul Sanobar 	गुल सनोबर 
Kalidas samman 	कालीदास सम्मान 
Steinfeld Cup 	स्टेनफील्ड कप 
Badhti Ka Naam Dadhi 	बढ़ती का नाम दाढ़ी 
Mazda Motor 	माज़दा मोटर 
Harry Potter 	हैरी पॉटर 
Millennium Technology Prize 	मिलेनियम टेक्नोलॉजी प्राइज़ 
Aandhi Toofan 	आँधी तूफान 
Sun Microsystems 	सन माइक्रोसिस्टम 
Madhya Pradesh 	मध्य प्रदेश 
Sajid Mahmood 	साजिद महमूद 
Compass Group 	कंपास ग्रुप 
Husn Ka Chor 	हुस्न का चोर 
Ruwan Kalpage 	रुवान कल्पेज 
Harold Morton Landon Translation Award 	हैरल्ड मोर्टन लंडन ट्रांसलेशन अवार्ड 
Jai Jagannath 	जय जगन्नाथ 
Andrews University 	एण्ड्रयूस यूनिवर्सिटी 
Spanish waltz 	स्पैनिश वाल्ट्ज 
Aar Paar 	आर पार 
Museum of Cretan Ethnology 	म्युज़ियम ऑफ क्रिटेन एथनोलॉजी 
Square dance 	स्क्वाएर डांस 
Paul Hitchcock 	पॉल हिचकॉक 
Commerzbank Zentrale 	कॉमर्ज़बैंक ज़ेनट्रले 
Sadiq Mohammad 	सादिक मोहम्मद 
Abdur rahim 	अब्दुर रहीम 
Argentina Museum of Natural Sciences 	अर्जेंट‍ीना म्युज़ियम ऑफ नैचरल साइंसेस 
Saptahik hindustan 	साप्ताह‍िक ह‍िन्दुस्तान 
Craig Wishart 	क्रेग विशार्ट 
Abhi Abhi 	अभी अभी 
Kaun Ho Tum 	कौन हो तुम 
Gariep Dam 	गेरीप डैम 
Praj Industries 	प्राज इंडस्ट्रीज़ 
Order of Zhoukov 	ऑडर ऑफ़ ज़ूकोव 
Piya Ghar Aja 	पिया का घर 
Prince Edward 	प्रिन्स एडवर्ड 
General Motors 	जनरल मोटर्स 
Aaj Ki Dhara 	आज की धारा 
Paul Simon 	पॉल सिमॉन 
Kochi Refin 	कोची रेफ़िन 
Abdul hannan 	अब्दुल हन्नान 
Fort gaines 	फोर्ट गेन्स 
Nyika Plateau 	न्याइका प्लेट्‍यू 
Meri Biwi Ki Shaadi 	मेरी बीवी की शादी 
Ahmed ar-Rifai 	अहमद अर-रिफाई 
American Numismatic Society Museum 	अमेर‍िकन न्यूम‍िस्मेट‍िक सोसायटी म्युज़ियम 
Ji Chahta Hai 	जी चाहता है 
Ramanujan Prize 	रामानुजन प्राइज़ 
Heriot-Watt University 	हैरियट-वॉट यूनिवर्सिटी 
Memorial Cup 	मेमोरियल कप 
Regina Maria Pia 	रेजिना मारिया पिया 
Thomas Hobbs 	टॉमस हॉब्स 
Harvinder Singh 	हरविंदर सिंह 
Hell Gate RailRoad 	हेल गेट रेलरोड 
Agra Fort 	आगरा फोर्ट 
Geological Museum of china 	ज‍िओलॉजकिल म्युज़ियम ऑफ चाइना 
Johny Walker 	जॉनी वॉकर 
Ambika Kalna 	अम्बिका कालना 
Woodstock Historical Society 	वुडस्टॉक ह‍िस्टॉर‍िकल सोसायटी 
Ameeri Gareebi 	अमीरी गरीबी 
Chhupa Rustam 	छुपा रुस्तम 
KongZhong Corporation 	काँगझाँग कॉर्पोरेशन 
Banke Lal 	बाँके लाल 
Anwar Hossain 	अनवर हुसैन 
Abundant Life Christian Fellowship 	अब्यूडंट लाइफ क्रिश्चियन फ़ेलोशिप 
Kachchi Kali 	कच्ची कली 
Aretha Franklin 	एरीथा फ़्रेंकलिन 
Cueva de la Bruja 	क्युवा डी ला ब्रूजा 
Tere Meree Beech Mein 	तेरे मेरे बीच में 
Samandaron Ki Malika 	समंदरों की मलिका 
Bayazid Bastami 	बयाज़िद बस्तामी 
Kaun Saccha Kaun Jhootha 	कौन सच्चा कौन झूठा 
Gary Robertson 	गेरी रॉबर्ट्‍सन 
Aurat Aur Parinda 	औरत और परिंदा 
Bali Barat 	बाली बारत 
Ladki Jawan Ho Gai 	लड़की जवान हो गई 
Yangtze ki yang 	‍यांगत्ज़े की यांग 
Brian Close 	ब्रेन क्लोस 
Anglo-Cherokee War 	एंग्लो-चेरोकी वार 
Gul Sanovar 	गुल सनोवर 
Saleem Malik 	सलीम मलिक 
Lahore fort 	लाहौर फोर्ट 
Amla Junction 	आम्ला जंक्शन 
Ankhiyon Ke Jharokhon Se 	अँखियों के झरोखों से 
Abdul noor 	अब्दुल नूर 
Red Fort 	रेड फोर्ट 
Phande Baaz 	फंदे बाज़ 
Paras Mhambrey 	पारस म्हांब्रे 
Mike Atherton 	माइक एथर्टन 
Kleist Prize 	क्लेस्ट प्राइज़ 
Dai Ichi Mutual Life Insurance 	दैई इची म्युच्युअल लाइफ़ इंश्योरेंस 
Renee Zellweger 	रीनी ज़ेलीवॅगर 
Chor Machaye Shor 	चोर मचाए शोर 
Philippine Bank of Communication 	फिलीपीन बैंक ऑफ कम्यूनिकेशंस 
Tom Hogan 	टॉम हॉगन 
Teesri Aankh 	तीसरी आँख 
Ito Sei Prize for Literature 	इटो सेइ प्राइज़ फॉर लिट्रेचर 
Gul Badan 	गुल बदन 
John Keats 	जॉन कीट्स 
Yamaha Motor 	यामाहा मोटर 
Naag Devta 	नाग देवता 
Hanste Ansoo 	हँसते आँसू 
Orson Wales 	ऑरसॉन वेल्स 
Kitna Badal Gaya Insan 	कितना बदल गया इंसान 
Order of the Tower and Sword 	ऑडर ऑफ़ द टॉवर एण्ड स्वॉर्ड 
Gurudwara Uchh Ka Peer 	गुरूद्वारा उच का पीर 
Gurudwara Tikana Sahib 	गुरूद्वारा टिकाणा साहिब 
LeoNardo Di Vinci 	लियोनार्डो द विंन्सी 
Mahatma Kabir 	महात्मा कबीर 
Abdul azim 	अब्दुल अज़ीम 
Gamini Perera 	जेमिनी परेरा 
Hickory Street Presbyterian 	हिकॉरी स्ट्रीट प्रेस्बिटेरिटन 
Grutas de Cacahuamilpa 	ग्रुटस डे काकाहुआमील्पा 
Silicon Motion Technology Corporation 	सिलिकॉन मोशन टेक्नोलॉजी कॉर्पोरेशन 
Narad Leela 	नारद लीला 
Akele Hum Akele Tum 	अकेले हम अकेले तुम 
Ek Baar Kaho 	एक बार कहो 
War between Brandenburg and Sweden 	वार बिट्वीन ब्रेडनबर्ग एण्ड स्वीडन 
Garam Masala 	गरम मसाला 
Sau Saal Baad 	सौ साल बाद 
Ranbaxy Labs 	रैनबैक्सी लैब्स 
Mad Bhare Nain 	मद भरे नैन 
Rao Saheb 	राव साहब 
Abul Fazal 	अबुल फजल 
Patthar Aur Payal 	पत्थर और पायल 
Gopal Sharma 	गोपाल शर्मा 
Gloria Steinem 	ग्लोरिया स्टेनम 
Breendonck fort 	ब्रीनडॉन्क फोर्ट 
El Potosi 	इल पोतोसी 
Lance Klusener 	लैन्स क्लूजनर 
Jimmy Maher 	जिमी मेहर 
Baraigram Junction 	बराइग्राम जंक्शन 
Love In Canada 	लव इन कैनेडा 
University of East Anglia 	यूनिवर्सिटी ऑफ ईस्ट एंग्लिया 
Abdur Rehman 	अब्दुर रहमान 
Jone Reverse 	जोन रिवर्स 
Nicky Boje 	निक्की बोजे 
Mahmood Hamid 	मेहमूद हामिद 
Order of National Establishment Merit 	ऑडर ऑफ नेशनल एस्टैबलिशमेंट मेरिट 
Changez Khan 	चंगेज़ खान 
Romesh Kaluwitharana 	रोमेश कालुविथराणा 
Fort canning 	फोर्ट कैनिंग 
Younis Ahmed 	यूनिस अहमद 
Moschip Semi 	मॉस्चिप सेमी 
Fort san cristobal 	फोर्ट सैन क्रिस्टोबल 
Mullah Shah Badakhshi 	मुल्ला शाह बदाख्शी 
Professor Pyarelal 	प्रोफेसर प्यारेलाल 
Darling Darling 	डार्लिंग डार्लिंग 
Castle clinton 	कैसल क्लिंटन 
Ottawa Church of Christ 	ओटावा चर्च ऑफ क्राइस्ट 
Robert Key 	रॉबर्ट की 
SelaQui World School, Dehradun 	सेलाकी वर्ल्ड स्कूल, देहरादून 
Shera Shamshera 	शेरा शमशेरा 
Ganga Aur Suraj 	गंगा और सूरज 
Agaton fort 	एगाटन फोर्ट 
Natali Cole 	नताली कोल 
Khuda Ka Banda 	खुदा का बंदा 
Ashok Nagar 	अशोक नगर 
University of Newcastle 	यूनिवर्सिटी ऑफ न्यूकैसल 
Broechem fort 	ब्रोकेम फोर्ट 
Infosys Technologies Limited 	इंफ़ोसिस टेक्नोलॉजीज़ लिमिटेड 
Gurudwara Nanaksar Sahib 	गुरूद्वारा नानकसर साहिब 
Do Dost 	दो दोस्त 
Order of Australia 	ऑडर ऑफ ऑस्ट्रेलिया 
Syndicate Bank 	सिंडीकेट बैंक 
Yunus Emre 	युनुस इमर 
Bandra Terminus 	बांद्रा टर्मिनस 
Abdul mueez 	अब्दुल मुईज़ 
Mujhe Kasam Hai 	मुझे कसम है 
Gunung Gede Pangrango 	गुनुंग गेडे पैनग्रांगो 
Sky diving 	स्काय डाइविंग 
Athar Laeeq 	अथार लईक 
Don Johnson 	डॉन जॉनसन 
Studio Museum in Harlen 	स्टुड‍ियो म्युज़ियम इन हार्लेन 
Khwab Ki Duniya 	ख्वाब की दुनिया 
Zakhami Insaan 	ज़ख्मी इंसान 
Bhaini Khurd 	भाइनी खुर्द 
Australian War Memorial 	ऑस्ट्रेल‍ियन वार मेमोर‍ियल 
Ghar Ki Laaj 	घर की लाज 
Cha cha 	चा चा 
Royal Alberta Museum 	रॉयल अल्बर्टा म्युज़ियम 
Gavin Rennie 	गेविन रेनी 
Golden Gate Highlands 	गोल्डन गेट हाईलैंड्स 
Shaurya Chakra 	शौर्य चक्र 
Love In Goa 	लव इन गोवा 
Chaparmukh Junction 	चपरमुख जंक्शन 
Dhobi Doctor 	धोबी डॉक्टर 
Carlton Baugh 	कार्लटन बॉग 
Hindustan Copper 	हिंदुस्तान कॉपर 
Char Chand 	चार चाँद 
China Natural Resources 	चाइना नेचुरल रिसोर्स 
Alan Turner 	एलन टर्नर 
Conjunto Santa Rita 	कॉनजज्युनटो सेंटा रीटा 
Mitsubishi Chemical 	मित्सुबिशी केमिकल 
Lakkhi sarai 	लक्खी सराय 
Namaste Ji 	नमस्ते जी 
Norbert Wiener Award 	नॉर्बर्ट वीनर अवार्ड 
Helen Keller 	हेलन केलर 
Cardiome Pharma Corporation 	कार्डिओम फ़ार्मा कॉर्पोरेशन 
Badmashon Ka Badmash 	बदमशों का बदमाश 
Mexico City 	मेक्सिको सिटी 
Pacific Ocean 	पैसिफिक ओशन 
Saqlain Mushtaq 	सक्लेन मुश्ताक 
Bada Bhai 	बड़ा भाई 
Ibn Arabi 	इब्न अरबी 
Museum of Engravings and Graphic Arts 	म्युज़ियम ऑफ एन्ग्रेव‍िंग्स एण्ड ग्राफ‍िक आर्ट्स 
Bhatpar Rani 	भटपार रानी 
Thomas Cook 	थॉमस कुक 
Mahmud Shabistari 	महमूद शबिस्तरी 
Colorado Spring 	कोलोरॅडो स्प्रिंग 
Jungle Ki Beti 	जंगल की बेटी 
Medal of Zhukov 	मेडल ऑफ ज़ुकोव 
Miss Good Night 	मिस गुड नाइट 
Naqli Baap 	नकली बाप 
Utpal Chatterjee 	उत्पल चैटर्जी 
Dil Ka Sathi Dil 	दिल का साथी दिल 
Margaret Maid 	मार्गरेट मेड 
Abdul muqeet 	अब्दुल मुकीत 
Red Rose 	रेड रोज़ 
Ranjit Fernando 	रंजीत फर्नेंडो 
Crete Maritime Museum 	क्रेट मैरीटाइम म्युज़ियम 
Bharti Air 	भारती एयर 
Meetha Zahar 	मीठा ज़हर 
Do Khiladi 	दो खिलाड़ी 
Mard Ka Bachcha 	मर्द का बच्चा 
Raj Rani 	राज रानी 
Kunwara Badan 	कुँवारा बदन 
Ratna Manjari 	रत्न मंजरी 
Maha Shaktimaan 	महा शक्तिमान 
Lake District 	लेक डिस्ट्रीक्ट 
Robert Kennedy 	रॉबर्ट कैनेडी 
Dharm Patni 	धरम पत्नी 
China Grentech Corporation Limited 	चाइना ग्रेन्टेक कॉर्पोरेशन लिमिटेड 
Flex Industries 	फ़्लेक्स इंडस्ट्रीज़ 
Tim Cary 	टिम कॅरी 
Bhai Ka Dushman Bhai 	भाई का दुश्मन भाई 
Junior Murray 	जुनियर मुर्रे 
Nusrat Fateh Ali Khan 	नुसरत फतेह अली खान 
Theodore Roosevelt 	थीओडोर रूज़वेल्ट 
Sem group 	सेम ग्रुप 
Abdul rahim 	अब्दुल रहीम 
Mark Higgs 	मार्क हिग्स 
Langstone redoubt 	लैंगस्टोन रिडाउट 
Phil Edmonds 	फिल एडमंड्‍स 
Haath Ki Safai 	हाथ की सफाई 
Yuvraj Singh 	युवराज सिंह 
Pehla Pehla Pyar 	पहला पहला प्यार 
Garibi Hatao 	गरीबी हटाओ 
Spetses Museum 	स्पेट्सेस म्युज़ियम 
Bhai Saheb 	भाई साहब 
Kashif Raza 	काशिफ रज़ा 
Kirti Azad 	कीर्ति आज़ाद 
Abdul raqib 	अब्दुल रकीब 
Ek Nai Paheli 	एक नई पहेली 
Marcel Benoist Prize 	मार्सेल बेनोइस्ट प्राइज़ 
Apollo Hospital 	अपोलो हॉस्पिटल 
Karen Blixen Museum 	कैरेन ब्ल‍िक्सन म्युज़ियम 
Cape Horn 	केप हॉर्न 
Baha al din 	बहा अल दीन 
Aditya Vikram Birla Group 	आदित्य विक्रम बिड़ला ग्रुप 
Sanam Teri Kasam 	सनम तेरी कसम 
Chandi Sona 	चाँदी सोना 
Carl Jung 	कार्ल जंग 
Fort adams 	फोर्ट एडम्स 
Milan Linate 	मिलान लिनेट 
Bambai Ka Babu 	बंबई की बहू 
Bassi Pathanam 	बस्सी पठनम 
Shahi Bazar 	शाही बाज़ार 
Jacob's Well 	जैकॉब्स वेल 
Sea of Marmara 	सी ऑफ मारमारा 
Rastriya sahara 	राष्‍ट्रीय सहारा 
Alibaba Marjina 	अलीबाबा मर्जीना 
Rangila Ratan 	रंगील रतन 
Khul Ja Sim Sim 	खुल जा सिम सिम 
Elizabeth Clair Prophet 	एलीज़ाबेथ क्लेयर प्रोफ़ेट 
Fort darnet 	फोर्ट डार्नेट 
Ezra Moseley 	एज़्रा मोसेले 
Tumhare Bina 	तुम्हारे बिना 
Pyaasa Sawan 	प्यासा सावन 
Do Kaliyan 	दो कलियाँ 
Bose Corp 	बोस कॉर्प 
Kawabata Yasunari Prize 	कावाबाटा यसुनारी प्राइज़ 
Andrew Martin 	एण्ड्रू मॉर्टन 
Fort saint philip 	फोर्ट सेंट फिलिप 
Draxis Health 	ड्रेक्सिस हेल्थ 
Joey Benjamin 	जॉय बेंजामिन 
Madliena tower fort 	मैडलीना टावर फोर्ट 
Kala Samundar 	काला समंदर 
Northrop Grumman 	नॉर्थ ग्रुम्मन 
Angiotech Pharmaceuticals 	एन्जियोटेक फ़ार्मासुटिकल्स 
Lake Nakuru 	लेक नाकुरु 
Presidio of san francisco 	प्रेसिडियो ऑफ सैन फ्रान्सिस्को 
Qwest Communications 	क्वेस्ट कम्युनिकेशंस 
Laila Majnu 	लैला मजनू 
Sudath Pasqual 	सुदाथ पासक्वेल 
Malcolm Baldrige National Quality Award 	मैल्कम बैलरिज नेशनल क्वालिटी अवार्ड 
Brest fortress 	ब्रेस्ट फोरट्रेस 
Dahina Zainabad 	दाहिना ज़ैनाबाद 
Bruce Reid 	ब्रूस रैड 
National parks of Brazil 	नेशनल पार्क्स ऑफ ब्राज़ील 
New Haven Road Church of God 	न्यू हेवन रोड चर्च ऑफ गॉड 
Gary Cosier 	गेरी कॉसियर 
Khoon Ki Keemat 	खून की कीमत 
Chor Chor 	चोर चोर 
Kenneth Star 	कैनॅथ स्टार 
Cornish Colony Museum 	कॉर्न‍िश कॉलोनी म्युज़ियम 
Ahista Ahista 	आहिस्ता आहिस्ता 
Martin Snedden 	मार्टिन स्नेडन 
Collins Obuya 	कॉलिंस ओबुया 
Chikodi Road 	चिकोड़ी रोड 
Edger allan Poe 	एडगर एलन पोय 
Dulha Bikta Hai 	दुल्हा बिकता है 
British Petroleum 	ब्रिटिश पेट्रोलियम 
Aston University 	ऐस्टन यूनिवर्सिटी 
Harfan Maula 	हरफन मौला 
Vince Wells 	विंस वेल्स 
Makhaya Ntini 	मखाया न्टीनी 
Jwala Daku 	ज्वाला डाकू 
Miss Chalbaaz 	मिस चालबाज़ 
Saheb Bahadur 	साहब बहादुर 
Mafizur Rahman 	मफिज़र रहमान 
Kaise Kahoon 	कैसे कहूँ 
One Liberty Place 	वन लिबर्टी प्लेस 
Sri Thendayuthapani 	श्री थेंदयूथपानी 
Fort vancouver 	फोर्ट वैनकॉवर 
Rada Electronics Industries Limited 	राडा इलेक्ट्रॉनिक्स इंडस्ट्रीज़ लिमिटेड 
Hari Darshan 	हरि दर्शन 
Glomar Explorer 	ग्लोमर एक्सप्लोरर 
Fort red bay 	फोर्ट रेड बे 
Fort recovery 	फोर्ट रिकवरी 
Cochin Harbour Terminus 	कोचीन हार्बर टर्मिनस 
Russian Federation 	रशियन फ़ेडरेशन 
Aunrihar Junction 	औंरिहर जंक्शन 
Bauria Junction 	बौरिया जंक्शन 
Power Trading Corporation 	पॉवर ट्रेडिंग कॉर्पोरेशन 
Vitran Corporation 	वित्रान कॉर्पोरेशन 
Fort knox 	फोर्ट क्नॉक्स 
Makhdoom Yahya Maneri 	मखदूम यहया मनेरी 
Saul Bello 	सॉल बेलो 
Fort lafayette 	फोर्ट लैफायेट्‍ट 
Mulkraj Anand 	मुल्कराज आनंद 
Laxminarayan Shastri 	लक्ष्मीनारायण शास्त्री 
Naag Lok 	नाग लोक 
Ek Aur Khoon 	एक और खून 
Shree Krishna Darshan 	श्री क़ृष्ण दर्शन 
Santa Monica 	सैन्टा मोनिका 
Bharat Arun 	भरत अरुण 
Cambridge Antibody Technology Group 	कैंब्रिज एंटीबॉडी टेक्नोलॉजी ग्रुप 
Liberty Shoes 	लिबर्टी शूज़ 
Parma Missionary Baptist 	पार्मा मिशनरी बैपटिस्ट 
Kabhi Andhera Kabhi Ujala 	कभी अंधेरा कभी उजाला 
Pat Nixon 	पॅट निक्सन 
Prem Patra 	प्रेम पत्र 
Abdul hannaan 	अब्दुल हन्नान 
Abdul nafee 	अब्दुल नफी 
Karwa Chouth 	करवा चौथ 
Heeralal Pannalal 	हीरालाल पन्नालाल 
Aag Ke Sholay 	आग के शोले 
Gul jaafaree 	गुल जाफरी 
Mark Waugh 	मार्क वॉ 
Rafiqul Islam 	रफीकल इस्लाम 
Prix Apollo 	प्रिक्स अपोलो 
Ek Raat 	एक रात 
Naag Mandir 	नाग मंदिर 
Purani Pehchan 	पुरानी पहचान 
Central chronicle 	सेंट्रल क्रॉन‍िकल 
The Armenian Church of Holy Martyrs 	द अमेरिकन चर्च ऑफ होली मार्टयर्स 
Niamur Rashid 	नियामुर रशीद 
Israel Prize 	इस्राएल प्राइज़ 
Hutchison Essar 	हचिसन एस्सार 
Almirante Latorre 	अल्मीरेंट लेटौर 
Aurat Teri Yehi Kahani 	औरत तेरी यही कहानी 
Gorakhpur City 	गोरखपुर सिटी 
Aansoo Bane Angaarey 	आँसू बने अंगारे 
O Panchhi 	ओ पंछी 
Craig Serjeant 	क्रैग सर्जेंट 
Mansoor Al Hallaj 	मंसूर अल हल्लज 
Vusi Sibanda 	व्युसी सिबांडा 
Log Kya Kahenge 	लोग क्या कहेंगे 
Fort clinch 	फोर्ट क्लिंच 
Barbara Marx Hubbard 	बारबरा मार्क्स हबर्ड 
Bansi Birju 	बंसी बिरजू 
Eagle Scout 	ईगल स्काउट 
Bheegi Palken 	भीगी पलकें 
Aya Sawan Jhoom Ke 	आया सावन झूम के 
Ferid Murad 	फ़ेरिड मुराड 
Augrabies Falls 	ऑग्राबीस फॉल्स 
Sarai Ke Bahar 	सराय के बाहर 
Champion's Cup 	चैंपियन्स कप 
Nadiya Ke Paar 	नदिया के पार 
Kala Ghoda 	काला घोड़ा 
Alan Butcher 	ऐलन बुचर 
Raj Pratigya 	राज प्रतिज्ञा 
George Burns 	जॉर्ज बर्न्स 
Dhola Mazra 	धोला माज़रा 
Moti Mahal 	मोती महल 
Bhagwan Parshuram 	भगवान परशुराम 
Vivendi Universal 	विवेंदी यूनिवर्सल 
Saint helens fort 	सेंट हेलेन्स फोर्ट 
Mudassar Nazar 	मुदस्सर नाज़र 
Cheng Lang 	चेंग लांग 
University of Sydney 	यूनिवर्सिटी ऑफ सिडनी 
Saajan Ka Ghar 	साजन का घर 
King Philip's War 	किंग फिलिप्स वार 
Excellent Glory 	एक्सीलेंट ग्लोरी 
Central Queensland University 	सेंट्रल क्वीन्सलैंड यूनिवर्सिटी 
Ernakulam Town 	इरनाकुलम टाउन 
Silverline School, Ghaziabad 	सिल्वरलाइन स्कूल, गाज़ियाबाद 
Ted Bundy 	टेड बुंडी 
Supa Dam 	सुपा डैम 
University of Alaska 	यूनिवर्सिटी ऑफ अलास्का 
Batu Dam 	बटु डैम 
John The Baptist 	जॉन द बैपटिस्ट 
Nathan Hauritz 	नाथन हॉरिट्ज़ 
Essel Propack 	एस्सेल प्रोपेक 
Fort austin 	फोर्ट ऑस्टिन 
War Cross with sword 	वार क्रास विद स्वॉर्ड 
Jeremy Coney 	जेरेमी कोने 
Otto Group 	ओट्टो ग्रुप 
University of Saint Andrews 	यूनिवर्सिटी ऑफ सेंट एण्ड्रयूस 
Shoaib Mohammad 	शोएब मोहम्मद 
Birla Group 	बिड़ला ग्रुप 
Agni Prem 	अग्नि प्रेम 
Las Vegas 	लास वेगास 
John Kenneth Galbraith 	जॉन कीनॅथ गलब्रेथ 
Knuth Prize 	नुथ प्राइज़ 
Ipca Labs 	इप्का लैब्स 
Saregama India 	सारेगामा इंडिया 
Madari Mohan 	मदारी मोहन 
Hemis Gompa 	हेमीस गोम्पा 
Riwa fort 	रीवा फोर्ट 
Tu Hi Tu 	तू ही तू 
Barry Wood 	बैरी वुड 
Doosri Sita 	दूसरी सीता 
Prithvi Putra 	पृथ्वी पुत्र 
Order of the Three Stars 	ऑडर ऑफ़ द थ्री स्टार्स 
Woh Din Aayega 	वो दिन आएगा 
Mike Veletta 	माइक वेलेटा 
Budapest Ferihegy 	बुडापेस्ट फेरीहिग्य 
Madhur Milan 	मधुर मिलन 
Thomas Road Baptist 	थॉमस रोड बैपटिस्ट 
West Coast 	वेस्ट कोस्ट 
Menara Telekom headquarters 	मेनरा टेलीकॉम हेडक्वार्टर्स 
Rani Aur Jani 	रानी और जानी 
Shiv Bhakt Baba Balak Nath 	शिव भक्त बाबा बालक नाथ 
Georgia Pacific 	जॉर्जिया पेसिफक 
Bahiyy al din 	बहिय अल दीन 
Poonam Ki Raat 	पूनम की रात 
Apmaan Ki Aag 	अपमान की आग 
Cummins India 	क्यूमिंस इंडिया 
China Telecommunications 	चाइना टेलीकम्युनिकेशंस 
Dalsingh Sarai 	दलसिंह सराई 
Preet Ki Reet 	प्रीत की रीत 
Goodrum Baptist 	गूडरुम बैपटिस्ट 
Sunil Gavaskar 	सुनील गावस्कर 
The times of india 	द टाइम्स ऑफ इंडिया 
Mulshi Dam 	मुल्शी डैम 
Cowan University 	कॉवन यूनिवर्सिटी 
Mike Gatting 	माइक गैटिंग 
Winston Churchill 	विंस्टन चर्चिल 
Fort saint george 	फोर्ट सेंट जॉर्ज 
Rome Leonardo da Vinci 	रोम लियोनार्दो द विन्सी 
Nav Jeevan 	नव जीवन 
Jai Radhakrishna 	जय राधाक़ृष्ण 
Unicredito Italiano. 	यूनीक्रेडिटो इटालियानो 
Anjane Mein 	अंजाने में 
Bada Kabootar 	बड़ा कबूतर 
Ford Motor 	फ़ोर्ड मोटर 
Vimicro International Corporation 	विमाइक्रो इंटरनेशनल कॉर्पोरेशन 
National Jewish Book Award 	नेशनल ज्युश बुक अवार्ड 
Sandhya Chhaya 	संध्या छाया 
Skyscraper Museum 	स्कायस्क्रैपर म्युज़ियम 
Disabled sailing 	डिसऐबल्ड सेलिंग 
Abdul mujeeb 	अब्दुल मुजीब 
Bank of Baroda 	बैंक ऑफ बड़ौदा 
Theodore Dreiser 	थियोडोर ड्रेज़र 
Abdul mannaan 	अब्दुल मन्नान 
Shree Ganesh 	श्री गणेश 
Mitchell Johnson 	मिशेल जॉनसन 
Choti Khatu 	छोटी खाटु 
Commonwealth Bank Of Australia 	कॉमनवेल्थ बैंक ऑफ ऑस्ट्रेलिया 
Bhala Manus 	भला मानुस 
Shriman Satyawadi 	श्रीमान सत्यवादी 
Chhoti Si Mulaqat 	छोटी सी मुलाकात 
Barsat Ki Raat 	बरसात की रात 
Jose Saramago 	जोस सरभागो 
Philatelic Museum 	फ‍िलेटेलिक म्युज़ियम 
Guy de Alwis 	गाए डे एल्विस 
Mohinder Amarnath 	मोहिंदर अमरनाथ 
Roger Twose 	रॉगर ट्वोस 
Richard Snell 	रिचर्ड स्नेल 
Ammiraglio di Saint Bon 	अमीरैगलियो डी सेंट बॉन 
Walkley Award 	वॉक्ले अवार्ड 
Godel Prize Award 	गोडल प्राइज़ अवार्ड 
Patty Kazmaier Award 	पैटी कज़्मायर अवार्ड 
Stirling Smith Museum and Art Gallery 	स्टर्ल‍िंग स्म‍िथ म्युज़ियम एण्ड आर्ट गैलरी 
Coca Cola Enterprises 	कोका कोला एन्टरप्राइजेस 
Saint andrews blockhouse 	सेंट एण्ड्रयूज ब्लॉकहाउस 
Sword dance 	स्वॉर्ड डांस 
Fatehpur Sekhawati 	फतेहपुर सेखावटी 
Fort randall 	फोर्ट रैंडाल 
Charles Sturt University 	चार्ल्स स्टर्ट यूनिवर्सिटी 
Denesh Ramdin 	देनेश रामदिन 
Tahir Khan 	ताहिर खान 
Oriental Hotels 	ओरिएंटल होटल्स 
Pati Patni 	पति पत्नी 
Modern Youth 	मॉडर्न यूथ 
Amtek Auto 	एम्टेक ऑटो 
Attila Jozsef Prize 	एटीला जोसफ प्राइज़ 
Bhakta Raj 	भक्त राज 
Middle Fail 	मिडिल फेल 
Abdul qaadir 	अब्दुल कादिर 
Lance Gibbs 	लैन्स गिब्स 
Steve Rhodes 	स्टीव रोड्‍स 
Nazmul Hossain 	नज़्मुल हुसैन 
Richard Blakey 	रिचर्ड ब्लैकी 
Biwi Kiraye Ki 	बीवी किराए की 
Kirloskar Bros 	किर्लोस्कर ब्रदर्स 
The International Andy Awards 	द इंटरनेशनल एण्डी अवार्ड्‍स 
The tyne turrets 	द टायने टरेट्‍स 
Saint Mary's Convent Inter College, Allahabad 	सेंट मेरीज़ कॉंन्वेंट इंटर कॉलेज, अलाहाबाद 
Himmat Aur Mehnat 	हिम्मत और मेहनत 
Chalu Mera Naam 	चालू मेरा नाम 
Rohan Gavaskar 	रोहन गावस्कर 
Order of Aviz 	ऑडर ऑफ एविज़ 
Sairaj Bahutule 	सैराज बहुतुले 
Robert Croft 	रॉबर्ट क्रोफ्ट 
Daal Mein Kala 	दाल में काला 
Mera Ladka 	मेरा लड़का 
Gunahon Ka Faisla 	गुनाहों का फैसला 
Bees Saal Pehle 	बीस साल पहले 
Rajgad fort 	राजगढ़ फोर्ट 
Fort hunt 	फोर्ट हंट 
Pyaasi Ankhen 	प्यासी आँखें 
Ek Bechara 	एक बेचारा 
Pulu Keeling 	पुलू कीलिंग 
Main Tulsi Tere Aangan Ki 	मैं तुलसी तेरी आँगन की 
Hills Lumshnong village 	हिल्स लम्सनाँग विलेज 
Mevan Pieris 	मेवन पाइरिस 
Anwar Sadat 	अनवर सादत 
Divya bhaskar 	द‍िव्य भास्कर 
National Museum of China 	नेशनल म्युज़ियम ऑफ चाइना 
Faakhruddin Ganjshakar 	फकरूद्दीन गंजशाकर 
Argonia Friends 	अर्गोनिया फ्रेंडस 
Purana quila 	पुराना किला 
Donald Rumsfeld 	डोनाल्ड रम्सफ़ील्ड 
Lenin Peace Prize 	लेनिन पीस प्राइज़ 
Indo Rama 	इंडो रामा 
Order Orla Bialego 	ऑडर ऑर्ला बायलेगो 
Rod Marsh 	रॉड मार्श 
Andrew Symonds 	एण्ड्रयू सिमंड्‍स 
Ek Saal Pehle 	एक साल पहले 
Boncelles fort 	बॉन्सेलेस फोर्ट 
Sulagte Arman 	सुलगते अरमान 
Mark Ealham 	मार्क एल्हैम 
Jai Bangladesh 	जय बांग्लादेश 
Heera Moti 	हीरा मोती 
Stora Enso 	स्टोरा एंसो 
Groupe Pinault Print 	ग्रुप पिनॉल्ट प्रिंट 
First Canadian Place 	फर्स्ट कैनेडियन प्लेस 
Gurudwara Falahi Sahib 	गुरूद्वारा फलाही साहिब 
Pehli Jhalak 	पहली झलक 
Raj Darbar 	राज दरबार 
Fort de joux 	फोर्ट डे जॉक्स 
Mar Mitenge 	मर मिटेंगे 
Fort saint john 	फोर्ट सेंट जॉन 
Frank Loyad Right 	फ़्रेक लॉयड राइट 
Bukit Barisan Selatan 	बुकिट बरीसन सेलटन 
Hobey Baker Award 	होबी बेकर अवार्ड 
Fort albany 	फोर्ट एल्बनी 
Coldstream Museum 	कोल्डस्ट्रीम म्युज़ियम 
Anisur Rahman 	अनीसुर रहमान 
Sati Anusuya 	सती अनुसुया 
Woh Phir Nahin Aayee 	वो फिर नहीं आई 
Teri Mang Sitaron Se Bhar Doon 	तेरी माँग सितारों से भर दूँ 
Papeeha Re 	पपीहा रे 
Gurudwara Santokhsar 	गुरूद्वारा संतोखसर 
Scanian War 	स्कैनियन वार 
Glenn Bishop 	ग्लेन बिशप 
Matra Bhoomi 	मातृ भूमि 
Jagat Mohini 	जगत मोहिनी 
Kachche Heere 	कच्चे हीरे 
21 Century Tower 	21 सेन्चुरी टॉवर 
Fort bliss 	फोर्ट ब्लिस 
Birha Ki Raat 	बिरह की रात 
John Lanen 	जॉन लैनन 
Tino Best 	टिनो बेस्ट 
Zakhmi Zameen 	ज़ख्मी ज़मीन 
Carmel Convent School, Chanakya Puri 	कारमेल कॉन्‍वेंट स्कूल, चाणक्य पुरी 
Barwadih Junction 	बरवादिह जंक्शन 
Fort ronduit 	फोर्ट रॉनड्‍यूट 
Sati Seeta 	सती सीता 
Athula Samarasekera 	अथुला समारासेकरा 
Bhai Ka Pyar 	भाई का प्यार 
Agnee Pareeksha 	अग्नि परीक्षा 
Raste Aur Rishte 	रास्ते और रिश्ते 
Tony Award 	टोनी अवार्ड 
Ab Meri Baari 	अब मेरी बारी 
Main Wohi Hoon 	मैं वही हूँ 
Aaj Ka Robinhood 	आज का रॉबिनहुड 
Patrick French 	पॅट्रिक फ़्रेंच 
Ab Insaf Hoga 	अब इंसाफ होगा 
Baghi Haseena 	बागी हसीना 
Round dance 	राउंड डांस 
Barsi Town 	बरसी टाउन 
Chenderoh Dam 	चेन्देरोह डैम 
Christian Church of Clarendon Hills 	क्रिश्चियन चर्च ऑफ क्लारेनडॉन हिल्स 
Bank of Punjab 	बैंक ऑफ पंजाब 
East Nimad 	इस्ट निमाड़ 
Doodh Ka Karz 	दूध का कर्ज़ 
Khel Mohabbat Ka 	खेल मोहब्बत का 
Fort ligonier 	फोर्ट लिगोनियर 
State Heraldic Museum 	स्टेट हेराल्ड‍िक म्युज़ियम 
Bazida Jatan 	बज़िदा जतन 
Maqsood Rana 	मकसूद राणा 
Phil Carlson 	फिल कार्लसन 
Bijli Chamke Jamana Par 	बिजली चमके जमना पार 
Solah Satra 	सोलह सत्रह 
Malika Salomi 	मलिका सलोमी 
Fort royal 	फोर्ट रॉयल 
Order of Merit 	ऑडर ऑफ मेरिट 
Perunchani Reservoir 	पेरुंचनी रिज़रवायर 
Bethany Evangelical Free 	बेथानी एवनगेलिकल फ़्री 
Lala Rukh 	लाला रुख 
Antim Nyay 	अंतिम न्याय 
Stuart Matsikenyeri 	स्टुअर्ट मैटसिकेन्येरी 
Bhimavaram Junction 	भीमावरम जंक्शन 
Tonganoxie Christian 	टाँगनॉक्सी क्रिश्चियन 
Begu Sarai 	बेगु सराई 
Southern Iron 	साउदर्न आयरन 
Ladki Bholi Bhali 	लड़की भोली भाली 
Radha Krishna 	राधा क़ृष्ण 
Vikram Solanki 	विक्रम सोलंकी 
Texas Instruments 	टैक्सास इंस्ट्रुमेंट्स 
Sidhdhi vinaayak 	सिद्धि विनायक 
Queen Cleopatra 	क्वीन क्लियोपात्रा 
Asoka De Silva 	असोका डे सिल्वा 
Abdul nafi 	अब्दुल नफी 
Robin Jackman 	रॉबिन जैकमन 
Acharya Tulsi 	आचार्य तुलसी 
Doosri Shaadi 	दूसरी शादी 
Sindoor Ka Daan 	सिंदूर का दान 
Apna Ghar 	अपना घर 
Dick Van Dyke 	डिक वैन डाइक 
Chittorgarh fort 	चित्तौड़गढ़ फोर्ट 
Tom Selleck 	टॉम सीलॅक 
Rel Capital 	रिलायंस कैपिटल 
Kaushal Lokuarachchi 	कौशल लोकुअराच्ची 
Syed Rasel 	सय्यद रसेल 
Jalte Deep 	जलते दीप 
Mardon Wali Baat 	मर्दों वाली बात 
Prem Ki Duniya 	प्रेम की दुनिया 
Barbara Walters 	बारबरा वॉल्टर्स 
Parambikulam Reservoir 	परमबिकुलम रिज़रवायर 
Fort zachary taylor 	फोर्ट ज़करी टेलर 
Prithvi Vallabh 	पृथ्वी वल्लभ 
Tata Finance 	टाटा फ़ायनेंस 
Kamakshi Amman 	कामाक्षी अम्मान 
University of Notre Dame 	यूनिवर्सिटी ऑफ नोटर डेम 
Mohsin Kamal 	मोहसिन कमाल 
Petronas Tower 2 	प्रेट्रोनॉस टॉवर 2 
Ek Hasina Do Diwane 	एक हसीना दो दीवाने 
Gurudwara Southhall 	गुरूद्वारा साउथहाल 
Begam Akhtar 	बेगम अख्तर 
Bata drums 	बाटा ड्रम्स 
Jaisalmer fort 	जैसलमेर फोर्ट 
Raste Pyar Ke 	रास्ते प्यार के 
Shotley battery 	शोटे बॅटरी 
Simon Davis 	साइमन डेविस 
Unichem Labs 	युनिकेम लैब्स 
American Legion 	अमेरिकन लेजन 
Nat King Cole 	नेट किंग कोल 
Gomoh Junction 	गोमोह जंक्शन 
Aon Centre 	एऑन सेन्टर 
Safed Jhooth 	सफ़ेद झूठ 
Fort scott 	फोर्ट स्कॉट 
Paapi Pet Ka Sawal Hai 	पापी पेट का सवाल है 
Abdur rahamaan 	अब्दुर रहमान 
Fox War 	फॉक्स वार 
Dayle Hadlee 	डायल हेडली 
Abdus shafi 	अब्दुस शफी 
Fort efford 	फोर्ट एफोर्ड 
University of Sunderland 	यूनिवर्सिटी ऑफ सुंदरलैंड 
Fort spion 	फोर्ट स्पायन 
Claude Henderson 	क्लॉड हेंडरसन 
Daulat Ke Dushman 	दौलत के दुश्मन 
Anokha Bandhan 	अनोखा बंधन 
Brendon Julian 	ब्रेंडन जूलियन 
Castle walk 	कैशल वॉक 
Shan Creek Community Bible 	शान क्रीक कम्युनिटी बायबल 
Kavi Sammelan 	कवि सम्मेलन 
Jyotiba Phule Nagar 	ज्योतीबा फुले नगर 
Mera Naseeb 	मेरा नसीब 
Stanley De Silva 	स्टैनले डे सिल्वा 
Aansoo Ban Gaye Phool 	आँसू बन गए फ़ूल 
Better Online Solutions 	बेटर ऑनलाइन सॉल्यूशंस 
Holly Hunter 	हॉली हंटर 
Mamta Ki Chhaon Mein 	ममता की छाँव में 
Asahi Kasei 	आशी कसेई 
Professional wrestling 	प्रोफेश्नल रेस्लिंग 
Do Dilon Ki Dastan 	दो दिलों की दास्तां 
Durga Mata 	दुर्गा माता 
Illustrators of the Future 	इलस्ट्रेटर्स ऑफ द फ्यूचर 
National Television Awards 	नेशनल टेलीविज़न अवार्ड्‍स 
Delaware Canal 	डेलावेयर केनाल 
Be Aabroo 	बे आबरू 
Bharwa Sumerpur 	भरवा सुमेरपुर 
Ram Ki Ganga 	राम की गंगा 
Maria Shriver 	मारिया श्रीवर 
David Joseph 	डेविड जोसफ 
Gandhidham Junction 	गांधीधाम जंक्शन 
William Shakespeare 	विलियम शेक्सपियर 
The Little White 	द लिटिल व्हाइट 
Fort loudoun 	फोर्ट लॉडून 
Badnera Junction 	बदनेरा जंक्शन 
Pyasi Atma 	प्यासी आत्मा 
Mera Gaon 	मेरा गाँव 
Aisa Bhi Hota Hai 	ऐसा भी होता है 
Darren Sammy 	डैरन सैम्मी 
Ladki Sahyadri Ki 	लड़की सह्याद्री की 
Port Louis 	पोर्ट लुईस 
Milton Pydanna 	मिल्टन पायडैना 
Manoj Prabhakar 	मनोज प्रभाकर 
Dorel Industries 	डॉरेल इंडस्ट्रीज 
Neil Foster 	नील फॉस्टर 
Apollo Tyres 	अपोलो टायर्स 
Miles Franklin Award 	माइल्स फ्रेंकलिन अवार्ड 
Costa Rica 	कोस्टा रिका 
Prem Geet 	प्रेम गीत 
Sammy Sosa 	सैमी सोसा 
Verne citadel 	वर्न सिटाडेल 
Mahasati Tulsi 	महासती तुलसी 
Ishq Per Jor Nahin 	इश्क़ पर ज़ोर नहीं 
Bahu Begum 	बहू बेगम 
India Glycols 	इंडिया ग्लायकॉल्स 
War of the Bavarian Succession 	वार ऑफ द बेवेरियन सक्सेशन 
Dectron International 	डेक्ट्रॉन इंटरनेशनल 
City University 	सिटी यूनिवर्सिटी 
Cape York 	केप यॉर्क 
Janis Joplin 	जेनिस जॉपलिन 
Coles Myer 	कोल्स मैर 
Gombe Stream 	गोंबे स्ट्रीम 
Abdul aleem 	अब्दुल अलीम 
Abdul halim 	अब्दुल हलीम 
Museum of African Art 	म्युज़ियम ऑफ अफ्रीकन आर्ट 
Kabhi Dhoop Kabhi Chhaon 	कभी धूप कभी छाँव 
Anokhi Mohabbat 	अनोखी मोहब्बत 
John Carry 	जॉन कॅरी 
Bharat Ke Shaheed 	भारत के शहीद 
Wayne Clark 	वेन क्लार्क 
Shareef Badmash 	शरीफ बदमाश 
Jaan Hatheli Pe 	जान हथेली पे 
Bad Aur Badnaam 	बद और बदनाम 
Lover Boy 	लवर बॉय 
Seiko Epson 	सिएको एप्सन 
Bikaner fort 	बीकानेर फोर्ट 
Mummy Daddy 	मम्मी डैडी 
Rahul Dravid 	राहुल द्रविड़ 
Fort frederick 	फोर्ट फ्रेडरिक 
Gurudwara Bibhor Sahib 	गुरूद्वारा बिभोर साहिब 
Andrew Puttick 	एण्ड्रयू पुटिक 
The Kings Medal of Merit in Gold 	द किंग्स मेडल ऑफ मेरिट इन गोल्ड 
Matsushita Electric Industrial 	मत्सुशिता इलेक्ट्रिक इंडस्ट्रीयल 
Fort nascopie 	फोर्ट नैस्कोपी 
Ray Charles 	रे चार्ल्स 
Mangal Pandey 	मंगल पांडे 
Pak Daman 	पाक दामन 
Mississippi Missouri 	मिसीसिपी मिसौरी 
David Smith 	डेविड स्मिथ 
Rabindranath Tagore 	रबीन्द्रनाथ टागोर 
International Crook 	इंटरनेशनल क्रुक 
Ajee Bus Shukriya 	अजी बस शुक्रिया 
Frank Zappa 	फ़्रेंक ज़ाप्पा 
Kossuth Prize 	कोसुथ प्राइज़ 
Sydney Harbour 	सिडनी हार्बर 
Pyar Ka Mausam 	प्यार का मौसम 
Ek Aur Sangram 	एक और संग्राम 
Medal of Nesterov 	मेडल ऑफ नेस्टेरोव 
Fields Medal 	फील्ड्‍स मेडल 
Visisht Seva Medal 	विशिष्ट सेवा मेडल 
Terry Cole Whittaker 	टैरी कोल व्हिटेकर 
Allahabad Bank 	इलाहाबाद बैंक 
Southern Petrochem 	साउदर्न पेट्रोकेम 
Philo Wallace 	फिलो वैलेस 
Ek Jaan Hai Hum 	एक जान हैं हम 
Lahu Ki Awaz 	लहू की आवाज़ 
Women's Literature Prize 	वुमेन्स लिट्रेचर प्राइज़ 
Fort bridger 	फोर्ट ब्रिजर 
Paul Jarvis 	पॉल जार्विस 
Satnam Overseas 	सतनाम ओवरसीस 
La Poste 	ला पोस्ट 
Frick Collection 	फ्रिक कलेक्शन 
Jamai Raja 	जमाई राजा 
Bharatpur Junction 	भरतपुर जंक्शन 
Erode Junction 	इरोड जंक्शन 
Teri Talash Mein 	तेरी तलाश में 
Pahunche Hue Log 	पहुँचे हुए लोग 
Abdul khaaliq 	अब्दुल खालिक 
Dorothy Canfield Fisher Children's Book Award 	डोरोथी कैनफील्ड फिशर चिल्ड्रन बुक अवार्ड 
Lawrence School 	लॉरेंस स्कूल 
Super Bowl 	सुपर बाउल 
Abdul mughaani 	अब्दुल मुग़ानी 
London University Business School 	लंडन यूनिवर्सिटी बिज़नेस स्कूल 
Railway Platform 	रेल्वे प्लेटफार्म 
Har Har Mahadev 	हर हर महादेव 
Rio Grande River 	रिओ ग्रांड रिवर 
Olfert Fischer 	ऑफर्ट फिशर 
Sajeewa de Silva 	सजीवा डे सिल्वा 
Muqaddar Ka Badshah 	मुकद्दर का बादशाह 
Fort saint joseph 	फोर्ट सेंट जोसफ 
Seeta Swayamvar 	सीता स्वयंवर 
Trevor Franklin 	ट्रेवर फ्रेंकलिन 
Paisa Ya Pyar 	पैसा या प्यार 
Wilson Castle 	व‍िल्सन कॅसल 
Perumpallam Reservoir 	पेरुमपल्लम रिज़रवायर 
Ethan Allen Homestead Museum 	एथन ऐलन होमस्टेड म्युज़ियम 
Bhimavaram Town 	भीमावरम टाउन 
Mark Dekker 	मार्क डेक्कर 
De Zeven Provincien 	डी ज़ेवेन प्रोविंसियन 
Fort bij rhijnauwen 	फोर्ट बिज ‍रिजनॉवेन 
Pehli Shadi 	पहली शादी 
John Edrich 	जॉन एडरिक 
Mettur Reservoir 	मेत्तुर रिज़रवायर 
Alok Kapali 	आलोक कपाली 
Gunung Rinjani 	गुनुंग रिनजनी 
Michael Drayton 	माइकल ड्राइटन 
Mushtaq Ahmed 	मुश्ताक अहमद 
Govindaraja Perumal 	गोविंदराज्जा पेरूमाल 
Sean Davies 	सीन डेवीस 
Gurudwara Chamkaur Sahib 	गुरूद्वारा चमकौर साहिब 
Historical Museum of Crete 	ह‍िस्टॉर‍िकल म्युज़ियम ऑफ क्रेट 
Breakwater fort 	ब्रेकवॉटर फोर्ट 
Himax Technologies 	हीमैक्स टेक्नोलॉजीज़ 
Phil Simmons 	फिल सिमंस 
Dainik janasadharan 	दैन‍िक जनसाधारण 
Elvis Presley 	एल्विस प्रीस्ले 
Tata Coffee 	टाटा कॉफ़ी 
Vittorio Emanuele 	विक्टोरियो इमानुएल 
Jecy Jackson 	जेसी जैक्सन 
Billy Graham 	बिली ग्राहम 
Badla Aur Balidan 	बदला और बलिदान 
Roland Holder 	रॉलेंड होल्डर 
Dil Ki Rani 	दिल की रानी 
Abdul munim 	अब्दुल मुनीम 
West Sarguja 	वेस्ट सरगुजा 
Aag Aur Daag 	आग और दाग 
Hans Blicks 	हॅन्स ब्लिक्स 
Kurt Wilkinson 	कर्ट विल्किंसन 
Chambal Ki Rani 	चंबल की रानी 
Order of Suvorov 	ऑडर ऑफ सुवोरोव 
Lagunas de Chacachua Lagunas de Montebello 	लागुआन्स डी चाकाचुआ लॅगुनास डे मोन्टेबेलो 
Akalanka Ganegama 	अकलंका गनेगामा 
Alfred Luseno 	एल्फ्रेड लूसेनो 
Vajont Dam 	वेजोंट डैम 
Ian Bell 	इआन बेल 
Keegan Meth 	कीगन मेथ 
Khooni Saya 	खूनी साया 
Padma Bhushan 	पद्‍म भूषण 
Kansas City 	कान्सास सिटी 
Nehemiah Perry 	नेहमियाह पेरी 
Shokh Dilruba 	शोख दिलरुबा 
Nishane Baazi 	‍निशाने बाज़ी 
Jacques Rudolph 	जैक्वेस रुडॉल्फ 
Pricewaterhouse coopers 	प्राइसवॉटरहाउस कूपर्स 
Medal of Pushkin 	मेडल ऑफ पिश्किन 
Russel Arnold 	रुस्सेल आरनॉल्ड 
Insaniyat Ke Dushman 	इंसानियत के दुश्मन 
Abdul mujib 	अब्दुल मुजीब 
Saza E Maut 	सज़ा ए मौत 
Pyar Ka Toofan 	प्यार का तूफान 
University of Leeds 	यूनिवर्सिटी ऑफ लीड्‍स 
Stuart Law 	स्टुअर्ट लॉ 
Fort de gagel 	फोर्ट डे गैगल 
Shakeel Khan 	शकील खान 
Schock Prize in Logic and Philosophy 	श्कॉक प्राइज़ इन लॉजिक एण्ड फिलोसफी 
Brian Luckhurst 	ब्रेन लकहर्स्ट 
Miss India 	मिस इंडिया 
Fort san geronimo 	फोर्ट सैन गेरोनिमो 
Gehra Daag 	गहरा दाग 
Khwaja Nizamuddin Chishti 	ख्वाजा निज़ामुद्दीन चिस्ती 
Kovilar Reservoir 	कोविलर रिज़रवायर 
Lisbon Portela 	लिस्बन पोर्टेला 
Noor Jahan 	नूर जहाँ 
Kulachi Hansraj Model School 	कुलाची हंसराज मॉडेल स्कूल 
Abdul wahaab 	अब्दुल वहाब 
Fort bij vechten 	फोर्ट बिज वेकटन 
Signal hill 	सिग्नल हिल 
Abdur raqeeb 	अब्दुर रकीब 
Rocket Girl 	रॉकेट गर्ल 
Sepik flutes Kanengara 	सेपिक फ्ल्यूट्स कनेनगरा 
Gran Canaria 	ग्रान कनारिया 
Sher Khan 	शेर खान 
Gehra Zakhm 	गहरा ज़ख्म 
Trinidad and Tobago 	त्रिनिदाद एण्ड टोबॅगो 
Plainfield Bible 	प्लेनफिल्ड बायबल 
Roger Tolchard 	रॉजर टोल्चार्ड 
Fred Titmus 	फ्रेड टिटमस 
United Overseas Bank Plaza 	यूनाइटेड ओवरसीस बैंक प्लाज़ा 
Ananda bazar patrika 	आनंद बाज़ार पत्रिका 
Zahid Saeed 	ज़ाहिद सईद 
International Center of Photography 	इंटरनेशनल सेंटर ऑफ फोटोग्राफी 
Hum Se Na Jeeta Koi 	हम से न जीता कोई 
Thirumurthi Reservoir 	थिरुमूर्थी रिज़रवायर 
Mount Carmel School 	माउंट कारमेल स्कूल 
Saint Stanislaus High School. Mumbai 	सेंट स्टेनिस्लॉस हाई स्कूल, मुम्बई 
Sete Cidades 	सेटे सिडाडेस 
Farz Aur Kanoon 	फर्ज़ और कानून 
Sindoor Aur Bandook 	सिंदूर और बंदूक 
Pooja Ke Phool 	पूजा के फूल 
Tandem Cycling 	टैंडम सायकलिंग 
Rupye Ki Kahani 	रुपए की कहानी 
Roy Fredericks 	रॉय फ्रेडरिक्स 
Anokha Prem Yudh 	अनोखा प्रेम युद्ध 
Alipur Duar Junction 	अलीपुर द्वार जंक्शन 
Kabir Khan 	कबीर खान 
Elizabeth Doll 	एलिज़ाबेथ डोल 
Mujrim Kaun Khooni Kaun 	मुजरिम कौन खूनी कौन 
San Remo Music Festival 	सैन रेमो म्युज़िक फेस्टिवल 
Yang Qin 	यैंग किन 
General Slocum 	जनरल स्लोकम 
Vince Hogg 	विंस हॉग 
Ati Visisht Seva Medal 	अति विशिष्ट सेवा मेडल 
Rikki Clarke 	रिकी क्लार्क 
Kiran Bedi 	किरण बेदी 
Mera Dharam 	मेरा धरम 
Daku Aur Jawan 	डाकू और जवान 
Poonam Ka Chand 	पूनम का चाँद 
Badarpur Junction 	बदरपुर जंक्शन 
Chini Jadugar 	चीनी जादूगर 
Gurudwara Nankana Sahib 	गुरूद्वारा ननकाना सहिब 
Ron Hart 	रोन हार्ट 
Haathi Ke Daant 	हाथी के दाँत 
Gopichand Jasoos 	गोपीचंद जासूस 
Alvin Greenidge 	एल्विन ग्रीनिज 
Brooklyn Museum 	ब्रुकल‍िन म्युज़ियम 
Nathan Bracken 	नाथन ब्रेकन 
Minoo Masani 	मीनू मसानी 
Martin Suji 	मार्टिन सूजी 
Anand Aur Anand 	आनंद और आनंद 
Anil Dalpat 	अनिल दल्पत 
Abdul muaid 	अब्दुल मुएद 
Geoff Cook 	जिऑफ कुक 
Brayla Chaurasi 	ब्रायला चौरसी 
Auraiya Kannauj 	औरैया कन्नौज 
Fort bij vuren 	फोर्ट बिज व्युरेन 
Darren Gough 	डॉरेन गॉ 
Ark Royal 	आर्क रॉयल 
Ozarkhed Dam 	ओज़रखेद डैम 
The British Museum 	द ब्रिटिश म्युज़ियम 
Ek Baar Muskura Do 	एक बार मुस्कुरा दो 
Aadhi Raat 	आधी रात 
Ryanair Holdings 	रयानएअर होल्डिंग्ज 
Abdul muhayamin 	अब्दुल मुहायमीन 
Palkon Ki Chhaon Mein 	पलकों की छाँव में 
Mgahinga Gorilla 	मगाहिंगा गोरिल्ला 
Loots Bosman 	लूट्स बॉसमन 
Pyar Ka Pahla Sawan 	प्यार का पहला सावन 
Carry Grant 	कैरी ग्रांट 
Museum of Anthropology 	म्युज़ियम ऑफ एन्थ्रोपॉलॉजी 
Arabian Night 	अरेबियन नाइट 
Wireless Museum 	वायरलेस म्युज़ियम 
West Coast Pape 	वेस्ट कोस्ट पेप 
Linda Ronstadt 	लिंडा रॉन्सडेट 
College Football Awards 	कॉलेज फुटबॉल अवार्ड्‍स 
Main Awara Hoon 	मैं आवारा हूँ 
Dapeng International Plaza 	डापेन्ग इंटरनेशनल प्लाज़ा 
Montshire Museum of Science 	मॉन्टशायर म्युज़ियम ऑफ साइन्स 
Mitti Ke Khilone 	मिट्टी के खिलौने 
Peter Fulton 	पीटर फल्टन 
Rukmani Haran 	रुक्मणी हरण 
Merck Pharma 	मर्क फ़ार्मा 
Paanch Dushman 	पाँच दुश्मन 
Delhi fort 	डेल्ही फोर्ट 
Aaj Ki Taaqat 	आज की ताक़त 
Griffin Poetry Prize 	ग्रिफिन पोएट्री प्राइज़ 
Amar Shakti 	अमर शक्ति 
Little Richard 	लिटिल रिचर्ड 
Pyar Mohabbat 	प्यार मोहब्बत 
Arctic ocean 	आर्कटिक ओशन 
Bin Maa Ke Bhachchey 	बिन माँ के बच्चे 
Shahar Ka Jadu 	शहर का जादू 
Bahu Ho To Aisi 	बहू हो तो ऐसी 
Bank of America Center 	बैंक ऑफ अमेरिका सेन्टर 
Bombay Ki Billi 	बॉम्बे की बिल्ली 
Heeron Ka Chor 	हीरों का चोर 
Municipal Gallery of Rhodes 	म्युन‍िस‍िपल गैलरी ऑफ रोड्स 
Bombay Raat Ki Bahon Mein 	बॉम्बे रात की बाहों में 
Gurudwara Jund Sahib 	गुरूद्वारा जंड साहिब 
Abdul walee 	अब्दुल वली 
Ek Baap Chhe Bete 	एक बाप छह बेटे 
Saba Karim 	सबा करीम 
Lagunas de Zempoala 	लागुआन्स डी ज़ेम्पोआला 
Manjural Islam 	मंजुरल इस्लाम 
Bina Junction 	बीना जंक्शन 
Gurudwara Akal Bunga 	गुरूद्वारा अकाल बुंगा 
Bayer India 	बेयर इंडिया 
Liverpool Community 	लिवरपूल कम्युनिटी 
Bill Clinton 	बिल क्लिंटन 
Police Public 	पुलिस पब्लिक 
SIGNY award 	सिग्नी अवार्ड 
Boschbeek fort 	बॉशबीक फोर्ट 
Derawar fort 	डेरावर फोर्ट 
Anmol Sitarey 	अनमोल सितारे 
Mere Sartaaj 	मेरे सरताज 
Naved Ashraf 	नावेद अशरफ 
Fort mott 	फोर्ट मॉट 
Huge Grant 	ह्यूज ग्रांट 
Gurudwara Guru ke Wadali 	गुरूद्वारा गुरू के वडाली 
Gurudwara Guru ki Kaashi 	गुरूद्वारा गुरू की काशी 
Craig White 	क्रेग व्हाइट 
Ping Pong 	पिंग पॉन्ग 
Manimukthanadhi Reservoir 	मणिमुक्तानधी रिज़रवायर 
Bakhtiyarpur Junction 	बख्तियारपुर जंक्शन 
Sachcha Pyar 	सच्चा प्यार 
Pole vaulting 	पोल वॉल्टिंग 
Ito Yokado 	इतो योकाडो 
Disco Dancer 	डिस्को डांसर 
Royal Bank Of Scotland 	रॉयल बैंक ऑफ स्कॉटलैंड 
Abdul mannan 	अब्दुल मन्नान 
Chambal Ka Badshah 	चंबल का बादशाह 
Bank of America Plaza 	बैंक ऑफ अमेरिका प्लाज़ा 
Robert Bridges 	रॉबर्ट ब्रिजि‍ज 
Kirloskar Group 	किर्लोस्कर ग्रुप 
Commie Awards 	कॉमी अवार्ड्‍स 
Fort howe 	फोर्ट हॉवे 
State Grid 	स्टेट ग्रिड 
Jim Carter 	जिमी कार्टर 
Tony Opatha 	टोनी ओपाथा 
Michelle Nostradum 	मिशेल नॉस्ट्रेडमस 
University of New South Wales 	यूनिवर्सिटी ऑफ न्यू साउथ वेल्स 
Kamran Akmal 	कमरन अकमल 
Aarti Industrie 	आरती इंडस्ट्री 
Sagar Ki Kanya 	सागर की कन्या 
Bhaton Ki Gali 	भटों की गली 
Paris Orly 	पेरिस ऑरले 
Welham Girls' High School, Dehradun 	वेल्हैम गर्ल्स हाई स्कूल, देहरादून 
Choki Sorath 	चोकी सोरथ 
Harshad Mata 	हर्षत माता 
Greg Matthews 	ग्रेग मैथ्यूज 
Hang Khe Rhy 	हैंग की राई 
Ruggiero di Lauria 	रुगेरो दी लॉरिया 
Chor Police 	चोर पुलिस 
Merlin kville 	मर्लिन क्वीले 
Darien War 	डैरियन वार 
Kirin Brewery Company 	किरिन ब्रेवरी कंपनी 
Amavas Ki Raat 	अमावस की रात 
Meri Kahani 	मेरी कहानी 
Ivory Coast 	आयवरी कोस्ट 
General George Castro 	जनरल जॉर्ज कॅस्ट्रो 
Toubro Infotech 	टूब्रो इंफ़ोटेक 
Anokha Modh 	अनोखा मोड़ 
Dirt Bike Racing 	डर्ट बाइक रेसिंग 
Geoff Miller 	जिऑफ मिलर 
Paraye Bas Mein 	पराए बस में 
Ghar Ghar Mein Diwali 	घर घर में दीवाली 
Honeywell Intl 	हनीवेल इंटेल 
Cesar Award 	कैसर अवार्ड 
William Randolph Hearst 	विलियम रेंडॉल्फ़ हर्स्ट 
Muslim Ka Lal 	मुस्लिम का लाल 
Ajay Sharma 	अजय शर्मा 
Kanchan Aur Ganga 	कंचन और गंगा 
Martin Luther 	मार्टिन लुथर 
Gibbs Brothers Medal 	गिब्स ब्रदर मेडल 
Frank Hayes 	फ्रेंक हेस 
Raja Saab 	राजा साब 
Bob Packwood 	बॉब पैकवुड 
Parthiv Patel 	पार्थिव पटेल 
Rahemdil Jallad 	रहमदिल जल्लाद 
Agni Chakra 	अग्नि चक्र 
Lakhon Mein Ek 	लाखों में एक 
John Grisham 	जॉन ग्रिशॅम 
Nagma E Sahara 	नगमा ए सहारा 
Sidhdh yogee 	सिद्ध योगी 
Ravi Shastri 	रवि शास्त्री 
Mazdoor Zindabad 	मज़दूर ज़िंदाबाद 
Dave Richardson 	डेव रिचर्डसन 
Mark Benson 	मार्क बेंसन 
Maxim Garci 	मॅक्ज़िम गॉर्की 
Charkhi Dadri 	चरखी दादरी 
Abdul haq 	अब्दुल हक 
Mark Boucher 	मार्क बूचर 
Cinema Cinema 	सिनेमा सिनेमा 
Abdul alee 	अब्दुल अली 
Business Objects 	बिज़नेस ऑब्जेक्ट्स 
Dennis Rodman 	डेनिस रॉडमन 
Tenet Healthcare 	टेनेट हेल्थकेयर 
Jatin Paranjpe 	जतिन पारंजपे 
Anadoluhisar fort 	एनाडोल्यूहिसर फोर्ट 
Surya Pahar 	सूर्य पहर 
Khooni Mahal 	खूनी महल 
Picklecombe fort 	पिकलकोम्ब फोर्ट 
Gunah Aur Kanoon 	गुनाह और कानून 
Gordon Greenidge 	गॉरडन ग्रीनिज 
Mian Mir 	मिलन मीर 
Alan Knott 	ऐलन नॉट 
Pittsburg church of Christ 	पिट्सबर्ग चर्च ऑफ क्राइस्ट 
Novartis India 	नॉवर्टिस इंडिया 
Naoki Prize 	नाओकी प्राइज़ 
Robbie Kerr 	रॉबी केर 
Harry Truman 	हैरी ट्रुमॅन 
My Friend 	माय फ्रेंड 
King George's War 	किंग जॉर्ज्स वार 
American Electric Power 	अमेरिकन इलेक्ट्रिक पॉवर 
Museum of Islamic Ceramics 	म्युज़ियम ऑफ इस्लाम‍िक स‍िरेम‍िक्स 
Bruce Blair 	ब्रूस ब्लेअर 
Holberg International Memorial Prize 	होल्बर्ग इंटरनेशनल मेमोरियल प्राइज़ 
Fort elson 	फोर्ट एल्सन 
Bill Athey 	बिल एथे 
Salimbeni Prize 	सलीमबेनी प्राइज़ 
Kariakoil Reservoir 	करियाकोइल रिज़रवायर 
Daniel Vettori 	डैनियल वेटोरी 
Jawani Ki Kahani 	जवानी की कहानी 
Harishchandra Taramati 	हरीशचंद्र तारामती 
Bilaspur Road 	बिलासपुर रोड 
Veste coburg 	वेस्ट कॉबर्ग 
Mandy Yachad 	मैन्डी याचड 
Fort steurgat 	फोर्ट स्ट्‍यूर्गेट 
Mujhe Seene Se Laga Lo 	मुझे सीने से लगा लो 
Naya Khoon 	नया खून 
Akzo Nobel 	एक्ज़ो नोबल 
Saradindu Mukherjee 	सरादिंदू मुखर्जी 
Duraundha Junction 	दुरौंधा जंक्शन 
Ann Rand 	एन रैंड 
Geoff Boycott 	जिऑफ बॉयकॉट 
Dehri On Sone 	देहरी ऑन सोने 
Mengkuang Dam 	मेंगक्वांग डैम 
Gulf Oil 	गल्फ़ ऑईल 
Yeh Pyar Nahin 	ये प्यार नहीं 
Zakhmi Aurat 	ज़ख्मी औरत 
Chhupa Chhupee 	छुपा छुपी 
Azadi Ke Baad 	आज़ादी के बाद 
Pilgrim Lutheran 	पिलग्रिम लुथरेन 
Robert Hull Fleming Museum 	रॉबर्ट हल फ्लेमिंग म्युज़ियम 
Chinnar Reservoir 	चिन्नार रिज़रवायर 
Hare Rama Hare Krishna 	हरे रामा हरे क़ृष्णा 
Somerset Maugham Award 	सोमरसेट मॉघम अवार्ड 
Sumitranandan Pant 	सुमित्रानंदन पंत 
Mera Dost Mera Dushman 	मेरा दोस्त मेरा दुश्मन 
Miami University 	मियामी यूनिवर्सिटी 
Johnson Controls 	जॉनसन कंट्रोल्स 
Ashfaq Ahmed 	अश्फाक अहमद 
Shiv Parvati 	शिव पार्वती 
Saint George's 	सेंट जॉर्ज 
Bhagat Ki Kothi 	भगत की कोठी 
Kajal Sharma 	काजल शर्मा 
Miss Mary 	मिस मेरी 
Pyar Ki Pyas 	प्यार की प्यास 
Shaun Tait 	शॉन टैट 
Eastman Kodak 	ईस्टमेन कोडेक 
Aktieselskabet Dampskibsselskabet Torm 4 	एक्टीसल्:कॅबेट डॅम्प्सकीबेसेल्सकॅबेट टॉर्म 4 
Simon Doull 	साइमन डॉल 
Aaj Ki Baat 	आज की बात 
Fort nieuwersluis 	फोर्ट न्युवरस्लुइस 
Farz Ki Jung 	फर्ज़ की जंग 
Air France Klm Group 	एयर फ़्रांस केएलएम ग्रुप 
Durg taranee 	दुर्ग तरणी 
Ashwa Ghosh 	अश्व घोष 
Henry Fielding 	हेनरी फील्डिंग 
Sean Connery 	सीन कोनेरी 
On Track Innovations 	ऑन ट्रेक इनोवेशन 
Cobh Heritage Center 	कोब हेर‍िटेज सेंटर 
Siddhi Vinayak 	सिद्धी विनायक 
Ruth Westheimer 	रूथ वेस्टहीमर 
Fort caroline 	फोर्ट कैरोलीन 
Aaj Ka Yeh Ghar 	आज का यह घर 
Pyara Dushman 	प्यारा दुश्मन 
Coalhouse fort 	कोलहाउस फोर्ट 
Hitesh Modi 	हितेश मोदी 
Kala Chor 	काला चोर 
Naag Champa 	नाग चंपा 
Forbes Gokak 	फ़ोर्ब्स गोकाक 
Martin Kent 	मार्टिन केंट 
Museum of Dionysios Solomos and Eminent Zakynthians 	म्युज़ियम ऑफ डीयॉन‍िस‍ियॉस सोलोमॉस एण्ड एम‍िनेंट झॅक‍िन्थ‍ियन्स 
Monte Lynch 	मोंटे लिंच 
Paap Ki Kamai 	पाप की कमाई 
Nikhil Chopra 	निखिल चोपड़ा 
Rocky mountain house 	रॉकी माउंटेन हाउस 
Synchronised Swimming 	सिंक्रोनाइज़्ड स्विमिंग 
Madan Manjari 	मदन मंजरी 
Gurudwara Saragadi 	गुरूद्वारा सारागड़ी 
American War of Independence 	अमेरिकन वार ऑफ इंडिपेंडेंस 
Cardiff University 	कार्डिफ यूनिवर्सिटी 
Shivlal Yadav 	शिवलाल यादव 
Société Générale 	सोसायटी जनरल 
Bellevue Christian 	बेलेव्यू क्रिश्चियन 
Do Dil 	दो दिल 
University of Durham 	यूनिवर्सिटी ऑफ डरहैम 
Church of the Harvest 	चर्च ऑफ द हार्वेस्ट 
Fort mcallister 	फोर्ट मैकऑलिस्टर 
Graham Yallop 	ग्रेहम यालॉप 
Veolia Environnement 	वेओलिया एनवायरमेंट 
Premio Quevedos for graphical humor 	प्रेमियो क्युवेडोस फॉर ग्रैफिकल ह्युमर 
Thilan Samaraweera 	थिलन समारावीरा 
Nasser Hussain 	नासिर हुसैन 
Maa Ka Pyar 	माँ का प्यार 
Anheuser Busch 	एन्ह्यूसर बुश 
Been Ka Jadu 	बीन का जादू 
Opra Winfre 	ऑपरा विन्फ़्रे 
Balram Shrikrishna 	बलराम श्रीक़ृष्ण 
Kahan Kahan Se Guzar Gaya 	कहाँ कहाँ से गुज़र गया 
Fort pitt 	फोर्ट पिट 
Premio Nadal 	प्रेमियो नडाल 
Hardanger fiddle 	हैरडेंजर फिडल 
Toppan Printing 	टॉपन प्रिंटिंग 
Rober Bosch 	रॉबर बॉश 
Deen Aur Iman 	दीन और ईमान 
Desh Shatru 	देश शत्रु 
Ram Leela 	राम लीला 
Christmas Island 	क्रिसमस आयलंड 
Clio Awards 	क्लियो अवार्ड 
Piya Pyare 	पिया प्यारे 
Dannie Heineman Prize 	डैनी हेनमैन प्राइज़ 
Thomas Hardy 	टॉमस हार्डी 
Godhra Junction 	गोधरा जंक्शन 
Trump World Tower 	ट्रम्प वर्ल्ड टॉवर 
Raja Harishchandra 	राजा हरीशचंद्र 
Aldous Huxley 	अल्डुअस हक्सले 
Sewnarine Chattergoon 	सिवनारायन चैटरगून 
Arun Shourie 	अरूण शौरी 
United Phosphorous 	यूनाइटेड फ़ॉस्फ़ोरस 
Vellore fort 	वेल्लोर फोर्ट 
Chetan Sharma 	चेतन शर्मा 
Graf Zeppelin 	ग्रेफ जेपलिन 
Zakir Hasan 	ज़ाकिर हसन 
Nellai Kahaaboman 	नेल्लाई कहाबोमन 
Rahul Sanghvi 	राहुल संघवी 
Gazi Ashraf 	गाज़ी अशरफ 
Rookie of the Year Award 	रूकी ऑफ द ईयर अवार्ड 
Ek Chadar Maili Si 	एक चादर मैली सी 
Derek Stirling 	डेरेक स्टरलिंग 
Sautela Pati 	सौतेला पति 
Jeff Thomson 	जेफ थॉमसन 
Raj Nandini 	राज नंदिनी 
Hamilton Masakadza 	हैमिल्टन मसाकद्‍ज़ा 
Great Basin 	ग्रेट बेसीन 
Bosch Chassis 	बॉश चेसिस 
Idemitsu Kosan 	आइडेमित्सु कोसान 
Kenny Benjamin 	केनी बेंजामिन 
Rama Newsprint 	रामा न्यूज़प्रिंट 
Taro Pharmaceutical Industries 	टैरो फ़ार्मास्युटिकल इंडस्ट्रीज़ 
Waterton Lakes 	वॉटरटॉन सरोवर 
Shanghai Museum 	शंघाई म्युज़ियम 
Order of Merit of the Principality of Liechtenstein 	ऑडर ऑफ मेरिट ऑफ द प्रिंसिपेलिटी ऑफ लीकटेंस्टीन 
Ghar Mei Ram Gali Mein Shyam 	घर में राम गली में श्याम 
Vilenica prize 	विलेनिका प्राइज़ 
Parthasarthi Sharma 	पार्थसार्थी शर्मा 
IGATE Solutions 	आईगेट सॉल्यूशन 
Order of Civil Merit 	ऑडर ऑफ सिविल मेरिट 
Baskin Robins 	बस्किन रॉबिन्स 
Anmol Ratan 	अनमोल रतन 
Tohfa Mohabbat Ka 	तोहफा मोहब्बत का 
Harinder Singh Mehboob 	हरिंदर सिंह महबूब 
Jay Vijay 	जय विजय 
Do Mastane 	दो मस्ताने 
Master Ji 	मास्टर जी 
Raj Kanya 	राज कन्या 
Abdur rahaman 	अब्दुर रहमान 
Abdus shafee 	अब्दुस शफी 
Dharti Ke Lal 	धरती के लाल 
Chaudfontaine fort 	कॉडफॉन्टेन फोर्ट 
National Wax Museum 	नेशनल वैक्स म्युज़ियम 
Avishkar Salvi 	आविष्कार साल्वि 
Abdul wakil 	अब्दुल वकील 
Qayamat Se Qayamat Tak 	क़यामत से क़यामत तक 
Bhatke Rahi 	भटके राही 
Gareth Breese 	गैरेथ ब्रीस 
University of Coventry 	यूनिवर्सिटी ऑफ कॉवेंनट्री 
Sophia High School 	सोफिया हाई स्कूल 
Bees Saal Baad 	बीस साल बाद 
Rimjhim Geeton Ki 	रिमझिम गीतों की 
Gurudwara Taashkand 	गुरूद्वारा ताशकंद 
Panama Canal 	पनामा केनाल 
House of Prayer Lutheran 	हाउस ऑफ प्रेअर लुथेरान 
EXFO Electro-Optical Engineering 	ईएक्सएफ़ओ इलेक्ट्रो-ऑप्टिकल इंजीनियरिंग 
Ashley Mallett 	एशले मैलेट 
Sri Ramakrishna Vidyashala, Mysore 	श्री रामकृष्ण व‍िद्याशाला, मैसूर 
Jawab Hum Denge 	जवाब हम देंगे 
Nisal Fernando 	निसल फर्नेंडो 
High Point 	हाई पॉइंट 
Aaja Re O Sajna 	आजा रे ओ सजना 
Abdul wahid 	अब्दुल वहीद 
Rocket Tarzan 	रॉकेट टार्ज़न 
Saawan Ko Aane Do 	सावन को आने दो 
Fort clatsop 	फोर्ट क्लैटसॉप 
Kisi Se Na Kehna 	किसी से न कहना 
Dildarnagar Junction 	दिलदारनगर जंक्शन 
Museum of Welsh Life 	म्युज़ियम ऑफ वेल्श लाइफ 
Chal Chal Re Naujawan 	चल चल रे नौजवान 
Dainik janambhumi 	दैन‍िक जन्मभूमि 
Malayala manorama 	मालायला मनोरमा 
Check Point Software Technologies 	चेक पॉईंट सॉफ़्टवेयर टेक्नोलॉजीज़ 
Stephen Leacock Award 	स्टीफन लीकॉक अवार्ड 
Ajith Weerakkody 	अजीथ वीरक्कोडी 
Coretta Scott King 	कोरीटा स्कॉट किंग 
Purab Aur Pashcim 	पूरब और पश्चिम 
Atonement Lutheran 	अटॉनमेंट लुथेरान 
Fort vredeburg 	फोर्ट व्रेडबर्ग 
Aziz Mahmud Hudayi 	अज़ीज़ महमूद हुदाई 
Murali Kartik 	मुराली कार्तिक 
Peter Lever 	पीटर लीवर 
Post Box 	पोस्ट बॉक्स 
Murray Parker 	मुर्रे पार्कर 
German Historical Museum 	जर्मन ह‍िस्टॉर‍िकल म्युज़ियम 
Call Girl 	कॉल गर्ल 
Kevin Arnott 	केविन आरनॉट 
Hollywood Walk of Fame 	हॉलीवुड वॉक ऑफ फेम 
Yeh To Kamal Ho Gaya 	ये तो कमाल हो गया 
Talha Jubair 	ताल्हा जुबैर 
Aur Kaun 	और कौन 
National Folk Museum 	नेशनल फोक म्युज़ियम 
Exxon Valdez 	एक्सोन वल्डेज 
Bay Life Community 	बे लाइफ कम्युनिटी 
Fort fareham 	फोर्ट फेयरहैम 
Courtney Love 	कोर्टनी लव 
Ajmer Junction 	अजमेर जंक्शन 
Cahora Bassa Dam 	कहोरा बस्सा डैम 
Kali Basti 	काली बस्ती 
Abdul ahad 	अब्दुल अहद 
Hum Matawle Naujawan 	हम मतवाले नौजवान 
Zulm Ka Badla 	ज़ुल्म का बदला 
Walt Whitman 	वॉल्ट व्हिटमॅन 
Abdul baari 	अब्दुल बारी 
Welham Boys' School, Dehradun 	वेल्हैम बॉयज़ स्कूल, देहरादून 
Adbul qawi 	अद्‍बुल कावी 
Jai Ambe Maa 	जय अम्बे माँ 
Mercator Lines 	मर्केटर लाइन्स 
Waqt Ke Shahzade 	वक्त के शहज़ादे 
Fan lau fort 	फन लॉ फोर्ट 
National Order of Quebec 	नेशनल ऑर्डर ऑफ क्यूबेक 
Terry Alderman 	टेरी एल्डरमैन 
Rama O Rama 	रामा ओ रामा 
Meyrick Pringle 	मेरिक प्रिंगल 
Jab Yaad Kisi Ki Aati Hai 	जब याद किसी की आती है 
Hart Memorial Trophy 	हार्ट मेमोरियल ट्रॉफी 
Samrat Prithviraj Chauhan 	सम्राट पृथ्वीराज चौहान 
Tera Karam Mera Dharam 	तेरा करम मेरा धरम 
Gauri Pooja 	गौरी पूजा 
Victory Assembly of God 	विक्ट्री असेंबली ऑफ गॉड 
Hajji Bektash Wali 	हाजी बेकताश वाली 
Waqt Waqt Ki Baat 	वक्त वक्त की बात 
Order of National Security Merit 	ऑडर ऑफ नेशनल सिक्योरिटी मेरिट 
Leonardo da Vinci 	लियोनार्डो दा विंसी 
Geeta Mera Naam 	गीता मेरा नाम 
Kullursandai Reservoir 	कुल्लुरसन्दई रिज़रवायर 
Jeff Crowe 	जेफ क्रौ 
Paisa Yeh Paisa 	पैसा ये पैसा 
Abdur rasheed 	अब्दुर रशीद 
Sheikh Said 	शेख सईद 
Geraint Jones 	गेरैंट जोंस 
Tuntex Sky Tower 	टर्नटेक्स स्काय टॉवर 
Fort assiniboine 	फोर्ट एसीनिबोइन 
Meri Aankhen 	मेरी आँखें 
Vijaya karnataka 	व‍िजय कर्नाटका 
Hugo Weaving 	ह्यूगो विविंग 
Hisham Kabbani 	हिशाम कब्बानी 
Simon Peterson 	साइमन पीटरसन 
Gangapur Dam 	गंगापुर डैम 
Aye Milan Ki Bela 	आई मिलन की बेला 
Baghdad Ka Chor 	बगदाद का चोर 
Bu Ali Shah Qalandar 	बू अली शाह क़लंदर 
Jack Heron 	जैक हेरन 
Bilal Asad 	बिलाल आसद 
Jupiter Bio 	ज्युपिटर बायो 
University of Glasgow 	यूनिवर्सिटी ऑफ ग्लैसगो 
Fort de chartres 	फोर्ट डे कार्टेस 
Spectrum Signal Processing 	स्पेक्ट्रम सिग्नल प्रोसेसिंग 
Jeevan Jyoti 	जीवन ज्योति 
Mohammad Khalil 	मोहम्मद खलिल 
Nai Imarat 	नई इमारत 
Wayne James 	वेन जेम्स 
The Perfect Murder 	द पर्फेक्ट मर्डर 
Shaw Wallace 	शॉ वैलेस 
Boris Yeltsin 	बोरिस येल्तसिन 
Gammon India 	गैमॉन इंडिया 
Robin Peterson 	रॉबिन पीटरसन 
Pyar Ki Baaten 	प्यार की बातें 
Ganga Maiya 	गंगा मैया 
Valley Forge 	वैली फॉर्ज 
Ek Tha Ladka 	एक था लड़का 
Hindu American 	हिन्दू अमेरिकन 
Norbert Phillip 	नॉबर्ट फिलिप 
Apni Chhaya 	अपनी छाया 
Lal Dupatta 	लाल दुपट्टा 
Bir Uttom 	बीर उत्तोम 
Crossroads Christian Center 	क्रॉसरोडस क्रिश्चियन सेंटर 
Bade Dilwala 	बड़े दिलवाला 
Shiv Charan 	शिव चरण 
Jal Bin Machali 	जल बिन मछ्ली 
Gunnar Myrdal 	गुन्नार मिर्डल 
Ramanadhi Reservoir 	रामानधी रिज़रवायर 
Bansi Paharpur 	बंसी पहारपुर 
Sunflag Iron 	सनफ़्लैग आयरन 
Mahavir Spinnin 	महावीर स्पिनिन 
Mount Abu 	माउंट आबू 
Shiv Leela 	शिव लीला 
Laurence Olivier Awards 	लॉरेंस ओलिवर अवार्ड्‍स 
Jeet Hamari 	जीत हमारी 
Melbourne Cup 	मेल्बॉर्न कप 
Pahadi Kanya 	पहाड़ी कन्या 
Shipping Corp 	शिपिंग कॉर्प 
Paap Ka Anth 	पाप का अंत 
Haar Jeet 	हार जीत 
Burj Al Arab Hotel 	बुर्ज अल अरब होटेल 
Johar In Kashmir 	जौहर इन कश्मीर 
Sapnon Ka Saudagar 	सपनों का सौदागर 
Allan Border Medal 	एलन बोर्डर मेडल 
Norbert Wiener Prize in Applied Mathematics 	नॉरबेर्ट वीनर प्राइज़ इन अप्लाएड मैथेमेटिक्स 
Parai Aag 	पराई आग 
Fort william 	फोर्ट विलियम 
Eddo Brandes 	एड्डो ब्रन्डेस 
The hindu 	द ह‍िन्दू 
Sautela Bhai 	सौतेला बेटा 
Aristotle Onassis 	एरीस्टोटल ओनासि‍स 
Rangeela Raja 	रंगीला राजा 
Mohabbat Aur Jung 	मोहब्बत और जंग 
Dan David Prize 	डैन डेविड प्राइज़ 
Basava Sagar Dam 	बसावा सागर डैम 
Usha Martin 	ऊषा मार्टिन 
Chhapra Kacheri 	छपरा कचेरी 
Furkating Junction 	फर्कटिंग जंक्शन 
Divis Labs 	डिविस लैब्स 
Husn Ka Ghulam 	हुस्न का गुलाम 
Shiv Shakti 	शिव शक्ति 
Guneru Bamori 	गुनेरु बामोरी 
Wisden Cricketer of the Year 	विस्डन क्रिकेटर ऑफ द ईयर 
Wolf Prize in Mathematics 	वॉल्फ प्राइज़ इन मैथमेटिक्स 
Anokha Milan 	अनोखा मिलन 
Highway Holdings 	हाईवे होल्डिंग्स 
Veria Folklore Museum 	वेर‍िया फोकलोर म्युज़ियम 
Saint-Affrique Prize 	सेंट-एफ्रीक प्राइज़ 
Abdul wahhab 	अब्दुल वहाब 
Thambalahalli Reservoir 	थम्बलाहाली रिज़रवायर 
France Télécom 	फ़्रांस टेलीकॉम 
Justice Choudhary 	जस्टिस चौधरी 
Janam Janam 	जनम जनम 
Husn Aur Ishq 	हुस्न और इश्क़ 
Fort bij tienhoven 	फोर्ट बिज तीनहॉवेन 
Diwali Ki Raat 	दिवाली की रात 
Dennis Lillee 	डेनिस लिली 
Larchmont Avenue 	लार्चमॉन्ट एवेन्यू 
Abdus shakoor 	अब्दुस शकूर 
Tarun bharat 	तरुण भारत 
Akosombo Dam 	एकोसोम्बो डैम 
Richard Sims 	रिचर्ड सिम्स 
Jimmy Hendricks 	जिमी हैंड्रिक्स 
Ray Illingworth 	रे इलिंगवर्थ 
Lal Batti 	लाल बत्ती 
Raat Andheri Thi 	रात अंधेरी थी 
Strawberry Fields World School 	स्ट्रॉबेरी फील्ड्स वर्ल्ड स्कूल 
Sadanand Viswanath 	सदानंद विश्वनाथ 
Saanch Ko Aanch Nahin 	साँच को आँच नहीं 
Shaun Udal 	शॉन उदल 
Fort mcnair 	फोर्ट मैकनायर 
Abdul qayyoom 	अब्दुल कय्यूम 
Romeo Juliet 	रोमियो जुलियट 
Joan Baze 	जोएन बेज़ 
Fort ticonderoga 	फॅर्ट टिकोन्डेरोगा 
Ek Din Aadhi Raat 	एक दिन आधी रात 
Zameen Aasman 	ज़मीन आसमान 
Michael Clarke 	माइकल क्लार्क 
George Weston 	जॉर्ज वेस्टन 
Dornakal Junction 	दोरनाकल जंक्शन 
Rang Mahal 	रंग महल 
Dindigul Junction 	डिंडुगुल जंक्शन 
Andher Nagari Chapat Raja 	अंधेर नगरी चौपट राजा 
Paul and Alexandra Canellopoulos Museum 	पॉल एण्ड एलेक्ज़ेंड्रा कैनलोपॉलस म्युज़ियम 
Dhari Junction 	धारी जंक्शन 
Bob Hope 	बॉब होप 
Khatta Meetha 	खट्टा मीठा 
Gallants bower 	गैलंट्‍स बॉवर 
Sohni Mahiwal 	सोहनी महिवाल 
Mudra Communications 	मुद्रा कम्युनिकेशन्स 
Noyyal Oarathuppalayam 	नोय्यल ऑराथुप्पलयम 
Commencement Bay 	कमेंस्मेंट बे 
Aan Milo Sajna 	आन मिलो सजना 
Rio Negro 	रियो नेग्रो 
Jahan Ara 	जहाँ आरा 
Charles Roberts Award 	चार्ल्स रॉबर्ट्‍स अवार्ड 
Maa Ki Saugandh 	माँ की सौगंध 
Mukilteo Presbyterian 	मुकिल्टीओ प्रेस्बिटेरिअन 
Rashid Patel 	रशीद पटेल 
John Jameson 	जॉन जेम्सन 
Chand Siau 	चांद सिओ 
Holi Ayee Re 	होली आई रे 
Nagavathi Reservoir 	नागावथी रिज़रवायर 
Santander Central 	सेंटेंडर सेंट्रल 
IFlex Solution 	आईफ़्लेक्स सॉल्यूशन 
Amazing Grace Baptist 	अमेज़िंग ग्रेस बैपटिस्ट 
San Martino 	सैन मार्टिनो 
Murlin munro 	मर्लिन मुनरो 
Hum Dono 	हम दोनों 
Alas Purwo 	अलास पुर्वो 
Eisner Awards 	ईस्नर अवार्ड्‍स 
Governor General's Award 	गवर्नर जनरल्स अवार्ड 
Do Bahadur 	दो बहादुर 
Ek Teri Nishani 	एक तेरी निशानी 
Deutscher Fernsehpreis German Television Award 	डेस्चर फर्नसेप्रिज जर्मन टेलीविज़न अवार्ड 
Bela Tal 	बेला तल 
Bing Crosby 	बिंग क्रॉसबे 
Kodaganar Reservoir 	कोडागनर रिज़रवायर 
Dharam Aur Kanoon 	धरम और कानून 
Hukum Ka Ikka 	हुकुम का इक्का 
Aaj Ka Gundaraj 	आज का गुंडाराज 
Andar Bahar 	अंदर बाहर 
Samrat Chandragupt 	सम्राट चंद्रगुप्त 
Miss Toofan Mail 	मिस तूफान मेल 
Choron Ka Chor 	चोरों का चोर 
Financial express 	फायनैन्शियल एक्सप्रेस 
Panama City 	पनामा सिटी 
Sonar kila 	सोनार किला 
Cheung Kong Centre 	चेयूंग काँग सेन्टर 
Brian Rose 	ब्रेन रोज़ 
Sterling Bio 	स्टर्लिंग बायो 
Ek Adhuri Kahani 	एक अधूरी कहानी 
London stansted 	लंदन स्टैनस्टेड 
Ian Callen 	इआन कैलेन 
Prem Nagar 	प्रेम नगर 
Do Ustaad 	दो उस्ताद 
Bhola Shankar 	भोला शंकर 
Key Tower 	की टॉवर 
Teri Bahon Mein 	तेरी बाहों में 
Kutharaiyar Reservoir 	कुथारइयर रिज़रवायर 
Appu Raja 	अप्पू राजा 
Pro-Finlandia medal 	प्रो-फिनलैंडिया मेडल 
Ganga Tera Pani Amrit 	गंगा तेरा पानी अमृत 
Pisa Galileo Galilei 	पिसा गैलिलियो गैलीली 
Enrico Fermi Award 	एनरिको फर्मी अवार्ड 
Pighalta Aasman 	पिघलता आसमान 
Monnet Ispat 	मोनेट इस्पात 
Thorington Road Baptist 	थोरिंग्टन रोड बैपटिस्ट 
Bagula Bhagat 	बगुला भगत 
Coolagh River 	कुलॅग रिवर 
Hans Christian Andersen 	हैन्स क्रिश्चियन एण्डरसन 
Jawani Ke Gunah 	जवानी के गुनाह 
Amerada Hess 	एमरेडा हेस 
Daku Rani Himmatwali 	डाकू रानी हिम्मतवाली 
Abdul gani 	अब्दुल गनी 
Arad fort 	एरड फोर्ट 
Jangal Mein Mangal 	जंगल में मंगल 
Nand Kishore 	नंद किशोर 
Freddie Mac 	फ़्रैडी मैक 
Saagar devataa 	सागर देवता 
Coimbatore Junction 	कोइम्बटूर जंक्शन 
Maan Maryada 	मान मर्यादा 
Kimberly Clark 	किंबर्लि क्लार्क 
Art Sunje Museum 	आर्ट संज म्युज़ियम 
Door Door Paas Paas 	दूर दूर पास पास 
Maa Bahen Aur Biwi 	माँ बहन और बीवी 
Dalmia Cement 	डाल्मिया सीमेंट 
Bourdieu okz 	बॉरड्यू ऑक्ज़ 
Tama Canning 	टामा कैनिंग 
Thames Valley University 	थेम्स वैली यूनिवर्सिटी 
Bow Derrick 	बो डीरिक 
Kumar Gandharva 	कुमार गंधर्व 
John Jani Janardan 	जॉन जानी जनार्दन 
Baghi Sipahi 	बागी सिपाही 
Pervez Mir 	परवेज़ मीर 
Broadmoor Baptist 	ब्रॉडमूर बैपटिस्ट 
Big Brother Awards 	बिग ब्रदर अवार्ड्‍स 
Do Qaidi 	दो कैदी 
Nanad Bhaujai 	ननद भौजाई 
Morphy Richards 	मॉर्फ़ी रिचर्ड्स 
Jaayen To Jaayen Kahan 	जाएँ तो जाएँ कहाँ 
Abdul haseeb 	अब्दुल हसीब 
Delhi Cantonment 	डेल्ही कैंनटॉनमेंट 
Aaqib Javed 	आकिब जावेद 
Dow Chemical 	डॉ केमिकल 
Rangeen Kahani 	रंगीन कहानी 
Warsaw Frederic Chopin 	वॉर्सा फ़्रेडरीक चोपिन 
Chakri Nareubet 	चाकरी नरुबेट 
Kirloskar Ferro 	किर्लोस्कर फ़ेरो 
Abdul azeez 	अब्दुल अज़ीज़ 
Teri Puja Karee Sansaar 	तेरी पूजा करे संसार 
Dil Ka Thug 	दिल का ठग 
Mahindra United World College of India 	मह‍िंद्रा यूनाइटेड वर्ल्ड कॉलेज ऑफ इंडिया 
Natun din 	नतुन द‍िन 
Hum Kahan Ja Rahe Hain 	हम कहाँ जा रहे हैं 
Soorma Bhopali 	सूरमा भोपाली 
Pyar Ka Mandir 	प्यार का मंदिर 
University of Southampton 	यूनिवर्सिटी ऑफ साउथएंपटन 
Takhat Shri Akal Takhat Sahib, Amritsar (Punjab) 	तखत श्री अकाल तखत साहिब, अमृतसर (पंजाब) 
Oliver Cromwell 	ऑलीवर क्रॉमवेल 
Karunakalage Sajeewa De Silva 	करुणकलागे सजीवा डे सिल्वा 
Fort morgan 	फोर्ट मॉर्गन 
Little fort 	लिटिल फोर्ट 
Kal Hamara Hai 	कल हमारा है 
Hind Oil Explor 	हिंद ऑईल एक्सप्लोर 
Fort miles 	फोर्ट माइल्स 
Yasir Arafat 	यासिर अराफत 
Abdul gaffaar 	अब्दुल गफ्फार 
Veste rosenberg 	वेस्ट रोजनबर्ग 
Sada Suhagan 	सदा सुहागन 
Nissan Motor 	निस्सन मोटर 
Ceragon Networks 	सेरागॉन नेटवर्क्स 
Gandhi Peace Prize 	गांधी पीस प्राइज़ 
Jadu Mahal 	जादू महल 
Dion Ebrahim 	डायोन एब्राहिम 
Ek Kali Muskai 	एक कली मुस्काई 
Cross Country Skiing 	क्रॉस कंट्री स्कीइंग 
Ved maatrakaa 	वेद मातृका 
Naved Latif 	नावेद लतीफ 
Fort bij asperen 	फोर्ट बिज एस्पेरेन 
Jeevan Mrityu 	जीवन मृ‍त्यु 
Malpasset Dam 	मैल्पसेट डैम 
Mill Mazdoor 	मिल मज़दूर 
Fort dix 	फोर्ट डिक्स 
Fort le boeuf 	फोर्ट ले बॉयूफ 
Gopinath Mohanti 	गोपीनाथ मोहंती 
Magal Security Systems 	मग़ल सिक्योरिटी सिस्टम्स 
Order of the Golden Eagle 	ऑडर ऑफ द गोल्डन ईगल 
Fort marlborough 	फोर्ट मार्लबोरॉ 
Brad Williams 	ब्रैड विलियम्स 
Dassault Systems 	डेसॉल्ट सिस्टम्स, 
Ghar Dwar 	घर द्वार 
Winona Ryder 	विनोना रायडर 
Ab Kya Hoga 	अब क्या होगा 
Eric Upashantha 	एरिक उपाशंथा 
Shree ganesh 	श्री गणेश 
Jai Ambe 	जय अम्बे 
China Technology Deveopment Group Corporation eLong 	चाइना टेक्नोलॉजी डेवलपमेंट ग्रुप कॉर्पोरेशन ईलाँग 
Lewis Ignosh 	लुइस इगनोश 
Macquarie University 	मैकक्वेरी यूनिवर्सिटी 
GENETIC TECHNOLOGIES 	जेनेटिक टेक्नोलॉजीज़ 
Ninetowns Digital World Trade Holdings Limited 	नाइनटाउन्स डिजीटल वर्ल्ड ट्रेड होल्डिंग्स लिमिटेड 
Takeda Award 	टकेडा अवार्ड 
Mere Sanam 	मेरे सनम 
British Comedy Awards 	ब्रिटिश कॉमेडी अवार्ड्‍स 
Do Shikari 	दो शिकारी 
Dhola Junction 	धोला जंक्शन 
Do Aankhen Barah Haath 	दो आँखें बारह हाथ 
New tavern fort 	न्यू टैवर्न फोर्ट 
Reuters Group 	रियूटर्स ग्रुप 
Krishna Sudaama 	क़ृष्ण सुदामा 
Carl Bulfin 	कार्ल बुल्फिन 
Roop Kumari 	रूप कुमारी 
Mah Seamless 	महिंद्रा सीमलेस 
Tim Zoehrer 	टिम ज़ोहरर 
Blessing Mahwire 	ब्लेसिंग मेहवायर 
Ghungroo Ki Awaz 	घुँघरू की आवाज़ 
Crownhill fort 	क्राउनहिल फोर्ट 
Sarkari Mehman 	सरकारी मेहमान 
Varattupallam Reservoir 	वरत्तुपल्लम रिज़रवायर 
Hindustan Lever 	हिंदुस्तान लीवर 
Futuremedia Public Limited Company 	फ़्यूचरमीडिया पब्लिक लिमिटेड कंपनी 
Mera Desh Mera Dharam 	मेरा देश मेरा धरम 
Revolt in the Vendee 	रिवॉल्ट इन द वेंडी 
Aadhi Yug 	आधी युग 
Raj Nartaki 	राज नर्तकी 
Dwarikesh Sugar 	द्वारकेश शुगर 
Sunil Wettimuny 	सुनिल वेट्टीमुनी 
Sierra Leone 	सिइरा लियोन 
Fish River Canyon 	फिश रिवर कैनयन 
Jab Andhera Hota Hai 	जब अँधेरा होता है 
Gurudwara Doot-talai 	गुरूद्वारा दूत-तलाई 
Paap Aur Punya 	पाप और पुण्य 
Three Gorges Dam 	थ्री गोरजेस डैम 
Ryan Ramdass 	रियान रामदास 
Sawan Bhadon 	सावन भादों 
Hosanna Lutheran 	हॉसन्ना लुथरेन 
Chand Chakori 	चाँद चकोरी 
Windham County Historical Museum 	व‍िंडहैम काउंट‍ी ह‍िस्टॉर‍िकल म्युज़ियम 
Jal Pari 	जल परी 
Naache uri 	नाचे उरी 
Mome Ki Gudia 	मोम की गुड़िया 
Vaughan Brown 	वॉगन ब्राउन 
Mai Baap 	माई बाप 
Schleswig-Holstein Wadden Sea 	शेज़विग-होलस्टेन वैडन सी 
Niaz And Namaz 	नियाज़ एण्ड नमाज़ 
Nishan Danka 	निशान डंका 
Benazir Bhutto 	बेनजीर भुट्टो 
Naspers Limited 	नैस्पर्स लिमिटेड 
Yaqui indian dance 	याकूई इंडियन डांस 
Eastbourne redoubt 	ईस्टबॉर्न रीडाउट 
Jimmy Swaggart 	जिमी स्वागर्ट 
Malhar Patel 	मल्हार पटेल 
Pyar Ke Do Char Din 	प्यार के दो चार दिन 
Prem Ki Aag 	प्रेम की आग 
Aankhon Mein Tum Ho 	आँखों में तुम हो 
David Chapel Missionary Baptist 	डेविड चेपल मिशनरी बैपटिस्ट 
Sajid Ali 	साजिद अली 
Khoon Bha Ganga Mein 	खून बहा गंगा में 
Jeene Nahin Doonga 	जीने नहीं दूँगा 
Badi Maa 	बड़ी माँ 
Mujhe Vachan Do 	मुझे वचन दो 
Fort buchanan 	फोर्ट बुकनन 
Brian Murphy 	ब्रायन मर्फी 
Lagoa do Peixe 	लागोआ डो पेक्सी 
Abdul matin 	अब्दुल मतीन 
Hayward Gallery 	हेवर्ड गैलरी 
Devar Bhabi 	देवर भाभी 
South Bank University 	साउथ बैंक यूनिवर्सिटी 
Felis Shelf 	फ़िलीस श्चेल्फी 
Three Hundreed Days After 	थ्री हंडरेज डेज़ आफ्टर 
Hanuman Vijay 	हनुमान विजय 
Meri Zubaan 	मेरी ज़ुबान 
Vesuvius India 	वेसुवियस इंडिया 
Aashiq Hoon Baharon Ka 	आशिक हूँ बहारों का 
Bombay Town 	बॉम्बे टाउन 
Renaissance Tower 	रेनेसान्स टॉवर 
Samuel Chase 	सैमुएल चेस 
Do Premee 	दो प्रेमी 
Sajjo Rani 	सज्जो रानी 
Shekhar Mera Naam 	शेखर मेरा नाम 
Meritorious Service Medal 	मेरिटोरियस सर्विस मेडल 
Wakefield Christian 	वेकफ़िल्ड क्रिश्चियन 
Chennai Central 	चेन्नई सेंट्रल 
Awara Baap 	आवारा बाप 
Aulad Ke Dushman 	औलाद के दुश्मन 
Gangsar Jaitu 	गंगसार जैतु 
Har Har Gange 	हर हर गंगे 
Mera Bhai Mera Dushman 	मेरा भाई मेरा दुश्मन 
Jeremy Castle 	जैरेमी कैसल 
Professor Aur Jadugar 	प्रोफेसर और जादुगर 
Fdederated Dept Stor 	फ़ेडरेटेड डेप्ट स्टोर 
Arab Ka Sitara 	अरब का सितारा 
Meri Adalat 	मेरी अदालत 
Michael Mason 	माइकल मैसन 
Apne Dam Par 	अपने दम पर 
Abdul majid 	अब्दुल मजीद 
Saleem Jaffar 	सलीम जाफर 
Cranfield University 	क्रैनफील्ड यूनिवर्सिटी 
Hum Naujawan 	हम नौजवान 
Phool Khile Hain Gulshan Gulshan 	फूल खिले हैं गुलशन गुलशन 
Order of Public Services Merit 	ऑडर ऑफ पब्लिक सर्विसेस मेरिट 
Goldsmith Book Prize 	गोल्डस्मिथ बुक प्राइज़ 
Darrin Murray 	डेरिन मुर्रे 
Rajendra Mohan Bhatnagar 	राजेन्द्र मोहन भटनागर 
Trinity Biotech 	ट्रिनिटी बायोटेक 
Stride Arcolab 	स्ट्राइड आर्कोलैब 
Tata Sponge Iro 	टाटा स्पॉन्ज़ इरो 
Abdul malik 	अब्दुल मलिक 
Oral Roberts 	ऑरल रॉर्बट्स 
Fort widley 	फोर्ट विडले 
Central America Maya 	सेंट्रल अमेरिका माया 
Jaise Ko Taisa 	जैसे को तैसा 
Lanka de Silva 	लंका डे सिल्वा 
Dyani Feinstein 	डायनी फ़ेनस्टिन 
Beti Bete 	बेटी बेटे 
Jai Jagat Janani 	जय जगत जननी 
Citygate tower 	सिटीगेट टॉवर 
Jerry Lee Lewis 	जेरी ली लुइस 
Dabhoi Junction 	दभोई जंक्शन 
Jeetan Patel 	जीतेन पटेल 
Bhatni Junction 	भटनी जंक्शन 
Meera Shyam 	मीरा श्याम 
Shabbir Ahmed 	शब्बीर अहमद 
Mohan Rakesh 	मोहन राकेश 
Krebs Biochem 	क्रेब्स बायोकेम 
Lola Awards 	लोला अवार्ड्‍स 
James Kirtley 	जेम्स कर्टले 
Panacea Biotech 	पैनेसिया बायोटेक 
Ray Bright 	रे ब्राइट 
Allaudin Ka Beta 	अलाउद्दीन का बेटा 
Columbia river 	कोलंबिया रिवर 
Pan American Silver 	पैन अमेरिकन सिल्वर 
Bialik Prize 	बियालिक प्राइज़ 
Do Bachche Dus Haath 	दो बच्चे दस हाथ 
Aage Mode Hai 	आगे मोड़ है 
Lomonosov Gold Medal 	लोमोनोसोव गोल्ड मेडल 
Uppar Reservoir 	उप्पर रिज़रवायर 
Laurie Williams 	लॉरी विलियम्स 
Govindi Marwar 	गोविंदी मारवाड़ 
Squiddy Awards 	स्क्विडी अवार्ड्‍स 
Dhul fiqar 	धुल फिकर 
International Grandmasters 	इंटरनेशनल ग्रैंडमास्टर्स 
Aadha Din Aadhi Raat 	आधा दिन आधी रात 
Robbie Hart 	रॉबी हार्ट 
Jahazi Lutera 	जहाज़ी लुटेरा 
Mohabbat Zindagi Hai 	मोहब्बत ज़िंदगी है 
Daku Bhupat 	डाकू भूपट 
Common Bete 	कॉमन बेटे 
Pehle Aap 	पहले आप 
Agra Cantonment 	आगरा कैनटॉनमेंट 
Order of the Crown 	ऑडर ऑफ द क्राउन 
The satyam times 	द सत्यम टाइम्स 
Attah Canada 	एटा कनाडा 
Bayana Junction 	बयाना जंक्शन 
Badalte Rishte 	बदलते रिश्ते 
Jeff Mackreth 	जेफ़ मॅकक्रेथ 
Graeme Swann 	ग्रीम स्वान 
Lewis Carroll 	लिविस करोल 
Frank furt 	फ़्रैंक फ़र्ट 
Manzoor Akhtar 	मंज़ूर अख़्तर 
Maritime Museum of Greece 	मैरीटाइम म्युज़ियम ऑफ ग्रीस 
Dil Ka Raja 	दिल का राजा 
Hansie Cronje 	हैंसी क्रोंज 
Southern sea 	सदर्न सी 
China Medical Technologies 	चाइना मेडिकल टेक्नोलॉजिस 
Fort pasir panjang 	फोर्ट पैसिर पैंजंग 
Sigourney Weaver 	सिर्गोनी विवर 
Woody Allen 	वुडी एलन 
Chalta Purza 	चलता पुर्ज़ा 
Sher Ka Punja 	शेर का पंजा 
Orteig Prize 	ऑर्टेग प्राइज़ 
Resham Ki Dori 	रेशम की डोरी 
Fort mandan 	फोर्ट मैंडन 
Japan Airlines 	जपान एयरलाइंस 
Irfan Fazil 	इरफान फाज़िल 
Chhoti Chhoti Baten 	छोटी छोटी बातें 
Kenosha Bible 	केनोशा बायबल 
Anokha Prem 	अनोखा प्रेम 
Gurudwara Kalgidhar 	गुरूद्वारा कलगीधर 
Riffa fort 	रिफा फोर्ट 
Dum Dum Cantonment 	डम डम कैनटॉनमेंट 
Order of the Elephant 	ऑडर ऑफ द एलिफेंट 
Eveready Ind 	एवरेडी इंडस्ट्रीज़ 
Na Hone Wali Baat 	ना होने वाली बात 
Abu Road 	आबु रोड 
Tube Investment 	ट्यूब इन्वेस्टमेंट 
Mastana Mashooq 	मस्ताना माशूक 
Paul Allott 	पॉल एलॉट 
Shah Behram 	शाह बेहराम 
Julius Scissor 	जुलियस सीजर 
Dil Tujh Ko Diya 	दिल तुझ को दिया 
Peak District 	पीक डिस्ट्रिक्ट 
Battice fort 	बैटिस फोर्ट 
Wells Fargo 	वेल्स फ़ार्गो 
Casper Community 	कैस्पर कम्युनिटी 
Biwi O Biwii 	बीवी ओ बीवी 
Gevra Road 	गेवरा रोड 
Elbit Medical Imaging 	एल्बिट मेडिकल इमेंजिंग 
Man Ka Meet 	मन का मीत 
Reshma Aur Shera 	रेश्मा और शेरा 
Vermont Ski Museum 	वरमाउंट स्काई म्युज़ियम 
Edinburgh College of Art 	ऐडिनबर्ग कॉलेज ऑफ आर्ट 
State Farm Insurance 	स्टेट फ़ार्म इंश्योरेंस 
Bijli Aur Toofan 	बिजली और तूफ़ान 
Craig Evans 	क्रेग ईवंस 
Shahid Mahboob 	शाहिद महबूब 
Mamta Aur Mian Biwi 	ममता और मियाँ बीवी 
Tiruvannamalai Samburwaryaar 	तिरुवन्नामलाई सबुंरवरयार 
Unicoi Christian 	यूनीकोई क्रिश्चियन 
Dripping Springs Community Fellowship 	ड्रिपिंग स्प्रिंग्स कम्युनिटी फेलोशिप 
Cathy Betts 	कॅथे बेट्स 
Shoaib Akhtar 	शोएब खान 
Abdul zalil 	अब्दुल ज़लील 
Prabodh Chandra 	प्रबोध चन्द्र 
Alfred Hitchcock 	अल्फ़्रेड हिचकॉक 
Overland Hills 	ओवरलैंड हिल्स 
Maple Museum 	मैपल म्युज़ियम 
Main Shadi Karne Chala 	मैं शादी करने चला 
SUNDAY Communications Limited 	सनडे कम्युनिकेशंस लिमिटेड 
Pati Pawan 	पति पावन 
Creative Technology 	क्रिएटिव टेक्नोलॉजी 
Kepler Wessels 	केप्लर वेसल्स 
Painter Babu 	पेंटर बाबू 
Man of the Year/Person of the Year 	मैन ऑफ द ईयर/पर्सन ऑफ द ईयर 
Gregory Strydom 	ग्रेगरी स्ट्राएडम 
Coretta Scott King Award 	कॉरेटा स्कॉट किंग अवार्ड 
London Luton 	लंदन ल्यूटॉन 
Gujarat samachar 	गुजरात समाचार 
Azhar Hossain 	अज़हर हुसैन 
Anuppur Junction 	अनुपपुर जंक्शन 
Saint Pierre's Episcopal 	सेंट पिरेस एपिस्कोपाल 
Swami Dayanand Saraswati 	स्वामी दयानंद सरस्वती 
Williamite war in Ireland 	विलियामाइट वार इन आयरलैंड 
Gambhiri Road 	गंभीरी रोड 
Fort pulaski 	फोर्ट पुलास्की 
Roger Woolley 	रॉजर वूले 
Pinson Park Baptist 	पिंसन पार्क बैपटिस्ट 
Midnight Mail 	मिडनाइट मेल 
Pugachev's Rebellion 	प्यूगाचेव्स रिबेलियन 
Garma Garam 	गरमा गरम 
Historical and Folklore Museum of Corinth 	ह‍िस्टॉर‍िकल एण्ड फोकलोर म्युज़ियम ऑफ कॉर‍िन्थ 
Ram Lakhan 	राम लखन 
Aurat Aur Patthar 	औरत और पत्थर 
Sanchi Stupa 	सांची स्तूप 
Leading Brands 	लीडिंग ब्रांड्स 
Orchid Chemical 	ऑर्किड केमिकल्स 
Martha Stewart 	मर्था स्टीवर्ट 
Bin Badal Barsaat 	बिन बादल बरसात 
Pyar Ki Dastan 	प्यार की दास्तां 
Friendship Baptist 	फ़्रेंडशिप बैपटिस्ट 
New Museum of Contemporary Art 	न्यू म्युज़ियम ऑफ कंटेम्पररी आर्ट 
Trevor Madondo 	ट्रेवर मैडोंडो 
University of Hertfordshire 	यूनिवर्सिटी ऑफ हर्टफोर्डशायर 
Delhi Junction 	डेल्ही जंक्शन 
World Heart Corporation 	वर्ल्ड हार्ट कॉर्पोरेशन 
Elton Chigumbura 	एल्टन चिगमबुरा 
Mera Dost 	मेरा दोस्त 
Abdul qahhar 	अब्दुल कहार 
Abdul mughanee 	अब्दुल मुग़ानी 
Ghazipur City 	गाज़ीपुर सिटी 
Jnanpith Award 	ज्ञानपीठ अवार्ड 
Mera Muqadar 	मेरा मुक़द्दर 
DLink (India) 	डीलिंक (इंडिया) 
Richard Petrie 	रिचर्ड पेट्री 
Junaid Zia 	जुनैद ज़िया 
Do Raha 	दो राहा 
Gamini Wickremasinghe 	जेमिनी विक्रमासिन्घे 
George Washington 	जॉर्ज वॉशिंग्टन 
Order of Polonia Restituta 	ऑडर ऑफ पोलोनिया रेस्टीट्यूटा 
United Western 	यूनाइटेड वेस्टर्न 
Publix Super Markets 	पब्लिक्स सुपर मार्केट्स 
Mikhail Gorbachev 	मिखाइल गोर्बाचेव 
Ryugyong Hotel 	युंगयोंग होटेल 
Bal Bharati Public School 	बाल भारती पब्लिक स्कूल 
Logie Award 	लॉग अवार्ड्‍स 
University of Bath 	यूनिवर्सिटी ऑफ बाथ 
Jhootha Sach 	झूठा सच 
Joru Ka Bhai 	जोरू का भाई 
University of Sussex 	यूनिवर्सिटी ऑफ सुसेक्स 
Khwaja Mir Dard 	ख्वाजा मीर दर्द 
Goswami Tulsidas 	गोस्वामी तुलसीदास 
The Australian/Vogel Literary Award 	द ऑस्ट्रेलियन/वोगेल लिट्रेरी अवार्ड 
Wachovia Corp 	वैकॉविया कॉर्प 
Kalahari Gemsbok 	कलाहारी जेम्सबॉक 
Bedroom Story 	बेडरूम स्टोरी 
Dharam Kanta 	धरम काँटा 
Barney Rogers 	बर्नी रॉजर्स 
Florina Museum of Modern Art 	फ्लोर‍िना म्युज़ियम ऑफ मॉडर्न आर्ट 
Shaitan Ka Pash 	शैतान का पाश 
Patterson Thompson 	पैटर्सन थॉमप्सन 
Banmankhi Junction 	बानमंखी जंक्शन 
Tel Aviv 	तेल अविव 
Chandan Ka Palna 	चंदन का पालना 
Mem Didi 	मेम दीदी 
Xel-ha Lagoon 	ज़ेल-हा लैगून 
Conte Verde 	कॉन्टे वर्डे 
Fatehgarh Sahib 	फतेहगढ़ साहिब 
Hawa Mahal 	हवा महल 
Usman dan Fodio 	उस्मान दान फोडियो 
Ranga Aur Raja 	रंगा और राजा 
Khudai Khidmatgar 	खुदाई खिदमतगार 
John Hancock Center 	जॉन हेनकॉक सेन्टर 
Graeme Wood 	ग्रीम वुड 
Alan Mullally 	ऐलन मुलाली 
Mawenge Mwena 	मवेंजी म्वेना 
Gunderippalam Reservoir 	गुन्देरीप्पलम रिज़रवायर 
Ijaz Ahmed 	इजाज़ अहमद 
Pirelli Award 	पिरेली अवार्ड 
Bhai Akhir Bhai Hota Hai 	भाई आखिर भाई होता है 
Rakhi Ki Saugandh 	राखी की सौगंध 
Jaigarh fort 	जयगढ़ फोर्ट 
Steven Hawking 	स्टीवन हॉकिंग 
Dick Gregory 	डिक ग्रीगोरी 
Romantic India 	रोमांटिक इंडिया 
Ek Ke Baad Ek 	एक के बाद एक 
Shane Lee 	शेन ली 
Main Khilona Nahin 	मैं खिलौना नहीं 
Charbagh Railway Station 	चारबाग रेल्वे स्टेशन 
Boeta Dippenaar 	बोएटा डिप्पेनार 
New York Historical Society 	न्यू यॉर्क ह‍िस्टॉर‍िकल सोसायटी 
Infotech Enter 	इंफ़ोटेक एन्टर 
Prix Goncourt 	प्रिक्स गॉनकोर्ट 
Blue Ridge parkway 	ब्ल्यू रिज पार्कवे 
Wasim Raja 	वसीम राजा 
Sindoor Bane Jwala 	सिंदूर बने ज्वाला 
Kamal Ke Phool 	कमल के फूल 
Neel Kamal 	नील कमल 
Perkin Medal 	पर्किन मेडल 
Jeevan Rekha 	जीवन रेखा 
Pati Parmeshwar 	पति परमेश्वर 
No mans land fort 	नो मैन्स लैंड फोर्ट 
Achhnera Junction 	अछनेरा जंक्शन 
ATOM Award 	एटम अवार्ड 
Rumford Medal 	रमफोर्ड मेडल 
Sir Richard Hadlee 	सर रिचर्ड हेडली 
Brendon Bracewell 	ब्रेंडन ब्रेसवेल 
Aftek Infosys 	एफ़्टेक इंफ़ोसिस 
Shun Hing Square 	शून हिंग स्क्वेअर 
Rishi Valley School 	ऋषि वैली स्कूल 
Chori Chori 	चोरी चोरी 
Radio Academy Awards 	रेडियो अकेडमी अवार्ड्‍स 
Altair Nanotechnologies 	अल्टायर नैनोटेकर्नलॉजिस 
Big apple 	बिग एपल 
Dil Akhir Dil Hai 	दिल आखिर दिल है 
Mohammad Nazir 	मोहम्मद नाज़िर 
Alok Industries 	आलोक इंडस्ट्रीज़ 
Bilhar Ghat 	बिलहार घाट 
Daiwa House Industry 	डैवा हाउस इंडस्ट्री 
Kevin Curran 	केविन क्यूरेन 
Lal Punja 	लाल पंजा 
Teddy Kenedy 	टेडी कॅनेडी 
Murde Ki Jaan Khatre Main 	मुर्दे की जान खतरे में 
Dak Ghar 	डाक घर 
Peder Skram 	पेडर स्क्रेम 
Roydon Hayes 	रेडन हेस 
Khwaja Shamsuddin Azeemi 	ख्वाजा शमसुद्दीन अज़ीमी 
Shaadi Se Pehle 	शादी से पहले 
Stanley fort 	स्टैनले फोर्ट 
Museum of Works by Theophilos 	म्युज़ियम ऑफ वर्क्स बाय थ‍ियोफ‍िलस 
Torrent Group 	टॉरेंट ग्रुप 
Nilesh Kulkarni 	निलेश कुलकर्णी 
Abdul baaqi 	अब्दुल बाक़ी 
Chhoo Mantar 	छू मंत्र 
Delhi Sarai Rohilla 	डेल्ही सराय रोहिल्ला 
Reporter Raju 	रिपोर्टर राजू 
Saat Hindustani 	सात हिंदुस्तानी 
Granville De Silva 	ग्रैनविले डे सिल्वा 
Xing Universal Telephone 	ज़िंग युनिवर्सल टैलिफ़ोन 
Fort ashby 	फोर्ट ऐशबाय 
Jung Bahadur 	जंग बहादुर 
Boot Polish 	बूट पॉलिश 
Chapada da Diamantina 	चापाडा डा डायमेंटिना 
Fort bembridge 	फोर्ट बेम्ब्रिज 
Phil Jaques 	फिल जैक्स 
100 Greatest Britons 	100 ग्रेटेस्ट ब्रिटन्स 
Pandit Jasraj 	पंडित जसराज 
Jaiprakash Narayan 	जयप्रकाश नारायण 
Bolero son 	बॉलेरो सन 
Huntsville Christian 	ह्यूस्टविले क्रिश्चियन 
Kaiser Barbarossa 	कैसर बर्बोरोसा 
Egebergs Erespris 	एजबर्ग्स एरेसप्रिस 
Prinzregent Luitpold 	प्रिंजरेजेंट ल्यूपोल्ड 
Walter Kohn 	वॉल्टर कोहन 
Pradeep Jayaprakashdaran 	प्रदीप जयप्रकाशदरन 
Mehandi Rang Layegi 	मेहँदी रंग लाएगी 
Bukit Baka Bukit Raya 	बुकिट बाका बुकिट राया 
Betty Friedan 	बेट्टी फ़्रिडन 
Woh Saat Din 	वो सात दिन 
Order of the Sword 	ऑडर ऑफ़ द स्वॉर्ड 
King Charlemagne 	किंग चार्लमेयनी 
Asomiya pratidin 	असोम‍िया प्रतिद‍िन 
Ankh Ka Nasha 	आँख का नशा 
Ghunghat Wali 	घूँघट वाली 
Travis Baptist 	ट्रॅविस बैपटिस्ट 
Lyon saint exupery 	आयॉन सेंट एज़्युपेरी 
Anura Ranasinghe 	अनुरा राणासिंघे 
Adgaon Buzurg 	अदगांव बुज़ुर्ग 
Grammy Award 	ग्रैमी अवार्ड 
Brit Awards 	ब्रिट अवार्ड्‍स 
Ujesh Ranchod 	उजेश रेंचड 
Daily aikya 	डेल्ही ऐक्य 
Samaj Patan 	समाज पतन 
Jagannath puri 	जगन्नाथ पुरी 
Abdur razzaq 	अब्दुर रज़्ज़ाक 
Agricultural Bank of China 	एग्रीकल्चरल बैंक ऑफ चाइना 
Haitian Revolution 	हायशियन रिवॉल्यूशन 
Bindiya Chamkegi 	बिंदिया चमकेगी 
Tyson Foods 	टायसॉन फ़ूड्स 
Mard Ki Zabaan 	मर्द की ज़बान 
Steve Martin 	स्टीव मार्टिन 
Sanwar Hossain 	सन्वर हुसैन 
Owais Shah 	ऑवेस शाह 
Shing Mun Reservoir 	शिंग मुन रिज़रवायर 
Shah Abdul Latif Bhittai 	शाह अब्दुल लतीफ भिट्टाई 
Phool Bane Angarey 	फूल बने अंगारे 
Hanste Khelte 	हँसते खेलते 
Gundappa Viswanath 	गुंडप्पा विश्वनाथ 
Brookings Wesleyan 	ब्रूकिंग्स वेस्लेयान 
Yehiam fort 	येहैम फोर्ट 
Justin Ontong 	जस्टिन ओंटॉन्ग 
Tad Turner 	टेड टर्नर 
Ek Nazar 	एक नज़र 
Belfast City 	बेलफास्ट सिटी 
Dum Dum 	डम डम 
Ghar Ka Chirag 	घर का चिराग 
Ek Din Achanak 	एक दिन अचानक 
Shri Raageshwari Radha Rani 	श्री रागेश्वरी राधा रानी 
Chalisgaon Junction 	चालीसगांव जंक्शन 
Aplam Chaplam 	अपलम चपलम 
Joginder Sharma 	जोगिंदर शर्मा 
Sampoorna Santoshi Maa Ki Mahima 	संपूर्ण संतोषी माँ की महिमा 
Raj Dulari 	राज दुलारी 
Saint Vincent 	सेंट विंसेंट 
Fort lovrijenac 	फोर्ट लॉव्रीजेनैक 
Bikaner Junction 	बीकानेर जंक्शन 
Cherish Rock 	चॅरिश रॉक 
Jeene Ki Raah 	जीने की राह 
Bhopal Junction 	भोपाल जंक्शन 
Baat Ek Raat Ke 	बात एक रात की 
Anderson Cummins 	एण्डरसन क्युमिंस 
Hum To Chale Pardes 	हम तो चले परदेस 
Rajin Saleh 	राजिन सालेह 
Passing Show 	पासिंग शो 
Shatranj Ke Mohre 	शतरंज के मोहरे 
Khol De Meri Zuban 	खोल दे मेरी ज़ुबान 
Insaaf Ki Manzil 	इंसाफ की मंज़िल 
Ahmad al-Arabi al-Darqawi 	अहमद अल-अरबी अल-दरक़ावी 
Ross Sea 	रॉस सी 
Shahi Mehmaan 	शाही मेहमान 
Marlon Samuels 	मार्लोन सैमुएल्स 
Imam Shamil 	इमाम शामिल 
Abdul jabbaar 	अब्दुल जब्बार 
Mathew Sinclair 	मैथ्यू सिनक्लेयर 
Hum Bhi Insaan Hai 	हम भी इंसान हैं 
Raja Rani 	राजा रानी 
Sarojini Naidu 	सरोजिनी नायडू 
Fort calgary 	फोर्ट कैलगरी 
Pyar Ki Manzil 	प्यार की मंज़िल 
Akhri Badla 	आखिरी बदला 
Heera Panna 	हीरा पन्ना 
Pantanal Matogrossense 	पेंटानल मॅटोग्रोसेंस 
Ajanta Ellora 	अजंता एलोरा 
Sherwin Campbell 	शर्विन कैम्पबेल 
Bromo Tengger 	ब्रोमो टेनग्गर 
The oriya samaja 	द ओड़िया समाज 
Wajahatullah Wasti 	वजाहतुल्लाह वस्ती 
Abdur rahmaan 	अब्दुर रहमान 
Hum Hain Lajawab 	हम हैं लाजवाब 
Fort honswijk 	फोर्ट हॉन्सविज़्क 
Miss Manners 	मिस मेनर्स 
Narendra Hirwani 	नरेंद्र हिरवानी 
Douglas Hondo 	डग्लस होंडो 
Cervantes Prize 	सेरवैनटेस प्राइज़ 
Samsung Museum 	सैमसंग म्युज़ियम 
Siju Dobhakol 	सिजु दोभाकोल 
Laheri Jiwan 	लहरी जीवन 
Fort crown point 	फोर्ट क्राउन पॉइंट 
Assam tribune 	असम ट्रिब्यून 
Fort sainte anne 	फोर्ट सेंट एनी 
Miss Coca Cola 	मिस कोका कोला 
Oklahoma city 	ओक्लाहोमा सिटी 
Bethel Apostolic 	बेथेल अपोस्टोलिक 
Aage Badho 	आगे बढ़ो 
University of Technology 	यूनिवर्सिटी ऑफ टेक्नोलॉजी 
Echo German music award 	इको जर्मन म्युज़िक अवार्ड 
Shyaam Ki Jogan 	श्याम की जोगन 
Railway Museum of Athens 	रेल्वे म्युज़ियम ऑफ एथेन्स 
Thorarinsson Medal 	थोरारिंसन मेडल 
Fort columbia 	फोर्ट कोलंबिया 
Fort snelling 	फोर्ट स्नेलिंग 
Gross Ventre 	ग्रॉस वेंटर 
Birju Ustad 	बिरजू उस्ताद 
Tobacco Root 	टोबॅक्को रूट 
Jiyo To Aise Jiyo 	जियो तो ऐसे जियो 
Protection of Natural Amenities Medal 	प्रोटैक्शन ऑफ नैचुरल अमेनिटीस मेडल 
Williams Tower 	विल्यम्स टॉवर 
Syneron Medical 	सिनेरॉन मेडिकल 
Degana Junction 	देगाना जंक्शन 
Mahanagar Gas 	महानगर गैस 
Jantar Mantar 	जंतर मंतर 
Aap Ki Khatir 	आप की खातिर 
Nancy Reagan 	नैंसी रीगन 
Viareggio Prize 	वायरेगियो प्राइज़ 
University of Nevada 	यूनिवर्सिटी ऑफ नेवाडा 
Kanch Aur Heera 	काँच और हीरा 
Masta Fakir 	मस्त फकीर 
Tahmeena Durrani 	तहमीना दुर्रानी 
Steven Jack 	स्टीवन जैक 
Eldine Baptiste 	एल्डिन बैप्टिस्ट 
Gurudwara Maal Tekri 	गुरूद्वारा माल टेकरी 
La Porte 	ला पोर्ट 
Aadmi Khilona Hai 	आदमी खिलौना है 
Bk Of Rajasthan 	बैंक ऑफ राजस्थान 
Chifley Tower 	चिफ़्ले टॉवर 
Bhaga Junction 	भगा जंक्शन 
Beti Tumhare Jaisi 	बेटी तुम्हारे जैसी 
National Museum of American Indian 	नेशनल म्युज़ियम ऑफ अमेर‍िकन इंड‍ियन 
Aag Ka Gola 	आग का गोला 
Ek Misaal 	एक मिसाल 
Newdigate prize 	न्यूडिगेट प्राइज़ 
Hidayat Inayat Khan 	हिदायत इनायत खान 
Krishna Kanhaiya 	क़ृष्ण कन्हैया 
Ray Price 	रे प्राइस 
Alakh Niranjan 	अलख निरंजन 
Kaanch Ki Deewar 	काँच की दीवार 
Victoria Fossil 	विक्टोरिया फ़ॉसिल 
Rugby Union World Cup 	रग्बी यूनियन वर्ल्ड कप 
Takhat Shri Damdama Sahib, Banthida (Punjab) 	तखत श्री दमदमा साहिब, बनठिंडा (पंजाब) 
Johny I Love You 	जॉनी आई लव यू 
New Guinea 	न्यू गुएना 
Rain Calcining 	रेन कैल्सिंइंग 
Chapel bay battery fort 	चैपेल बे बैटरी फोर्ट 
Lincoln University 	लिंकन यूनिवर्सिटी 
K Sera Sera 	के सेरा सेरा 
Gainsari Junction 	गैनसारी जंक्शन 
Boy Friend 	बॉय फ्रेंड 
Vaishno Devi 	वैष्णो देवी 
Gurudwara Doulatpur Sahib 	गुरूद्वारा दौलतपुर साहिब 
Anand Ashram 	आनंद आश्रम 
Aakhri Insaaf 	आखिरी इंसाफ 
Colgate Palmolive India 	कोलगेट पॉमोलिव इंडिया 
Abdul quddus 	अब्दुल कुद्दुस 
Gary Crocker 	गैरी क्रॉकर 
Cape Maclear 	केप मैकलियर 
Mars Hill 	मार्स हिल 
Azeemul Haniff 	अज़ीमुल हनिफ 
Choron Ki Baraat 	चोरों की बारात 
Narsi Mehta 	नरसी मेहता 
Prix des Deux-Magots 	प्रिक्स डेस ड्‍यूक्स-मैगट्‍स 
Laureus World Sports Awards 	लॉरेस वर्ल्ड स्पोर्ट्‍स अवार्ड्‍स 
Fort wayne 	फोर्ट वेन 
Carlos Castaneda 	कार्लोस कॅसटेनेडा 
Jaipur fort 	जयपुर फोर्ट 
Hindi milap 	ह‍िन्दी म‍िलाप 
Lalithamana Fernando 	ललिथमना फर्नेंडो 
Hum Hindustani 	हम हिंदुस्तानी 
Bayard cove fort 	बेयार्ड कोव फोर्ट 
Andy Whittall 	एण्डी व्हिट्टल 
Abdul khabeer 	अब्दुल खबीर 
Rubin Museum of Art 	रुब‍िन म्युज़ियम ऑफ आर्ट 
Tate Gallery 	टेट गैलरी 
Medal of the Gold Star 	मेडल ऑफ द गोल्ड स्टार 
Fort belan 	फोर्ट बेलन 
Syed Abid Ali 	सय्यद अबिद अली 
Garwa Road 	गरवा रोड 
Erzherzog Franz Ferdinand 	अर्ज़रज़ोग फ्रैंज फर्डिनांड 
Kahin Aur Chal 	कहीं और चल 
Vinod Mishra 	विनोद मिश्र 
Khaufnak Aankhen 	खौफनाक आँखें 
Alpesh Vadher 	अल्पेश वाढ़ेर 
Pyar Ki Raat 	प्यार की रात 
Re Umberto 	रे अम्बर्टो 
Prem Pariksha 	प्रेम परीक्षा 
Mick Malone 	मिक मैलोन 
Chris Martin 	क्रिस मॉर्टिन 
Fort wallace 	फोर्ट वैलेस 
Russo-Turkish War 	रशो-टर्किश वार 
Jack the ripper 	जैक द रिपर 
Gurudwara Nanak Piaau 	गुरूद्वारा नानक पिआऊ 
Keerthi Ranasinghe 	किर्ति राणासिंघे 
Nicholas Appert Award 	निकोलस एपर्ट अवार्ड 
Aluabari Road 	अलुयाबरी रोड 
American International Building 	अमेरिकन इंटरनेशनल बिल्डिंग 
Fort william henry 	फोर्ट विलियम हनरी 
Rod Serling 	रॉड सरलिंग 
Maine Jeena Seekh Liya 	‍मैंने जीना सीख लिया 
Zee Telefims 	ज़ी टेलीफ़िल्म्स 
Armand Hammer 	अरमंड हॅमर 
Faraar Quaidi 	फरार क़ैदी 
Guj Ind Power 	गुजरात इंड पॉवर 
Frederic Francois Chopin 	फ़्रेंडरिक फ़्रांसीस चॉपिन 
Behake Kadam 	बहके कदम 
Grammy Trustees Award 	ग्रैमी ट्रस्टीस अवार्ड 
Ramesh Powar 	रमेश पोवार 
Daulatabad fort 	दौलताबाद फोर्ट 
Dalli Rajhara 	दली राजहारा 
Kora Anchal 	कोरा आँचल 
Vikram Rathour 	विक्रम राठौर 
Hubert Humphrey 	ह्युबर्ट हम्फ़्री 
Malai malar 	मलाई मलर 
Prince William 	प्रिंस विलियम 
Abdul baaree 	अब्दुल बारी 
Nothe fort 	नोथ फोर्ट 
Ashantha De Mel 	अशांथा डे मेल 
Datamatics Tech 	डेटामेटिक्स टेक 
Bombay Race Course 	बॉम्बे रेस कोर्स 
Dover turret fort 	डॉवर टर्रेट फोर्ट 
Woodstock School, Mussoorie 	वूडस्टॉक स्कूल, मसूरी 
Model English School, Dombivli 	मॉडेल इंग्लिश स्कूल, डोम्बिवली‍ 
Gokhale Memorial Girls School, Calcutta 	गोखले मेमोर‍ियल गर्ल्स स्कूल, कैलकटा 
Shola Jo Bhadke 	शोला जो भड़के 
David Terbrugge 	डेविड टर्ब्रग 
Punjab Mail 	पंजाब मेल 
Qayamat Ki Raat 	क़यामत की रात 
Meri Awaaz Suno 	मेरी आवाज़ सुनो 
Duff Cooper Prize 	डफ कूपर प्राइज़ 
Wilhem Busch Museum 	व‍िल्हेम बुश म्युज़ियम 
Ram Darshan 	राम दर्शन 
Azam Khan 	आज़म खान 
Keanu Reeves 	कैनु रीव्स 
Chuck Barry 	चुक बेरी 
Andre Adams 	आन्द्रे एडम्स 
Yamashiro Maru 	यमाशिरो मारू 
Keith Fletcher 	कैथ फ्लेचर 
National herald 	नेशनल हेराल्ड 
Bhavani Nagar 	भावनी नगर 
The Robert Gordon University 	द रॉबर्ट गॉर्डन यूनिवर्सिटी 
Yitzhak Robin 	यिट्ज़हॅक रॉबिन 
Titan Industries 	टाइटन इंडस्ट्रीज़ 
Fort hamilton 	फोर्ट हैमिल्टन 
Kali Ganga 	काली गंगा 
Balyogi Upmanyu 	बालयोगी उपमन्यु 
Max India 	मैक्स इंडिया 
Fort macleod 	फोर्ट मैकलेयोड 
Sridharan Jeganathan 	श्रीधरन जगनाथन 
Fort smith 	फोर्ट स्मिथ 
Socrates Sculpture Park 	सॉक्रेट्स स्कल्पचर पार्क 
Jeene Do 	जीने दो 
Gholam Nousher 	गोलाम नौशर 
Bass Strait 	बास स्ट्रेट 
Takhat Shri Sachkhand Sahib, Nanded (Maharashtra) 	तखत श्री सचखंड साहिब, नांदेड़ (महाराष्‍ट्र) 
Dodi Fayad 	डोडी फ़ेयड 
Saint Michael's Academy, Chennai 	सेंट माइकल्स एकेडमी, चेन्नई 
Aakhri Goli 	आखिरी गोली 
Phil DeFreitas 	फिल डेफ्रेटास 
Hamara Khandaan 	हमारा खानदान 
Samaj Ko Badal Dalo 	समाज को बदल डालो 
Harvard University 	हावर्ड यूनिवर्सिटी 
Govindgarh Malk 	गोविंदगढ़ माल्क 
Brendan Fraser 	ब्रेंडन फ़्रेसिर 
Enamul Haque 	एनामुल हक 
Paanch Khiladi 	पाँच खिलाड़ी 
Kismat Ki Kasauti 	किस्मत की कसौटी 
Sant Ravidas Ki Amar Kahani 	संत रविदास की अमर कहानी 
Waqar Younis 	वकार युनिस 
Batang Ai Dam 	बतांग अई डैम 
Hewlett Packard 	ह्यूलेट पेकार्ड 
Paraguayan harp 	पैरागुएन हार्प 
Nick Nolte 	निक नोल्टे 
Ganj Basoda 	गंज बसोदा 
Lady Godiva 	लेडी गॉडिवा 
Major League Lacrosse Sportsman of the Year Award 	मेजर लीग लैक्रोस स्पोर्ट्‍समैन ऑफ द ईयर अवार्ड 
Badle Ki Aag 	बदले की आग 
Dilruba Tangewali 	दिलरुबा ताँगेवाली 
Fort zeelandia 	फोर्ट ज़ीलैंडिया 
Abdul muhaayamin 	अब्दुल मुहायमीन 
Vibhuti Bhushan 	विभूति भूषण 
Balmer Lawrie 	बालमेर लॉरी 
Naya Rasta 	नय रास्ता 
Oos Raat Ke Baad 	उस रात के बाद 
Bristol channel fort 	ब्रिस्टल चैनल फोर्ट 
Daleville Baptist 	डेलविले बैपटिस्ट 
Dyani Kitten 	डाएनी कीटन 
Hathon Ki Lakeer 	हाथों की लकीर 
Fort wentworth 	फोर्ट वेंटवर्थ 
John F. Kennedy 	जॉन एफ. केनेडी 
Chaure Bazar 	चौरे बाज़ार 
Mitsubishi Motors 	मित्सुबिशी मोटर्स 
Shaadi Ki Raat 	शादी की रात 
Devon Smith 	डेवन स्मिथ 
Badr aldin 	बद्र अलदीन 
Gurudwara Mehadiana 	गुरूद्वारा मेहदीआणा 
Lu luah 	लु लुअ 
Shri Mangal 	श्री मंगल 
Chris Silverwood 	क्रिस सिल्वरवुड 
Calf roping 	काफ रोपिंग 
James Michener 	जेम्स मिकॅनर 
Dummer's War 	ड्रमर्स वार 
Koning der Nederlanden 	कॉनिंग दर नीदरलैंडन 
Daku Hasina 	डाकू हसीना 
Aaj Ki Awaaz 	आज की आवाज़ 
Bridgeport Christian 	ब्रिजपोर्ट क्रिश्चियन 
Bank Manager 	बैंक मैनेजर 
Jawani Diwani 	जवानी दीवानी 
Ashok Malhotra 	अशोक मल्होत्रा 
Abdul waajid 	अब्दुल वाजिद 
Charnon Ki Dasi 	चरणों की दासी 
Fort frederica 	फोर्ट फ्रेडरिका 
Kaise Kaise Log 	कैसे कैसे लोग 
Warren Hegg 	वॉरेन हेग 
Pampa Award 	पैम्पा अवार्ड 
Fort battleford 	फोर्ट बैटलफोर्ड 
University of Nebraska 	यूनिवर्सिटी ऑफ नेब्रास्का 
Horn of Africa 	हॉर्न ऑफ अफ्रीका 
Biraj Bahu 	बिरज बहू 
Alan Hurst 	एलन हर्स्ट 
Instrumental Rock Guitar Hall Of Fame 	इंस्ट्रूमेंटल रॉक गिटार हॉल ऑफ फेम 
Prem Shastra 	प्रेम शास्त्र 
Dil Deke Dekho 	दिल देके देखो 
Nansen Refugee Award 	नानसेन रेफ्युजी अवार्ड 
Abdur Rauf 	अब्दुर रौफ 
Grindwell Norto 	ग्राइंडवेल नॉर्टो 
Hindustan Zinc 	हिंदुस्तान ज़िंक 
Geoff Cope 	जिऑफ कोप 
Sheikh Ruzbehan 	शेख़ रुज़बेहन 
Ze'ev Prize 	ज़ेव प्राइज़ 
Wildewood Christian 	वाइल्डवुड क्रिश्चियन 
Imran Abbas 	इमरान अब्बास 
Roland Butcher 	रॉलेंड बुचर 
Pyar Ka Bandhan 	प्यार का बंधन 
Brownlow Medal 	ब्राउनलो मेडल 
Turco-Persian War 	टर्को-पर्शियन वार 
Gurudwara Chola Sahib 	गुरूद्वारा चोला साहिब 
University of Hull 	यूनिवर्सिटी ऑफ हल 
Aan Aur Shaan 	आन और शान 
Elder Pharma 	एल्डर फ़ार्मा 
Chemin de fer fort 	केमिन डे फर फोर्ट 
Dana Pani 	दाना पानी 
Best Buy 	बेस्ट बाय 
Groupe Danone 	ग्रुप डैनॉन 
Hera Pheri 	हेरा फेरी 
Lal Kunwar 	लाल कुँवर 
Chhoti Odai 	छोटी ओदई 
Riding Mountain 	‍रायडिंग माउंटन 
Needles old battery 	नीडल्स ओल्ड बैटरी 
Half Ticket 	हाफ टिकिट 
Gurudwara Sahibdewa 	गुरूद्वारा साहिबदेवा 
Nadine Gordimer 	नादिन गार्डिमर 
Sajeewa Weerakoon 	सजीवा वीराकून 
Ha Ha He He Ho Ho 	हा हा ही ही हो हो 
Park Place Baptist 	पार्क प्लेस बैपटिस्ट 
National Royal Museum of Scotland 	नेशनल रॉयल म्युज़ियम ऑफ स्कॉटलैंड 
Holland Chapel Baptist 	हॉलैंड चैपेल बैपटिस्ट 
Shin Shinaki Babla Boo 	शिन शिनाकी बबला बू 
Heath Davis 	हीथ डेविस 
Tata Infotech 	टाटा इंफ़ोटेक 
Kahan Hai Manzil Teri 	कहाँ है मंज़िल तेरी 
Mark Haslam 	मार्क हेसलम 
Abdul kabeer 	अब्दुल कबीर 
Saint Xaviers's School, Chandigarh 	सेंट ज़ेवियर्स स्कूल, चंडीगढ़ 
Nau Do Gyarah 	नौ दो ग्यारह 
Naqli Heera 	नकली हीरा 
Hanuman Patal Vijay 	हनुमान पटल विजय 
Jeff Wilson 	जेफ विल्सन 
Bhola Bhala 	भोला भाला 
Uda Walawe 	उदा वालावे 
Madras Cements 	मद्रास सीमेंट्स 
Aurat Pair Ki Joti Nahin 	औरत पैर की जूती नहीं 
Horse Racing 	हॉर्स रेसिंग 
James Ormond 	जेम्स ऑर्मंड 
Scottish Power 	स्कॉटिश पॉवर 
Abdul hafeed 	अब्दुल हफीद 
Shaitani Ilaaka 	शैतानी इलाकी 
Band Master 	बैंड मास्टर 
Fort fisher 	फोर्ट फिशर 
Family of God 	फ़ैमिली ऑफ गॉड 
Order of Kuwait 	ऑडर ऑफ कुवैत 
Kavignar inkulab 	कव‍िग्नर इंकलाब 
Kuchh Naya 	कुछ नया 
Mawana Sugar 	मवाना शुगर 
Hundred Days 	हंडरेड डेज 
Amar Singh Rathod 	अमर सिंह राठौड़ 
Order of the Lion of Finland 	ऑडर ऑफ द लायन ऑफ फिनलैंड 
Sheetla Mata 	शीतला माता 
Shankar Shambhu 	शंकर शंभू 
Bargarh Road 	बारगढ़ रोड 
Andaman and Nicobar 	अंदमान एण्ड निकोबार 
Ranjith Madurasinghe 	रंजीथ मदुरासिंघे 
Thorolf Rafto Memorial Prize 	थोरोल्फ रैफ्टो मेमोरियल प्राइज़ 
Char Darvesh 	चार दरवेश 
Dost Garibon Ka 	दोस्त गरीबों का 
Mario cuomo 	मारियो क्यूमो 
Optimal Group 	ऑप्टीमल ग्रुप 
Deepak Fert 	दीपक फ़र्ट 
Municipal Gallery of Piraeus 	म्युन‍िस‍िपल गैलरी ऑफ पायरस 
Mahendra Nagamootoo 	महेन्द्र नगामूटू 
University of Strathclyde 	यूनिवर्सिटी ऑफ स्ट्रैथक्लाइड 
Madras Fertliser 	मद्रास फ़र्टीलाइज़र 
Russo-Persian War 	रशो-पर्शियन वार 
Pyar Karke Dekho 	प्यार करके देखो 
Hamari Yaad Aayegi 	हमारी याद आएगी 
Bank of Mah 	बैंक ऑफ महाराष्ट्र 
Raahi Badal Gaye 	राही बदल गए 
Sears Roebuck 	सियर्स रोबक 
Aaj Ki Aurat 	आज की औरत 
Munaf Patel 	मुनाफ पटेल 
Raksha Bandhan 	रक्षा बंधन 
Deutscher Spiele Preis 	डेस्चर स्पाइल प्रीस 
Mike Watkinson 	माइक वॉटकिंसन 
Great Northern War 	ग्रेट नॉर्दन वार 
Shimane Maru 	शिमेन मारू 
Police Station 	पुलिस स्टेशन 
Mud Mud Ke Na Dekh 	मुड़ मुड़ के न देख 
Gurudwara khandur Sahib 	गुरूद्वारा खंडूर साहिब 
Kumar Dharmasena 	कुमार धर्मसेना 
Nai Bhabhi 	नई भाभी 
Chris Smith 	क्रिस स्मिथ 
Shahenshah Babar 	शहंशाह बाबर 
Bauhaus System 	बुहाउस सिस्टम 
Khel Kismat Ka 	खेल किस्मत का 
Syed Akhtar Imam Quadri 	सय्यद अख्तर इमाम क़ादरी 
Hill Station 	हिल स्टेशन 
Mohabbat Ke Dushman 	मोहब्बत के दुश्मन 
Himatsingka Sei 	हिमतसिंगका सी 
Ingersoll Rand 	इंगरसॉल रैंड 
Tony Kent Strix award 	टोनी केंट स्ट्रिक्स अवार्ड 
Maa Ka Anchal 	माँ का आँचल 
Gurudwara Mata Gujri ji 	गुरूद्वारा माता गुजरी जी 
Maharani Padmini 	महारानी पद्‍मिनी 
Carl Friedrich Gauss Prize 	कार्ल फ्रेडरिक गॉस प्राइज़ 
Natchez Trace Parkway 	नॅटशेज़ ट्रास पार्कवे 
Noguchi Museum 	नोगुची म्युज़ियम 
Purana Mandir 	पुराना मंदिर 
Fort op de ruigenhoeksedijk 	फोर्ट ऑप डे ‍रुगनहोएकसेडिज्क 
Chashme Baddoor 	चश्मे बद्‍दूर 
Sharon Stone 	शेरॉन स्टोन 
Ehsanul Haque 	एहसानुल हॉक 
Maharshi Ved Vyas 	महर्षि वेद व्यास 
Meri Bhabhi 	मेरी भाभी 
Gupt Gyan 	गुप्त ज्ञान 
Dil Ki Basti 	दिल की बस्ती 
Peter Martin 	पीटर मार्टिन 
Robin Uthappa 	रॉबिन उथाप्पा 
Zulm Ko Jala Doonga 	ज़ुल्म को जला दूँगा 
Abdul nasir 	अब्दुल नासिर 
Jaal Saaz 	जाल साज़ 
Ek Tha Raja 	एक था राजा 
Dibrugarh Town 	डिब्रुगढ़ टाउन 
Dil Ka Dada 	दिल का दादा 
Clay Research Award 	क्ले रिसर्च अवार्ड 
Mann Cup 	मान कप 
Bloomberg Tower 	ब्लूमबर्ग टॉवर 
Polar Music Prize 	पोलर म्युज़िक प्राइज़ 
Lameck Onyango 	लैमेक ओन्यैंगो 
Narsimha Avtar 	नरसिम्हा अवतार 
Gillette India 	जिलेट इंडिया 
Carnegie Medal 	कार्नेग मेडल 
Jadui Bansari 	जादुई बंसरी 
Carnegie Mellon University 	कारनेग मेलन यूनिवर्सिटी 
Medal of Suvorov 	मेडल ऑफ सुवोरोव 
Pavitra Papi 	पवित्र पापी 
Bristol Channel 	ब्रिस्टल चैनल 
Charitha Buddhika 	चरिथा बुद्धिका 
Rashtriya Chem 	राष्ट्रीय केमिकल्स 
Hamara Haj 	हमारा हज 
Flextronics International 	फ़्लेक्सट्रॉनिक्स इंटरनेशनल 
Cuddalore Port 	कुडालोर पोर्ट 
Aadat Se Majboor 	आदत से मजबूर 
Yahan Wahan 	यहाँ वहाँ 
Sati Savitri 	सती सावित्री 
Red Sea 	रेड सी 
Shatranj Ke Khiladi 	शतरंज के खिलाड़ी 
Gemplus International 	गेमप्लस इंटरनेशनल 
Davis Museum and Cultural Art 	डेव‍िस म्युज़ियम एण्ड कल्चरल आर्ट 
Chiraag Kahan Roshni Kahan 	चिराग कहाँ रोशनी कहाँ 
John Hampshire 	जॉन हेम्पशायर 
Medals of Honor 	मेडल्स ऑफ ऑनर 
Strait of Magellan 	स्ट्रेट ऑफ मेगॅलन 
Bangalore Cantonment 	बैंगलोर कैनटॉनमेंट 
Westminster Presbyterian 	वेस्टमिनस्टर प्रेसबिटेरियन 
Dan Cullen 	डैन कूलन 
Elizabeth Tailor 	एलिज़ाबेथ टेलर 
Karm Yogi 	कर्म योगी 
Marconi Prize 	मारकोनी प्राइज़ 
Gangapur City 	गंगापुर सिटी 
Sri Kalahasti 	श्री कालहस्ती 
Abdus sattaar 	अब्दुस सत्तार 
Howrah Bridge 	हावड़ा ब्रिज 
Prem Jaal 	प्रेम जाल 
Ajit Agarkar 	अजीत आगरकर 
Sawan Aya Re 	सावन आया रे 
Principe Amadeo 	प्रिंसिपे अमाडियो 
Countrywide Financial 	कंट्रीवाइड फ़ाइनेंशियल 
Gurudwara Tarantaaran Sahib 	गुरूद्वारा तरनतारन साहिब 
Asian Hotels 	एशियन होटल्स 
Abdul rafee 	अब्दुल रफी 
Vivek Razdan 	विवेक राजदान 
Somachandra De Silva 	सोमचन्द्रा डे सिल्वा 
Bazar Band Karo 	बाज़ार बंद करो 
Miss Mala 	मिस माला 
Peach Tree War 	पीच ट्री वार 
The Museon 	द म्युज़िअन 
Gurudwara Punjokhara Sahib 	गुरूद्वारा पंजोखरा साहिब 
Nathan Astle 	नैथन एस्ले 
Carnatic War 	कार्नेटिक वार 
Muqaddar Ka Faisla 	मुकद्दर का फैसला 
Major League Lacrosse Coach of the Year Award 	मेजर लीग लैक्रोस कोच ऑफ द ईयर अवार्ड 
Chandausi Junction 	चंदौसी जंक्शन 
University of California 	यूनिवर्सिटी ऑफ कैलिफोर्निया 
Nav Bharat 	नव भारत 
Teesra Kinara 	तीसरा किनारा 
William nagar 	विलियम नगर 
The pioneer (daily) 	द पायोन‍ियर (डेली) 
Master Man 	मास्टर मैन 
Prince Harry 	प्रिंस हॅरी 
Dil Aur Patthar 	दिल और पत्थर 
Order of Military Merit 	ऑडर ऑफ मिलिट्री मेरिट 
Champaka Ramanayake 	चंपका रामनायक 
Juliette Binoche 	जुलियट बिनोची 
University of Huddersfield 	यूनिवर्सिटी ऑफ हडर्सफील्ड 
David Murray 	डेविड मुर्रे 
Crookhorn redoubt 	क्रुकहोर्न रीडाउट 
SMART Modular Technologies 	स्मार्ट मॉड्यूलर टेक्नोलॉजीज़ 
Raj Ratan 	राज रतन 
James Brown 	जेम्स ब्राउन 
Yograj Singh 	योगराज सिंह 
